	verb.stative@wnlex	adj.all@wnlex	tiempo@mariax	noun.person@wnlex	noun.artifact@wnlex	decir@mariax	tratar@mariax	verb.communication@wnlex	baraja@mariax	adv.all@wnlex	vestir@mariax	hablar@mariax	decidir@mariax	opinión@mariax	amor@mariax	escribir@mariax	saber@mariax	verb.motion@wnlex	noun.communication@wnlex	expresar@mariax	exclamar@mariax	tribunal@mariax	música@mariax	servir@mariax	verb.change@wnlex	jugar@mariax	enfermedad@mariax	pensar@mariax	noun.act@wnlex	sentir@mariax	luz@mariax	trabajar@mariax	examinar@mariax	descubrir@mariax	noun.attribute@wnlex	impresión@mariax	experiencia@mariax	verb.contact@wnlex	terminar@mariax	sexo@mariax	suceder@mariax	notar@mariax	milicia@mariax	verb.possession@wnlex	clase@mariax	armonía@mariax	comunicar@mariax	verb.cognition@wnlex	noun.cognition@wnlex	aspecto@mariax	conversar@mariax	atender@mariax	casa@mariax	orden@mariax	autoridad@mariax	inteligencia@mariax	caballería@mariax	voz@mariax	efecto@mariax	vivienda@mariax	indicar@mariax	moneda@mariax	color@mariax	animal@mariax	verb.perception@wnlex	verb.social@wnlex	adecuado@mariax	dinero@mariax	cuenta@mariax	mover@mariax	noun.time@wnlex	imprimir@mariax	importar@mariax	persona@mariax	tejer@mariax	noun.body@wnlex	despreciar@mariax	principiar@mariax	influir@mariax	lugar@mariax	entender@mariax	fuerte@mariax	llamar@mariax	reunir@mariax	forma@mariax	difundir@mariax	dirigir@mariax	mirar@mariax	teatro@mariax	tener@mariax	bueno@mariax	lenguaje@mariax	nombre@mariax	desarrollar@mariax	fútbol@mariax	libro@mariax	publicar@mariax	comer@mariax	negocio@mariax	comercio@mariax	estimar@mariax	distinguir@mariax	grande@mariax	narrar@mariax	dar@mariax	investigar@mariax	medicina@mariax	equivocar@mariax	lengua@mariax	gobernar@mariax	valer@mariax	documento@mariax	dicho@mariax	corresponder@mariax	alabar@mariax	enseñar@mariax	desacreditar@mariax	hábil@mariax	marina@mariax	responder@mariax	sorprender@mariax	informar@mariax	sonar@mariax	acción@mariax	representar@mariax	suerte@mariax	difícil@mariax	población@mariax	murmurar@mariax	insistir@mariax	ojo@mariax	asunto@mariax	río@mariax	meteorología@mariax	enfadar@mariax	planta@mariax	guerra@mariax	calle@mariax	anunciar@mariax	guardar@mariax	incrédulo@mariax	conocer@mariax	empleo@mariax	vigilar@mariax	pintar@mariax	desear@mariax	engañar@mariax	agricultura@mariax	dominar@mariax	creer@mariax	enterar@mariax	transportar@mariax	intención@mariax	estudiar@mariax	verb.creation@wnlex	arma@mariax	razón@mariax	parte@mariax	afirmar@mariax	hombre@mariax	convencer@mariax	separar@mariax	listo@mariax	verb.emotion@wnlex	gramática@mariax	puerta@mariax	cambiar@mariax	compadecer@mariax	barco@mariax	noble@mariax	noun.state@wnlex	marchar@mariax	significar@mariax	cariño@mariax	descomponer@mariax	durar@mariax	cuidar@mariax	rápido@mariax	golpe@mariax	andar@mariax	pariente@mariax	bello@mariax	construir@mariax	reprender@mariax	edificio@mariax	mar@mariax	arquitectura@mariax	idea@mariax	detener@mariax	sujetar@mariax	fama@mariax	sospechar@mariax	noun.group@wnlex	exagerar@mariax	destruir@mariax	cortés@mariax	superior@mariax	máxima@mariax	disgustar@mariax	precio@mariax	mostrar@mariax	fortificar@mariax	noun.location@wnlex	oportuno@mariax	terreno@mariax	manejar@mariax	cantidad@mariax	considerar@mariax	esencia@mariax	vencer@mariax	jurar@mariax	daño@mariax	luchar@mariax	cuestión@mariax	literatura@mariax	padecer@mariax	ir@mariax	hueco@mariax	imaginar@mariax	amenazar@mariax	cara@mariax	habitar@mariax	ver@mariax	suponer@mariax	noun.feeling@wnlex	desgracia@mariax	callar@mariax	alegre@mariax	medir@mariax	trasladar@mariax	señal@mariax	permitir@mariax	proteger@mariax	mucho@mariax	obligar@mariax	placer@mariax	adorno@mariax	cerrar@mariax	cuerpo@mariax	llevar@mariax	malo@mariax	cantar@mariax	actor@mariax	teología@mariax	noun.animal@wnlex	reflexionar@mariax	voluntad@mariax	intervenir@mariax	riña@mariax	estilo@mariax	entrar@mariax	fiesta@mariax	palabra@mariax	ganado@mariax	gracia@mariax	despropósito@mariax	espectáculo@mariax	recordar@mariax	noun.event@wnlex	defender@mariax	intenso@mariax	verb.body@wnlex	continuar@mariax	temer@mariax	beber@mariax	existir@mariax	juzgar@mariax	sostener@mariax	interrumpir@mariax	conducir@mariax	posición@mariax	vivir@mariax	acomodar@mariax	meter@mariax	insultar@mariax	sobresalir@mariax	asamblea@mariax	relación@mariax	ánimo@mariax	longitud@mariax	dimensión@mariax	repetir@mariax	camino@mariax	campo@mariax	vino@mariax	noun.object@wnlex	tender@mariax	usar@mariax	dibujo@mariax	matemática@mariax	precaución@mariax	compañía@mariax	abertura@mariax	oponer@mariax	religión@mariax	elevar@mariax	propiedad@mariax	fastidio@mariax	inventar@mariax	entretener@mariax	ocultar@mariax	edad@mariax	aparecer@mariax	interés@mariax	apto@mariax	danzar@mariax	morir@mariax	pena@mariax	dudar@mariax	cazar@mariax	ave@mariax	día@mariax	agujero@mariax	toro@mariax	espacio@mariax	mamífero@mariax	exasperar@mariax	muerte@mariax	bien@mariax	satisfacer@mariax	molestar@mariax	sentido@mariax	aguantar@mariax	madera@mariax	castigar@mariax	dios@mariax	real@mariax	dividir@mariax	completo@mariax	carne@mariax	mandar@mariax	cierto@mariax	determinar@mariax	señor@mariax	pagar@mariax	privilegio@mariax	trastornar@mariax	reproducción@mariax	atraer@mariax	complacer@mariax	medio@mariax	detestar@mariax	agradar@mariax	crear@mariax	aprender@mariax	magnitud@mariax	óptica@mariax	enamorar@mariax	árbol@mariax	superficie@mariax	cobrar@mariax	noticia@mariax	avisar@mariax	especial@mariax	pelota@mariax	asentir@mariax	amigo@mariax	conjunto@mariax	heráldica@mariax	pasar@mariax	vagar@mariax	astronomía@mariax	rey@mariax	cubrir@mariax	parecer@mariax	minería@mariax	resultar@mariax	asombrar@mariax	confiar@mariax	delegar@mariax	alto@mariax	recipiente@mariax	objeto@mariax	colocar@mariax	empeorar@mariax	tierra@mariax	percatarse@mariax	cortejar@mariax	loco@mariax	aprobar@mariax	monje@mariax	disimular@mariax	anticipar@mariax	acostumbrar@mariax	valiente@mariax	destinar@mariax	equitación@mariax	letra@mariax	tolerar@mariax	disminuir@mariax	origen@mariax	culto@mariax	ayudar@mariax	vida@mariax	linaje@mariax	incluir@mariax	límite@mariax	afluir@mariax	geografía@mariax	establecer@mariax	tranquilo@mariax	mujer@mariax	instruir@mariax	esperar@mariax	justo@mariax	máquina@mariax	cortar@mariax	poesía@mariax	conceder@mariax	moderar@mariax	torcer@mariax	extremo@mariax	esgrima@mariax	depender@mariax	partidario@mariax	protestar@mariax	presente@mariax	imperfecto@mariax	ofender@mariax	ley@mariax	explicar@mariax	agua@mariax	causa@mariax	gustar@mariax	noun.tops@wnlex	matrimonio@mariax	acordar@mariax	falta@mariax	botánica@mariax	impedir@mariax	lujo@mariax	insignificante@mariax	carruaje@mariax	impulso@mariax	coser@mariax	circunstancia@mariax	calor@mariax	deporte@mariax	química@mariax	holgazán@mariax	criticar@mariax	fruto@mariax	geometría@mariax	conseguir@mariax	solo@mariax	retirar@mariax	guisar@mariax	desechar@mariax	fisiología@mariax	juez@mariax	débil@mariax	familia@mariax	periódico@mariax	dejar@mariax	contener@mariax	salir@mariax	verbo@mariax	extender@mariax	viento@mariax	materia@mariax	referir@mariax	grado@mariax	borde@mariax	nota@mariax	reloj@mariax	pedir@mariax	gastar@mariax	niño@mariax	confundir@mariax	grupo@mariax	eclesiástico@mariax	desconfiar@mariax	unir@mariax	fecha@mariax	devoción@mariax	juntar@mariax	seguro@mariax	calzado@mariax	piedra@mariax	territorio@mariax	brotar@mariax	joven@mariax	simular@mariax	caer@mariax	recurrir@mariax	electricidad@mariax	ocupar@mariax	beneficiar@mariax	delicado@mariax	brío@mariax	depositar@mariax	permanecer@mariax	líquido@mariax	fuego@mariax	moler@mariax	aburrir@mariax	esforzar@mariax	añadir@mariax	incitar@mariax	ingenio@mariax	carretera@mariax	intranquilo@mariax	discutir@mariax	soberano@mariax	elegante@mariax	maltratar@mariax	montaña@mariax	curso@mariax	ignorar@mariax	necesario@mariax	función@mariax	carácter@mariax	adquirir@mariax	línea@mariax	indiferente@mariax	triste@mariax	peligro@mariax	matar@mariax	llegar@mariax	apoderar@mariax	seco@mariax	tapar@mariax	sagaz@mariax	arte@mariax	seguir@mariax	año@mariax	herir@mariax	propio@mariax	excitar@mariax	carta@mariax	igual@mariax	mente@mariax	perjuicio@mariax	cansar@mariax	imagen@mariax	observar@mariax	serie@mariax	signo@mariax	ruido@mariax	violento@mariax	situación@mariax	metal@mariax	pluma@mariax	repartir@mariax	noun.substance@wnlex	gente@mariax	escultura@mariax	muchacho@mariax	arrepentirse@mariax	consecuencia@mariax	destacado@mariax	someter@mariax	favor@mariax	atacar@mariax	desazón@mariax	alterar@mariax	motivo@mariax	doblar@mariax	política@mariax	ocio@mariax	despojar@mariax	sabor@mariax	norma@mariax	capacidad@mariax	tributo@mariax	contrato@mariax	tempestad@mariax	remedio@mariax	viajar@mariax	derribar@mariax	alojar@mariax	vacilar@mariax	carro@mariax	labrar@mariax	después@mariax	queja@mariax	rico@mariax	emprender@mariax	indigno@mariax	presumir@mariax	comedir@mariax	estar@mariax	ancho@mariax	echar@mariax	cumplir@mariax	mantener@mariax	profesión@mariax	firme@mariax	novio@mariax	énfasis@mariax	lado@mariax	anormal@mariax	pequeño@mariax	fuente@mariax	verb.consumption@wnlex	misa@mariax	deuda@mariax	aproximar@mariax	responsabilidad@mariax	estable@mariax	ejercer@mariax	soltar@mariax	oler@mariax	hijo@mariax	rozar@mariax	espada@mariax	grabar@mariax	asiento@mariax	cabeza@mariax	iglesia@mariax	fondo@mariax	risa@mariax	arco@mariax	corriente@mariax	impaciente@mariax	carpintero@mariax	horno@mariax	contagiar@mariax	astuto@mariax	advertir@mariax	esfera@mariax	boca@mariax	aumentar@mariax	apasionar@mariax	respetar@mariax	proceder@mariax	aislar@mariax	raro@mariax	deshonrar@mariax	adelantar@mariax	poner@mariax	cerdo@mariax	partir@mariax	saludar@mariax	romper@mariax	acertar@mariax	tienda@mariax	actividad@mariax	artillería@mariax	lanzar@mariax	extraordinario@mariax	adj.pert@wnlex	abatir@mariax	pretexto@mariax	campana@mariax	colgar@mariax	divertir@mariax	categoría@mariax	manar@mariax	retroceder@mariax	insensible@mariax	pieza@mariax	buscar@mariax	despierto@mariax	tragar@mariax	imitar@mariax	apoyar@mariax	censo@mariax	humor@mariax	albergar@mariax	verdad@mariax	aprovechar@mariax	estrecho@mariax	introducir@mariax	suave@mariax	comparar@mariax	comprometer@mariax	magnífico@mariax	escaso@mariax	reforzar@mariax	noun.food@wnlex	pelo@mariax	libre@mariax	negar@mariax	severo@mariax	vender@mariax	bajo@mariax	agitar@mariax	noun.possession@wnlex	ilusión@mariax	flor@mariax	verb.competition@wnlex	encontrar@mariax	lleno@mariax	padre@mariax	delito@mariax	susto@mariax	cauce@mariax	afeminado@mariax	vasija@mariax	vuelta@mariax	preciso@mariax	vicio@mariax	desembarazar@mariax	geología@mariax	difamar@mariax	interpretar@mariax	emoción@mariax	proyecto@mariax	ventana@mariax	derrochar@mariax	sensato@mariax	resto@mariax	rezar@mariax	ceder@mariax	lucir@mariax	salud@mariax	farmacia@mariax	heredar@mariax	admirar@mariax	limpiar@mariax	miedo@mariax	entusiasmar@mariax	convencional@mariax	encubrir@mariax	humillar@mariax	oratoria@mariax	delgado@mariax	educar@mariax	historia@mariax	acceder@mariax	noun.phenomenon@wnlex	ganar@mariax	lavar@mariax	gritar@mariax	procesión@mariax	mejor@mariax	aliviar@mariax	filtrar@mariax	coger@mariax	alma@mariax	curvo@mariax	excelente@mariax	digerir@mariax	desafiar@mariax	piel@mariax	sucio@mariax	convenir@mariax	desengaño@mariax	tropa@mariax	elegir@mariax	disparar@mariax	extrañar@mariax	falso@mariax	silogismo@mariax	convertir@mariax	muchedumbre@mariax	robar@mariax	mezclar@mariax	crecer@mariax	tallo@mariax	deslizar@mariax	levantar@mariax	derecho@mariax	punta@mariax	chasco@mariax	pecado@mariax	perfecto@mariax	enterrar@mariax	vela@mariax	asociar@mariax	solución@mariax	preocupar@mariax	regalar@mariax	clavo@mariax	mancha@mariax	soldado@mariax	moral@mariax	ferrocarril@mariax	breve@mariax	raza@mariax	criar@mariax	tímido@mariax	independiente@mariax	papel@mariax	encerrar@mariax	útil@mariax	gallardo@mariax	provecho@mariax	lotería@mariax	desagradar@mariax	confesar@mariax	amable@mariax	proveer@mariax	desconsideración@mariax	billar@mariax	oficina@mariax	discurso@mariax	erguir@mariax	pesar@mariax	reservar@mariax	prometer@mariax	contrario@mariax	cama@mariax	derivación@mariax	disculpa@mariax	hacer@mariax	genio@mariax	obtener@mariax	aire@mariax	peor@mariax	guiar@mariax	armadura@mariax	cirugía@mariax	charlar@mariax	componer@mariax	desairar@mariax	carecer@mariax	teléfono@mariax	fácil@mariax	mustio@mariax	retoñar@mariax	calificar@mariax	local@mariax	mueble@mariax	afición@mariax	dedo@mariax	apuro@mariax	mendigo@mariax	retrasar@mariax	amancebarse@mariax	tonto@mariax	cuerno@mariax	utensilio@mariax	disponer@mariax	distraer@mariax	apetecer@mariax	modelo@mariax	retratar@mariax	temporada@mariax	cocina@mariax	huir@mariax	vil@mariax	mitología@mariax	pegar@mariax	desaparecer@mariax	inmóvil@mariax	sustituir@mariax	vacío@mariax	genealogía@mariax	evitar@mariax	enemigo@mariax	no@mariax	tardar@mariax	descansar@mariax	chico@mariax	viejo@mariax	gimnasia@mariax	irritar@mariax	brillar@mariax	borracho@mariax	mecánica@mariax	testimonio@mariax	inmoral@mariax	gordo@mariax	abrir@mariax	atrever@mariax	brusco@mariax	velar@mariax	sedimento@mariax	dormir@mariax	torpe@mariax	perdonar@mariax	lento@mariax	poder@mariax	capa@mariax	apretar@mariax	perseguir@mariax	recubrir@mariax	atmósfera@mariax	desperdiciar@mariax	dolor@mariax	santo@mariax	desacertar@mariax	guapo@mariax	hueso@mariax	admitir@mariax	obstinación@mariax	escalera@mariax	forzar@mariax	eterno@mariax	deducir@mariax	biología@mariax	felicidad@mariax	refutar@mariax	respirar@mariax	travieso@mariax	queso@mariax	telégrafo@mariax	desentenderse@mariax	inspirar@mariax	llover@mariax	recolección@mariax	hambre@mariax	asustar@mariax	incompleto@mariax	indiscutible@mariax	arreglar@mariax	inseguro@mariax	posible@mariax	sutil@mariax	fotografía@mariax	quieto@mariax	curioso@mariax	secreto@mariax	pierna@mariax	dignidad@mariax	producir@mariax	automóvil@mariax	abundar@mariax	escena@mariax	diligente@mariax	cruel@mariax	grosero@mariax	marca@mariax	ceremonia@mariax	muro@mariax	abandonar@mariax	aturdir@mariax	subir@mariax	encantar@mariax	inútil@mariax	todo@mariax	enviar@mariax	eucaristía@mariax	rama@mariax	suprimir@mariax	psicología@mariax	conformar@mariax	sol@mariax	insignia@mariax	coacción@mariax	conservar@mariax	obsequiar@mariax	ensalzar@mariax	jesucristo@mariax	cobarde@mariax	sincero@mariax	informática@mariax	estropear@mariax	costa@mariax	ventaja@mariax	sortear@mariax	entregar@mariax	estómago@mariax	desorden@mariax	donación@mariax	afectación@mariax	diente@mariax	impertinente@mariax	desvergüenza@mariax	perro@mariax	oscuro@mariax	gestionar@mariax	detrás@mariax	sangre@mariax	palo@mariax	cielo@mariax	silencio@mariax	narcótico@mariax	culpa@mariax	azúcar@mariax	encolerizar@mariax	ponderar@mariax	excavar@mariax	oír@mariax	rechazar@mariax	arrendar@mariax	camisa@mariax	hospital@mariax	decaer@mariax	claro@mariax	cólera@mariax	chisme@mariax	intolerable@mariax	sitiar@mariax	participar@mariax	postura@mariax	serio@mariax	virtud@mariax	tipo@mariax	vulgar@mariax	nuevo@mariax	acoger@mariax	cuerda@mariax	ansiar@mariax	prevenir@mariax	mano@mariax	poco@mariax	hechicería@mariax	ilustre@mariax	traidor@mariax	tronco@mariax	puerto@mariax	techo@mariax	exterior@mariax	lisonja@mariax	ensayar@mariax	herramienta@mariax	atenuar@mariax	cargar@mariax	malograr@mariax	húmedo@mariax	malicioso@mariax	desviar@mariax	fracasar@mariax	girar@mariax	desigualdad@mariax	cabo@mariax	encargar@mariax	cooperar@mariax	inconveniente@mariax	cojo@mariax	abeja@mariax	recado@mariax	quitar@mariax	sombrero@mariax	inclinar@mariax	balancear@mariax	insensato@mariax	benévolo@mariax	caro@mariax	recibir@mariax	vid@mariax	atar@mariax	fijar@mariax	economía@mariax	limosna@mariax	modo@mariax	plata@mariax	mineral@mariax	ángulo@mariax	energía@mariax	insolente@mariax	lista@mariax	evadir@mariax	excluir@mariax	deslucir@mariax	ridículo@mariax	descuidar@mariax	oro@mariax	arriesgar@mariax	terror@mariax	universidad@mariax	tejado@mariax	noun.plant@wnlex	exacto@mariax	oveja@mariax	diferir@mariax	afán@mariax	jefe@mariax	caja@mariax	arbitrario@mariax	puro@mariax	entrometer@mariax	hilo@mariax	ocasión@mariax	enredar@mariax	harto@mariax	dispersar@mariax	censurar@mariax	noun.quantity@wnlex	pasear@mariax	coincidir@mariax	gruñir@mariax	extravagante@mariax	describir@mariax	envasar@mariax	moda@mariax	imponer@mariax	ostentar@mariax	avergonzar@mariax	pobre@mariax	café@mariax	abrigar@mariax	cohabitar@mariax	abusar@mariax	cosecha@mariax	falda@mariax	paz@mariax	veterinaria@mariax	mentir@mariax	proyectil@mariax	intrigar@mariax	seda@mariax	poseer@mariax	elemento@mariax	subasta@mariax	dispensar@mariax	trampa@mariax	tocar@mariax	resumir@mariax	machacar@mariax	apresurar@mariax	costar@mariax	hervir@mariax	cobertizo@mariax	pan@mariax	desaguar@mariax	pescar@mariax	estimular@mariax	citar@mariax	casto@mariax	embelesar@mariax	despojo@mariax	flaquear@mariax	imposible@mariax	denso@mariax	recoger@mariax	exigir@mariax	duro@mariax	predecir@mariax	leña@mariax	feo@mariax	garantía@mariax	cine@mariax	apresar@mariax	anular@mariax	mesa@mariax	encumbrar@mariax	reflejar@mariax	despreocuparse@mariax	aduana@mariax	eximir@mariax	desgastar@mariax	corregir@mariax	desprender@mariax	ahora@mariax	robusto@mariax	simpatía@mariax	preparar@mariax	ahuyentar@mariax	granuja@mariax	demostrar@mariax	barato@mariax	encuadernar@mariax	remate@mariax	saliente@mariax	sacar@mariax	inquieto@mariax	pasión@mariax	jardín@mariax	pez@mariax	tacaño@mariax	chocar@mariax	obrero@mariax	actitud@mariax	distancia@mariax	volar@mariax	peinar@mariax	exceptuar@mariax	cueva@mariax	pavimento@mariax	noun.shape@wnlex	mapa@mariax	sentencia@mariax	retener@mariax	hipotético@mariax	competir@mariax	compensar@mariax	baquetear@mariax	grieta@mariax	cercar@mariax	pie@mariax	policía@mariax	carrera@mariax	antiguo@mariax	casar@mariax	círculo@mariax	íntimo@mariax	envolver@mariax	ceñir@mariax	llanura@mariax	insustancial@mariax	músculo@mariax	joya@mariax	suelto@mariax	acusar@mariax	hoja@mariax	estrofa@mariax	prestar@mariax	cohibir@mariax	gesto@mariax	mundo@mariax	disconforme@mariax	hidráulico@mariax	sembrar@mariax	huella@mariax	romano@mariax	explorar@mariax	transigir@mariax	sacrificio@mariax	mimar@mariax	imprudente@mariax	angustia@mariax	vergüenza@mariax	deslumbrar@mariax	casual@mariax	cavidad@mariax	merecer@mariax	agradecer@mariax	turbar@mariax	tumor@mariax	condimentar@mariax	raíz@mariax	cuchillo@mariax	copiar@mariax	insecto@mariax	monte@mariax	cosa@mariax	órgano@mariax	ajetrear@mariax	rojo@mariax	consejo@mariax	pronunciar@mariax	inspección@mariax	tapiz@mariax	patria@mariax	caricia@mariax	ambición@mariax	ofuscar@mariax	noche@mariax	infalible@mariax	alimentar@mariax	mercado@mariax	cráneo@mariax	cuello@mariax	injustificado@mariax	pendiente@mariax	degenerar@mariax	frío@mariax	olvido@mariax	transparente@mariax	callejear@mariax	atravesar@mariax	hoyo@mariax	hundir@mariax	hospedar@mariax	bulto@mariax	convento@mariax	desahogar@mariax	refugio@mariax	confirmar@mariax	esparcir@mariax	aprovisionar@mariax	lejos@mariax	sepultura@mariax	alternar@mariax	explosión@mariax	radio@mariax	naturalidad@mariax	guarnición@mariax	desobedecer@mariax	preferir@mariax	mojar@mariax	cadáver@mariax	apartar@mariax	intermedio@mariax	rodear@mariax	prisión@mariax	probar@mariax	alisar@mariax	fecundar@mariax	desenvoltura@mariax	canal@mariax	número@mariax	perseverar@mariax	imprevisión@mariax	cinismo@mariax	solemne@mariax	tosco@mariax	ahorrar@mariax	estafar@mariax	verb.weather@wnlex	sacramento@mariax	adivinar@mariax	precipitar@mariax	malhumorado@mariax	nariz@mariax	blando@mariax	nadar@mariax	quemar@mariax	bordar@mariax	tejido@mariax	bulla@mariax	pájaro@mariax	desorientar@mariax	rueda@mariax	colección@mariax	obstruir@mariax	adjetivo@mariax	colegio@mariax	tormento@mariax	altar@mariax	provocar@mariax	diplomacia@mariax	retribución@mariax	regocijo@mariax	pinchar@mariax	contiguo@mariax	deshonesto@mariax	desierto@mariax	rellenar@mariax	prescindir@mariax	contorno@mariax	baño@mariax	complicar@mariax	lana@mariax	costumbre@mariax	podar@mariax	espina@mariax	útero@mariax	finca@mariax	vehículo@mariax	espantar@mariax	columna@mariax	temblar@mariax	regar@mariax	antipatía@mariax	dócil@mariax	crepúsculo@mariax	pretender@mariax	brújula@mariax	industria@mariax	formación@mariax	destituir@mariax	vidrio@mariax	pedante@mariax	manía@mariax	broma@mariax	cetrería@mariax	soso@mariax	fingir@mariax	cigarro@mariax	pasto@mariax	embargar@mariax	montar@mariax	avión@mariax	ola@mariax	cinta@mariax	cristiano@mariax	destreza@mariax	evidente@mariax	escándalo@mariax	generoso@mariax	bóveda@mariax	cerámica@mariax	alfombra@mariax	retrete@mariax	circunferencia@mariax	brida@mariax	sal@mariax	despedir@mariax	nervio@mariax	inesperado@mariax	molusco@mariax	municipio@mariax	tonel@mariax	cal@mariax	preguntar@mariax	disparate@mariax	jugo@mariax	discordia@mariax	polvo@mariax	llorar@mariax	renunciar@mariax	remendar@mariax	pasmar@mariax	cruz@mariax	mama@mariax	vengar@mariax	intimidar@mariax	desaprobar@mariax	plantar@mariax	desnudo@mariax	hortaliza@mariax	descortés@mariax	cómodo@mariax	disolver@mariax	pesado@mariax	memoria@mariax	teñir@mariax	desanimar@mariax	maduro@mariax	enseguida@mariax	fluir@mariax	fonético@mariax	embalar@mariax	zaherir@mariax	prohibir@mariax	ser@mariax	hostil@mariax	tirar@mariax	bruto@mariax	correo@mariax	tabaco@mariax	barro@mariax	excesivo@mariax	categórico@mariax	noun.relation@wnlex	astrología@mariax	vanidad@mariax	burla@mariax	llama@mariax	premio@mariax	desesperar@mariax	onda@mariax	ademán@mariax	criba@mariax	honrado@mariax	tornillo@mariax	secreción@mariax	fanfarrón@mariax	polea@mariax	tergiversar@mariax	huevo@mariax	libertino@mariax	descontentar@mariax	orgullo@mariax	jurisdicción@mariax	bobo@mariax	máximo@mariax	orina@mariax	rebelarse@mariax	sereno@mariax	griego@mariax	huerto@mariax	judío@mariax	pasatiempo@mariax	oficio@mariax	leche@mariax	indiscreto@mariax	afilar@mariax	fortalecer@mariax	noun.process@wnlex	brazo@mariax	parir@mariax	blanco@mariax	biblia@mariax	ejecutar@mariax	legumbre@mariax	bolsa@mariax	salvar@mariax	espeso@mariax	molde@mariax	fundir@mariax	hipocresía@mariax	chorro@mariax	parroquia@mariax	mono@mariax	negro@mariax	correr@mariax	nudo@mariax	desacuerdo@mariax	nube@mariax	aceite@mariax	adulterio@mariax	incapaz@mariax	aroma@mariax	arrastrar@mariax	bosque@mariax	recto@mariax	estado@mariax	esplendor@mariax	adusto@mariax	condición@mariax	renta@mariax	bravucón@mariax	arrugar@mariax	pereza@mariax	desatender@mariax	informal@mariax	figura@mariax	inestable@mariax	injusto@mariax	semana@mariax	remo@mariax	lujuria@mariax	uva@mariax	cantería@mariax	atropellar@mariax	hielo@mariax	mamarracho@mariax	cosmético@mariax	arado@mariax	encender@mariax	hierro@mariax	bautizar@mariax	resina@mariax	aversión@mariax	pastel@mariax	paliza@mariax	sacudir@mariax	pueblo@mariax	dulce@mariax	rival@mariax	plano@mariax	glotón@mariax	depresión@mariax	red@mariax	impudor@mariax	plaga@mariax	irregular@mariax	uña@mariax	humo@mariax	inconstante@mariax	comentar@mariax	sublevar@mariax	golosina@mariax	desavenir@mariax	ladrillo@mariax	escrupuloso@mariax	canalla@mariax	extranjero@mariax	arruinar@mariax	sumergir@mariax	lesión@mariax	vomitar@mariax	desmayar@mariax	franco@mariax	anillo@mariax	ardid@mariax	frustrar@mariax	repugnar@mariax	preso@mariax	ejemplo@mariax	colchón@mariax	deterioro@mariax	entristecer@mariax	topografía@mariax	yeso@mariax	sacrificar@mariax	cimiento@mariax	pasamanería@mariax	hierba@mariax	obispo@mariax	lanza@mariax	sello@mariax	evacuar@mariax	demonio@mariax	improvisar@mariax	dos@mariax	cocer@mariax	cortina@mariax	indeterminado@mariax	tubo@mariax	abiertamente@mariax	futuro@mariax	filosofía@mariax	pantalón@mariax	jabalí@mariax	parásito@mariax	ballesta@mariax	indeciso@mariax	carbón@mariax	parcial@mariax	domar@mariax	rizar@mariax	gallina@mariax	segar@mariax	ladrón@mariax	expresión@mariax	infringir@mariax	renovar@mariax	mies@mariax	pudrir@mariax	úlcera@mariax	ligero@mariax	leer@mariax	flaco@mariax	moldura@mariax	noun.motive@wnlex	sombra@mariax	ciervo@mariax	virgen@mariax	mequetrefe@mariax	corazón@mariax	erupción@mariax	contradecir@mariax	acicalar@mariax	formal@mariax	disgregar@mariax	surco@mariax	pelar@mariax	sobrar@mariax	hongo@mariax	curtir@mariax	melindre@mariax	barba@mariax	majadero@mariax	untar@mariax	aglomerar@mariax	trigo@mariax	maldecir@mariax	bandera@mariax	armario@mariax	inoportuno@mariax	esclavo@mariax	televisión@mariax	repentino@mariax	arácnido@mariax	vena@mariax	próximo@mariax	indio@mariax	antes@mariax	rumiante@mariax	papa@mariax	saltar@mariax	corteza@mariax	luna@mariax	emoliente@mariax	embarazo@mariax	frecuente@mariax	pienso@mariax	cautela@mariax	sílice@mariax	guitarra@mariax	gratis@mariax	ancla@mariax	espalda@mariax	sonsacar@mariax	maíz@mariax	encoger@mariax	cataplasma@mariax	descaro@mariax	cicatriz@mariax	horizonte@mariax	infeliz@mariax	estallar@mariax	silla@mariax	cáñamo@mariax	pastor@mariax	imán@mariax	herrar@mariax	diccionario@mariax	entereza@mariax	inquisición@mariax	grasa@mariax	cualidad@mariax	ensamblar@mariax	casco@mariax	consolar@mariax	paloma@mariax	almohada@mariax	chapuza@mariax	adular@mariax	afeitar@mariax	riñón@mariax	zalamería@mariax	zascandil@mariax	prostitución@mariax	trillar@mariax	paño@mariax	tabla@mariax	desdecir@mariax	rabia@mariax	montón@mariax	alfabeto@mariax	embriología@mariax	muñeco@mariax	embarullar@mariax	lente@mariax	irreflexivo@mariax	hinchar@mariax	adelgazar@mariax	goma@mariax	jabón@mariax	españa@mariax	nada@mariax	chocolate@mariax	crustáceo@mariax	disturbio@mariax	intestino@mariax	refresco@mariax	prestidigitación@mariax	himno@mariax	mes@mariax	veneno@mariax	halcón@mariax	acróbata@mariax	cereal@mariax	funeral@mariax	sopa@mariax	minucioso@mariax	fantoche@mariax	disputar@mariax	corral@mariax	raquítico@mariax	motor@mariax	infundado@mariax	expeditivo@mariax	chuchería@mariax	labio@mariax	forja@mariax	arrancar@mariax	estrella@mariax	marisco@mariax	católico@mariax	musulmán@mariax	presa@mariax	cabra@mariax	desamparo@mariax	cerebro@mariax	harina@mariax	ácido@mariax	recaudar@mariax	fiebre@mariax	parálisis@mariax	equilibrio@mariax	haz@mariax	abono@mariax	lino@mariax	átomo@mariax	rendir@mariax	cola@mariax	lamelibranquio@mariax	buey@mariax	gato@mariax	diezmo@mariax	estirado@mariax	caracol@mariax	pulmón@mariax	engrescar@mariax	tambor@mariax	saliva@mariax	marea@mariax	nieve@mariax	jugada@mariax	revolución@mariax	roca@mariax	hampa@mariax	circo@mariax	moco@mariax	abstraer@mariax	chusma@mariax	fumar@mariax	maestro@mariax	castrar@mariax	embutido@mariax	cementerio@mariax	desinfectar@mariax	encina@mariax	inminente@mariax	vientre@mariax	salsa@mariax	pantano@mariax	adversativo@mariax	choza@mariax	predicar@mariax	cesta@mariax	emperador@mariax	pirotecnia@mariax	alcahuete@mariax	sentar@mariax	rebajar@mariax	porteador@mariax	juerga@mariax	andrajo@mariax	inflamar@mariax	correlación@mariax	multiplicar@mariax	saco@mariax	carnaval@mariax	serpiente@mariax	asiático@mariax	vaca@mariax	contemporizar@mariax	hermano@mariax	charco@mariax	hereje@mariax	cazurro@mariax	envanecer@mariax	garganta@mariax	correa@mariax	plomo@mariax	cobre@mariax	amostazar@mariax	excremento@mariax	protestantismo@mariax	entumecer@mariax	manta@mariax	muy@mariax	fétido@mariax	navidad@mariax	látigo@mariax	purgante@mariax	microorganismo@mariax	comparación@mariax	escudo@mariax	sudar@mariax	electrónica@mariax	conspirar@mariax	concha@mariax	especia@mariax	marroquí@mariax	caña@mariax	resistir@mariax	mariposa@mariax	infectar@mariax	cadena@mariax	yugo@mariax	alcaloide@mariax	concesivo@mariax	gusano@mariax	onomatopeya@mariax	lago@mariax	lagarto@mariax	alemán@mariax	colcha@mariax	óxido@mariax	denigrar@mariax	calabaza@mariax	célula@mariax	ceniza@mariax	coleóptero@mariax	maltrecho@mariax	conejo@mariax	torta@mariax	cardenal@mariax	glándula@mariax	africano@mariax	fósil@mariax	loro@mariax	siempre@mariax	adj.ppl@wnlex	liebre@mariax	lechuza@mariax	cáncer@mariax
ne0002	3516	3238	2138	1738	1762	2167	2006	1652	1557	1589	1499	1675	1561	1523	1139	1378	1426	1096	1197	1257	1077	1349	827	1634	972	1034	1102	875	1004	1046	916	1103	973	1225	816	891	1214	873	909	656	951	970	652	1094	1252	1068	1102	895	782	923	1043	867	875	674	1045	929	661	687	824	1046	965	912	577	573	737	836	1075	1011	842	668	794	699	650	532	666	682	755	706	653	609	916	694	1165	594	577	891	552	708	533	718	903	514	910	481	608	503	841	805	785	995	631	828	736	872	834	676	676	903	553	882	577	628	906	879	847	491	828	615	466	792	673	876	437	534	582	836	631	712	813	771	729	595	457	565	489	506	471	533	784	612	598	671	539	561	357	605	683	444	637	524	685	540	586	472	505	495	561	580	795	773	569	460	590	448	564	432	510	486	422	935	508	505	668	442	702	408	461	740	492	409	353	527	575	405	570	305	566	393	449	438	293	524	336	586	454	703	466	691	307	588	407	374	429	587	532	582	486	465	512	496	698	533	338	481	238	600	428	291	455	426	378	577	388	503	347	726	366	379	471	426	386	516	412	446	438	385	358	366	417	502	541	378	470	485	327	364	480	345	399	365	452	357	418	323	506	650	295	496	322	377	604	375	396	366	412	491	443	365	349	304	599	396	516	354	434	339	266	473	284	345	292	323	463	319	421	295	294	430	292	483	327	474	285	277	494	244	775	316	367	387	345	333	311	302	424	367	396	391	301	341	354	346	310	351	312	255	379	336	627	419	413	263	356	337	336	628	379	356	406	446	313	495	351	512	455	390	482	196	419	346	300	418	327	269	369	339	367	342	352	296	377	267	273	311	315	435	278	342	241	356	319	250	580	328	243	253	365	287	423	347	306	324	291	325	373	370	184	206	372	304	149	291	288	383	202	349	342	251	311	362	222	423	428	315	406	339	201	282	256	437	232	217	362	324	321	257	303	225	325	248	255	258	262	385	165	148	258	354	339	285	247	205	266	310	340	286	280	345	258	248	561	317	247	264	335	258	248	209	243	324	306	224	219	243	192	291	369	175	208	264	304	359	267	264	205	212	254	209	196	325	300	136	154	235	198	270	267	238	220	238	254	304	270	327	320	205	300	252	171	220	206	169	219	271	256	177	306	475	542	184	237	213	218	187	180	268	266	265	181	295	296	324	227	459	520	263	218	162	211	359	234	238	319	279	219	209	255	241	243	352	243	211	187	153	220	260	206	156	173	178	194	218	296	192	215	162	275	226	113	211	178	228	189	273	185	129	214	157	141	328	180	178	278	193	175	149	261	175	162	221	277	248	201	240	240	278	220	272	181	205	357	104	149	225	204	447	265	344	261	189	210	177	217	178	195	345	242	236	176	233	206	200	332	130	238	197	257	147	308	207	166	211	242	222	201	151	147	153	159	176	208	102	156	127	164	169	170	239	154	177	219	165	172	183	202	208	150	133	192	158	218	147	169	131	126	143	239	156	185	195	150	109	259	175	175	156	122	172	121	184	189	237	143	200	244	126	183	436	138	227	210	295	205	203	227	181	178	179	341	165	192	139	183	414	176	281	152	129	367	165	175	157	129	144	146	130	222	107	152	139	175	129	202	174	149	152	167	98	162	91	224	155	168	225	155	187	257	187	225	108	151	111	109	142	176	162	147	148	138	120	103	121	192	119	111	108	170	229	179	131	171	116	164	256	152	148	189	226	141	118	123	106	213	151	173	136	96	172	160	159	152	167	121	160	176	156	198	111	142	172	145	165	125	140	167	117	99	200	119	131	144	141	257	119	181	122	195	145	183	175	201	149	118	174	118	184	118	140	123	205	100	133	132	154	100	137	104	180	157	124	213	127	99	122	129	158	150	255	118	110	112	130	150	136	123	134	128	178	341	107	160	146	130	157	178	92	134	82	120	100	165	89	146	201	113	145	125	113	85	119	114	84	385	125	100	122	149	115	102	60	129	77	101	200	83	85	94	103	85	115	160	177	109	88	102	114	97	66	104	97	128	101	130	213	135	128	140	92	113	78	113	125	144	184	109	130	183	179	123	112	101	100	100	93	78	197	178	129	116	135	101	103	93	60	79	118	173	125	98	122	87	149	185	129	106	78	86	111	120	80	125	170	88	112	85	113	130	125	90	62	79	89	98	93	81	94	89	90	56	101	82	135	104	170	124	119	148	114	99	137	133	89	88	90	60	81	64	138	75	169	138	83	73	106	77	127	102	114	108	87	115	79	98	97	71	69	102	127	104	133	107	71	68	133	90	82	131	107	168	83	59	135	66	92	115	97	79	74	148	122	92	119	59	109	73	98	148	88	77	105	120	122	133	75	108	88	79	92	96	110	75	115	115	76	77	85	143	215	86	79	111	63	122	132	62	71	116	69	97	131	90	78	74	72	65	72	88	105	110	62	80	105	70	133	101	88	97	77	120	66	62	193	131	98	96	86	71	126	91	123	96	88	239	76	106	115	99	76	57	75	81	115	100	138	67	86	47	88	126	57	75	65	84	75	121	115	78	240	92	74	64	126	103	70	82	93	89	134	75	162	76	74	56	100	136	45	47	107	94	48	53	84	64	115	85	92	109	75	64	77	78	53	86	79	87	68	146	77	93	72	143	69	101	175	82	59	61	65	57	69	65	80	81	60	35	62	70	79	37	97	133	67	54	94	65	62	68	53	72	78	79	55	39	53	75	63	84	36	46	84	139	68	48	63	66	67	75	71	41	76	86	80	60	88	73	64	62	102	63	95	95	56	61	115	73	38	49	74	35	88	56	102	45	40	59	57	39	60	37	57	54	52	98	135	218	73	49	47	57	79	48	70	33	83	79	57	57	89	63	48	77	68	44	63	60	41	56	64	58	60	74	43	123	66	45	74	35	91	28	72	56	53	35	39	56	79	68	74	92	50	66	111	103	27	93	74	39	59	40	60	34	28	51	50	53	43	86	55	56	40	74	30	46	50	56	38	86	50	78	73	59	62	68	80	31	45	75	69	59	62	27	49	37	37	32	51	32	42	21	39	41	41	50	61	41	51	52	32	66	49	59	44	34	47	62	37	72	62	38	41	41	54	67	42	37	46	70	34	38	34	49	50	70	65	54	71	21	33	48	33	44	46	48	62	56	46	102	42	37	53	38	30	55	41	72	111	84	47	41	45	29	38	49	30	31	25	47	67	40	82	49	14	43	44	35	41	55	59	32	53	50	40	49	24	51	52	22	44	34	72	59	52	59	30	48	31	50	47	42	73	60	46	53	28	23	39	27	81	19	28	36	59	44	45	34	23	39	29	42	48	90	59	43	75	28	38	44	28	49	54	39	37	29	51	33	38	77	34	53	50	28	43	17	46	22	45	52	33	24	31	32	39	32	24	44	71	42	36	36	44	19	24	32	30	32	49	31	70	62	19	34	48	22	20	46	24	30	84	25	31	39	37	40	49	29	26	18	25	35	33	55	42	55	21	20	15	27	29	46	35	34	30	23	37	42	40	34	23	50	29	24	38	32	35	25	15	52	17	46	28	58	31	86	35	37	30	26	42	14	24	24	34	34	16	30	26	17	33	30	20	47	41	32	19	27	21	27	25	25	23	10	37	11	36	25	27	19	27	18	52	12	18	12	26	29	17	36	37	16	29	27	31	40	21	15	27	23	27	11	20	28	12	20	14	19	29	20	10	19	11	25	14	27	17	33	21	30	25	48	16	39	22	10	43	27	23	18	14	20	23	22	39	8	18	39	27	23	30	21	19	23	18	22	12	28	25	8	22	21	23	26	6	34	9	14	15	9	18	29	9	21	14	11	17	17	38	26	6	25	12	55	12	99	13	17	26	15	23	15	12	15	31	17	12	15	10	16	25	11	9	15	29	9	14	13	11	20	18	71	9	18	11	27	34	5	17	9	12	10	23	13	5	13	14	12	17	9	19	25	8	11	14	16	12	16	9	6	8	11	9	20	0	12	8	19	8	24	7	18	6	22	14	7	13	42	6	10	10	9	18	7	1	9	5	6	13	4	31	6	12	8	14	14	12	15	12	4	18	10	9	8	3	6	3	4	6	2	1	5	4	13	16	10	3	4	12	6	10	6	9	4	2	16	7	39	1	5	3	4	1	5	1	3	2	9	5	1	3	1	2	0	0	0	5	1	1	1	9	2	5	38	1	2	6	1	1	0	0
ne0003	2748	2427	1555	1393	1130	1714	1448	1327	1231	1272	1157	1378	1411	1333	977	1010	1232	947	825	1007	892	1120	775	821	743	834	895	725	823	902	749	787	824	989	748	739	922	633	668	590	695	766	579	726	809	813	856	688	682	722	818	647	646	487	668	748	562	530	671	683	751	507	438	565	632	645	849	577	498	494	483	445	571	642	479	503	728	568	565	467	694	506	797	479	409	740	455	557	386	559	635	395	759	443	478	418	747	553	396	416	549	464	533	684	487	569	551	687	490	575	468	443	717	684	693	389	692	475	366	679	547	684	406	442	435	528	469	430	700	625	522	467	410	379	465	386	450	375	625	518	529	575	391	451	324	498	456	386	528	498	529	389	526	383	358	399	457	403	628	496	464	366	457	487	420	325	349	447	264	456	420	417	469	414	616	309	337	584	376	335	261	364	378	393	407	232	367	336	330	334	314	470	313	453	384	453	354	575	386	463	274	353	292	405	350	451	318	368	452	351	608	632	327	374	237	511	365	270	328	342	314	346	204	371	316	541	347	348	322	335	250	374	356	261	388	267	234	240	320	378	580	307	302	482	362	359	493	338	354	232	373	297	322	280	335	538	258	359	296	308	342	284	272	313	287	320	339	312	293	298	445	292	356	309	419	235	245	295	259	269	235	246	302	262	306	268	233	248	240	268	267	393	195	260	530	227	394	304	280	275	226	199	227	224	303	217	312	304	305	295	218	252	191	317	264	284	292	296	281	320	350	233	296	331	335	399	254	304	306	329	282	371	274	220	243	291	293	208	281	288	221	359	229	174	326	257	255	239	223	229	209	229	177	211	216	365	232	274	228	256	269	205	284	258	186	222	254	227	345	251	236	221	211	222	259	281	246	200	321	247	218	200	210	311	300	204	271	155	226	256	209	407	293	223	181	244	174	218	203	180	206	133	343	223	265	213	238	171	306	177	209	199	214	291	198	210	163	347	267	215	153	187	194	217	308	143	179	243	148	249	242	242	138	214	206	173	260	175	197	250	272	181	212	156	178	208	230	211	183	222	223	193	187	205	131	131	209	159	167	275	253	100	131	140	170	200	142	193	169	170	305	241	165	219	318	168	235	131	133	187	100	122	165	193	193	166	190	219	229	219	150	171	151	236	133	213	218	200	185	215	174	244	167	232	238	254	167	141	192	225	164	242	196	144	167	154	183	249	176	334	185	164	97	131	164	206	186	167	147	123	150	203	264	187	174	152	132	149	136	166	130	119	146	182	127	198	155	151	233	229	124	151	191	196	164	119	179	135	161	179	226	166	159	188	145	168	150	189	163	154	166	167	138	136	161	246	92	137	261	182	144	167	190	140	146	209	188	211	138	156	160	195	190	101	207	180	133	151	202	129	147	185	218	156	152	180	166	123	136	200	142	100	102	115	121	120	119	184	104	106	147	124	136	119	200	169	156	127	155	132	169	101	140	109	114	82	77	121	139	149	104	122	157	113	152	145	119	132	81	155	138	165	135	210	166	146	173	212	127	137	140	164	143	220	100	134	158	175	179	148	150	102	160	198	139	93	130	104	118	122	123	121	136	124	84	228	216	67	119	112	115	104	196	170	111	149	105	96	121	58	144	122	105	201	151	86	267	148	147	94	122	188	117	92	92	142	136	99	115	94	141	93	103	66	127	129	149	189	133	121	155	93	107	176	136	139	151	141	106	118	124	100	122	136	111	116	126	161	126	116	76	111	114	101	100	123	151	93	135	154	97	117	99	59	144	93	117	230	57	94	88	112	190	111	89	127	108	123	94	103	210	148	91	98	102	129	80	126	101	77	90	121	118	140	84	144	103	142	95	94	180	92	96	85	109	120	166	160	108	98	83	62	141	58	71	109	76	123	203	63	122	125	64	111	129	82	114	74	85	63	138	94	167	213	65	106	83	63	84	52	112	61	186	81	100	96	88	70	89	51	126	77	111	213	83	87	95	94	76	83	140	122	96	81	107	72	73	73	73	87	95	119	133	206	95	88	116	84	77	66	81	129	124	126	107	97	199	53	93	137	67	82	65	93	154	134	123	67	79	91	70	52	91	72	56	106	94	68	54	71	74	85	177	94	83	64	69	77	108	63	76	177	117	92	83	82	131	140	101	55	46	93	86	52	67	129	80	92	82	110	49	92	78	100	105	91	57	69	84	104	92	75	57	75	72	77	76	148	87	62	167	65	102	90	41	54	114	68	50	75	80	76	83	73	80	53	105	90	77	163	89	74	50	108	69	77	104	45	109	80	46	133	68	85	92	77	54	75	119	75	59	134	76	90	73	68	86	74	56	81	84	107	98	106	58	95	58	84	76	86	79	76	88	68	47	57	64	113	80	80	51	56	83	93	61	76	127	38	69	89	90	57	113	63	84	43	66	59	60	61	58	80	43	127	110	59	51	49	90	57	62	81	70	41	88	51	45	92	67	114	48	99	159	69	49	74	128	51	41	63	88	68	61	105	51	56	40	78	121	61	47	66	70	53	67	54	49	66	107	47	55	94	88	43	65	58	78	90	51	108	45	54	67	126	75	30	70	81	60	61	37	96	47	129	44	60	67	65	73	51	50	56	82	67	50	44	84	58	99	56	99	24	42	69	77	49	58	83	51	51	55	34	78	37	28	80	48	65	50	80	87	42	63	45	75	57	34	22	36	50	58	57	49	46	85	52	63	53	41	49	39	68	33	68	62	53	62	70	32	72	67	89	38	81	46	65	45	57	41	64	54	50	31	71	53	48	37	42	47	93	31	75	67	18	48	52	39	46	22	38	39	47	82	93	40	61	44	41	45	57	34	44	37	76	91	45	37	57	79	37	106	64	23	53	39	46	52	31	39	51	62	46	116	61	43	86	36	40	37	105	52	29	45	40	36	30	47	40	73	27	48	47	97	34	69	48	33	53	64	25	27	81	26	51	67	43	43	43	34	37	62	51	41	68	57	20	34	43	40	77	56	38	83	91	31	42	49	61	53	45	38	21	54	22	28	30	18	43	27	40	39	31	50	23	28	40	32	31	59	43	57	32	51	35	32	30	45	35	26	38	84	25	53	36	22	32	50	29	14	15	29	35	54	67	33	59	75	26	60	40	36	43	56	42	39	40	66	24	35	26	56	48	31	38	90	86	49	38	46	45	11	24	36	30	22	16	26	37	42	93	86	36	31	45	16	28	49	40	36	34	48	53	43	70	45	56	17	11	58	21	47	29	47	41	33	25	49	31	52	67	61	26	27	28	35	48	20	57	20	21	19	34	20	42	60	24	38	48	39	74	41	43	56	28	44	18	39	26	67	28	31	31	36	24	26	26	32	51	43	35	31	25	35	32	20	23	16	44	15	33	28	31	24	29	41	89	25	37	33	33	27	10	69	37	29	74	27	42	45	18	12	32	6	22	31	23	13	62	21	24	38	12	26	18	27	18	28	16	23	31	79	20	67	47	24	16	40	21	24	39	13	17	22	32	68	22	27	34	33	14	35	41	36	32	13	25	27	11	23	31	37	18	22	22	22	21	29	20	27	16	20	42	28	20	15	19	20	35	31	24	52	56	23	12	22	29	26	16	18	24	6	18	12	15	12	20	16	46	16	18	7	23	12	23	22	11	31	14	18	24	14	25	39	31	6	7	24	13	11	16	11	20	25	28	16	13	23	17	14	20	25	11	11	29	21	18	17	20	20	18	28	20	11	35	36	20	16	23	12	19	23	20	24	25	12	18	18	17	20	11	12	23	15	10	40	13	9	14	8	23	20	16	5	13	11	24	11	3	17	12	16	11	7	14	11	22	22	2	28	20	37	10	17	14	11	9	2	11	10	9	12	25	13	4	13	9	18	19	5	10	13	11	5	8	6	11	24	49	46	30	20	10	20	32	8	9	9	13	10	7	31	16	14	6	13	17	10	14	4	18	6	7	7	6	13	9	3	11	5	3	29	1	6	2	29	5	1	6	17	10	15	13	7	8	20	12	6	7	16	4	7	17	4	3	3	4	9	17	5	5	4	18	37	8	20	4	7	3	8	15	11	6	9	1	2	5	3	5	9	0	13	14	14	6	4	9	5	5	8	5	4	2	4	6	21	1	1	3	9	4	7	2	0	0	2	5	6	1	0	0	0	0	2	2	9	3	8	2	6	1	20	1	3	0	1	4	0	0
ne0004	3294	3323	1739	1821	1073	2037	2029	1682	1192	1392	1064	1567	1748	1608	1305	1299	1572	848	1228	1409	861	1227	865	1203	701	842	837	1013	1164	1112	672	1067	827	1160	1055	802	992	618	741	729	749	727	515	763	1239	1128	974	850	1095	699	1077	678	615	784	1160	989	556	490	881	655	946	620	366	538	554	783	1013	682	671	498	538	411	705	547	461	366	551	682	728	463	800	624	1150	625	387	843	639	512	437	664	1113	650	911	430	460	517	814	541	660	573	640	872	813	840	571	524	646	827	638	1011	593	561	871	891	802	601	828	673	386	820	543	827	321	639	557	539	493	375	810	796	472	569	291	391	505	367	361	364	750	521	492	789	495	457	297	636	388	460	645	515	538	394	684	493	429	347	551	334	777	688	511	362	497	498	482	305	380	538	285	818	524	400	501	537	719	426	427	709	353	279	474	416	381	442	355	259	394	480	368	424	384	394	428	453	348	760	385	747	386	520	359	311	301	448	385	479	442	416	569	454	695	392	320	519	385	486	335	281	440	316	232	395	241	466	345	477	343	292	402	358	315	452	340	303	485	389	258	237	356	345	407	262	358	568	217	351	540	274	366	371	274	301	333	273	431	646	234	421	218	280	658	317	315	329	213	387	462	302	300	378	433	335	458	272	331	226	324	441	359	306	260	246	230	281	193	260	352	369	328	429	256	423	201	319	699	283	726	258	378	244	170	166	257	276	459	241	251	305	351	203	200	291	201	290	316	239	399	230	370	348	321	255	317	359	280	657	312	324	384	239	401	433	366	345	343	380	306	174	299	288	297	393	320	233	379	262	339	261	178	249	233	229	221	313	241	441	228	213	250	207	253	210	601	183	336	278	266	298	396	350	282	140	295	306	216	349	226	233	287	267	342	213	218	377	340	280	266	195	278	256	220	463	353	274	274	214	184	304	230	276	258	209	404	272	386	173	229	178	367	237	175	214	192	339	260	223	202	227	271	297	245	160	266	291	344	182	329	294	217	223	522	309	204	292	228	232	191	217	201	187	251	145	187	222	267	190	209	203	251	247	223	218	229	217	151	146	208	174	179	318	274	210	142	176	152	189	132	162	164	208	318	254	194	289	444	159	254	135	102	239	159	107	193	193	220	154	351	444	506	254	142	182	121	148	136	152	222	208	189	283	138	272	208	493	507	220	120	211	265	294	211	192	189	132	155	139	181	139	239	204	144	130	157	242	195	230	200	246	168	140	235	380	217	157	212	168	152	230	108	164	197	132	129	209	126	140	227	95	187	237	227	187	268	165	141	142	195	130	285	153	161	189	238	170	175	251	125	251	153	126	183	169	116	172	141	444	167	246	249	177	173	173	189	160	203	244	218	248	186	234	132	209	242	101	190	214	246	168	245	196	257	138	143	215	125	173	193	120	109	291	124	106	140	86	148	101	151	152	178	148	173	88	155	148	345	234	135	164	156	123	198	83	149	190	109	111	74	175	104	131	150	223	196	130	128	106	99	232	117	129	115	129	148	114	137	123	185	457	160	136	219	174	115	204	137	213	165	280	245	186	116	50	169	428	184	115	132	112	183	145	137	129	94	101	82	162	177	72	53	54	100	212	174	142	140	112	173	111	241	68	158	177	98	178	236	123	219	233	167	83	139	80	182	131	92	142	185	102	235	163	119	93	180	73	98	77	143	201	103	96	210	108	185	147	116	65	80	175	116	56	122	78	83	167	145	131	186	101	137	133	84	92	86	144	91	118	154	163	116	84	137	152	132	110	109	56	82	283	69	117	86	124	189	120	92	99	155	60	185	96	147	174	137	112	99	98	158	172	83	120	97	163	153	84	71	154	134	128	106	126	142	137	67	122	151	147	111	205	108	184	68	76	152	57	88	166	90	148	256	61	184	107	60	118	191	76	105	109	94	78	100	57	105	191	103	63	107	68	74	129	70	86	399	96	105	56	88	86	90	50	95	98	157	133	57	102	109	91	58	60	106	102	153	110	177	88	72	72	52	95	85	86	202	159	73	111	177	87	78	106	110	128	99	174	140	92	111	63	104	100	83	72	55	58	65	119	163	84	93	131	106	104	107	92	60	63	202	130	77	112	58	100	103	114	101	100	55	123	153	69	83	154	87	146	93	98	88	173	108	56	69	98	72	64	88	150	35	108	83	120	57	127	49	134	93	102	129	84	44	132	78	73	33	132	62	73	78	196	93	71	97	49	59	130	73	62	119	90	54	87	75	138	66	86	64	56	86	77	127	281	119	90	74	107	48	124	90	54	130	67	81	99	55	79	53	64	50	97	96	120	81	93	50	95	66	56	62	51	55	131	116	83	66	99	81	76	50	57	61	134	128	83	96	88	67	78	140	167	72	94	74	52	121	118	102	49	70	26	75	71	75	61	52	106	39	37	122	57	97	110	114	71	80	116	82	33	69	48	84	46	88	60	76	61	98	85	61	47	83	113	62	88	202	36	38	78	82	44	30	75	53	73	46	138	36	78	60	97	137	40	59	94	102	57	61	50	30	65	79	47	55	128	151	52	60	54	81	67	56	149	51	87	60	49	94	34	69	79	39	131	37	86	64	105	28	112	77	78	76	74	84	52	74	110	79	51	80	41	54	51	61	29	39	112	55	100	81	98	40	38	55	30	53	27	27	94	57	69	48	76	91	45	39	36	48	42	28	54	68	40	36	66	43	81	50	42	60	52	30	39	85	61	36	95	84	43	62	62	115	51	85	127	42	107	63	88	45	62	41	106	60	61	33	66	39	50	75	39	57	55	27	76	47	78	52	61	24	54	45	84	58	72	81	108	24	67	28	52	17	62	52	44	46	56	51	34	45	55	34	80	58	35	64	41	34	42	43	55	30	65	76	53	88	70	21	38	36	55	25	95	55	29	27	55	26	36	72	37	42	69	78	55	42	27	100	57	48	47	21	44	38	42	47	35	56	28	72	36	48	37	93	82	44	55	38	31	42	57	44	59	77	43	39	53	22	24	76	42	74	60	34	21	59	36	37	31	13	41	26	66	65	64	79	56	20	55	34	38	91	30	29	28	45	43	39	29	43	16	70	44	77	88	50	41	45	32	45	19	28	31	33	39	78	49	37	58	45	12	30	40	64	33	64	49	44	51	60	23	18	31	103	30	52	36	40	38	68	67	44	24	25	19	40	29	22	30	36	40	41	60	37	28	50	30	22	26	51	43	54	44	46	42	40	36	45	73	26	17	51	72	36	22	34	46	57	34	68	43	49	90	39	31	30	31	46	70	29	41	20	38	18	50	32	37	36	19	35	22	36	24	36	14	33	29	50	30	33	33	115	18	24	24	30	61	12	26	39	32	19	29	28	29	44	40	27	37	37	15	23	29	38	33	48	20	41	100	24	45	19	37	31	14	21	12	30	27	18	24	17	14	25	41	20	20	37	25	16	52	22	19	40	14	46	15	17	26	31	31	28	42	100	31	20	41	22	11	25	15	36	43	23	31	20	23	50	49	28	22	37	21	18	79	27	16	13	37	25	17	33	21	43	16	25	17	30	19	28	24	64	23	10	30	17	26	31	23	35	7	10	28	12	53	30	24	14	23	19	24	7	17	5	42	8	43	39	18	13	17	33	34	29	21	23	5	24	13	18	41	13	28	11	18	24	23	11	15	31	18	24	8	8	8	23	20	24	20	29	13	23	11	36	12	22	14	21	14	39	12	39	10	16	10	7	28	19	14	38	10	10	19	13	24	24	22	14	24	15	12	27	10	13	29	19	4	16	20	3	12	11	26	7	15	9	11	15	7	2	12	7	3	14	14	12	7	8	12	13	14	19	10	13	17	7	2	9	13	17	6	38	8	16	38	11	8	11	12	10	9	20	20	32	13	5	9	12	2	12	36	3	7	6	33	30	16	8	8	7	17	13	14	20	9	13	24	4	7	8	11	13	14	1	8	12	5	8	10	6	16	8	2	7	5	5	7	8	4	19	17	12	9	10	4	5	2	9	7	8	3	43	4	35	22	5	4	12	7	12	5	9	6	6	5	3	4	3	3	5	9	5	15	6	6	5	1	4	0	4	54	13	2	15	27	7	2	1	4	3	5	5	1	2	5	0	3	15	3	4	7	3	5	1	5	0	1	1	2	4	1	1	1	0	2	1	0	13	0	0	1	5	1	1	0	0	2	8	0	0	0
ne0005	2187	2394	1436	1074	837	1309	1086	936	1033	1159	809	1004	1263	1084	1149	915	1062	537	633	903	716	747	713	691	620	709	737	765	674	951	523	760	630	817	716	638	855	511	609	649	547	592	401	542	576	744	671	780	755	608	590	535	458	428	504	888	422	356	608	457	575	430	377	465	452	547	630	442	459	349	540	426	488	430	438	405	526	515	518	317	622	440	485	293	361	511	339	433	388	538	502	457	499	400	412	414	477	406	329	318	576	405	336	499	400	413	405	530	516	404	392	479	578	567	453	391	483	629	256	445	388	497	251	497	387	420	352	209	469	455	360	469	228	328	391	294	288	250	433	299	400	597	276	296	436	590	410	285	456	426	397	278	579	380	341	254	356	303	445	388	306	323	413	521	457	232	352	390	183	310	454	272	402	538	412	341	330	431	221	229	235	487	226	272	197	155	227	323	286	282	222	412	176	362	245	270	257	418	337	411	250	222	164	319	177	455	230	306	465	373	420	358	239	361	287	395	224	227	386	267	251	247	225	396	368	301	251	319	274	253	240	376	228	183	317	337	268	213	277	243	327	219	358	356	209	283	461	212	207	316	195	153	282	199	413	373	166	290	215	209	207	226	207	328	202	355	274	216	248	227	241	305	272	209	294	210	140	256	305	198	183	205	179	170	160	155	388	265	299	264	232	360	162	225	317	168	256	264	305	259	197	286	253	253	355	214	219	319	231	162	224	216	184	196	232	174	297	216	173	273	305	251	226	203	201	238	240	184	219	229	180	365	228	241	204	283	259	208	272	218	249	339	338	196	384	225	272	255	144	162	170	159	181	218	206	379	226	155	141	135	209	204	163	143	185	157	169	208	268	272	171	130	255	173	199	203	174	173	245	164	123	186	176	363	263	245	176	218	225	198	188	226	186	243	160	184	153	142	136	148	186	199	332	217	200	163	134	198	335	185	130	215	202	325	129	143	153	190	177	206	216	87	174	285	279	161	165	196	144	183	97	142	124	163	150	189	154	163	157	175	191	153	151	147	173	163	142	137	222	152	189	108	169	162	140	124	183	147	112	246	164	132	140	182	122	116	137	173	164	110	105	227	148	181	206	118	174	118	81	101	137	170	228	126	154	102	164	195	174	194	100	114	87	121	121	135	153	139	122	275	71	167	121	88	137	142	91	122	208	213	176	174	166	95	152	156	137	164	150	165	108	96	170	235	123	123	148	188	168	121	158	209	193	107	177	104	100	188	70	133	118	121	143	139	106	54	192	142	125	210	124	141	148	102	156	127	172	111	137	112	154	174	160	111	141	134	104	151	95	106	101	114	70	117	108	92	97	101	177	167	140	103	138	112	152	157	185	142	170	151	105	127	162	95	114	128	127	100	214	121	144	122	120	144	113	109	100	71	73	83	104	121	139	59	143	84	95	146	142	124	123	82	100	179	164	137	125	133	138	70	104	83	98	141	84	123	67	209	87	96	104	105	157	118	93	72	117	146	119	116	102	117	94	121	108	102	102	78	123	66	135	159	78	95	118	97	120	149	142	113	78	67	143	80	100	90	67	75	77	123	105	122	94	71	110	89	163	46	100	69	93	132	149	117	70	86	121	122	181	55	108	113	84	123	141	90	163	140	121	138	95	123	112	109	79	90	89	71	128	116	114	69	102	88	49	54	115	191	95	80	170	63	125	92	82	88	63	118	113	84	58	47	85	104	90	105	37	90	91	80	81	78	58	103	68	110	121	117	63	74	71	83	103	89	90	58	101	170	49	108	45	112	192	100	88	84	97	139	115	86	146	79	94	78	64	63	57	78	59	84	76	82	79	51	52	111	100	144	72	76	144	70	61	101	83	73	86	136	82	92	102	94	109	53	88	118	58	83	93	79	79	114	83	88	88	86	89	98	104	90	60	58	69	136	87	86	72	70	64	77	72	70	61	90	68	101	85	86	68	58	60	57	78	121	47	91	99	72	73	42	71	99	112	73	92	43	39	47	77	68	74	100	84	114	175	80	118	49	54	79	116	132	69	100	77	74	145	80	54	69	95	53	50	88	77	123	93	62	67	96	102	93	68	48	39	75	195	102	38	63	42	96	94	77	64	47	51	103	89	41	107	132	37	82	46	41	102	135	70	44	40	73	84	54	59	62	75	63	54	97	43	102	37	81	65	55	64	108	51	73	73	70	37	58	34	62	56	72	55	50	76	59	64	92	35	45	87	74	36	44	69	82	69	48	66	43	57	63	93	86	99	43	77	55	39	103	82	58	65	74	40	114	43	61	32	67	64	62	66	75	65	92	40	97	50	57	68	59	59	71	60	70	126	46	112	76	38	34	71	84	81	66	77	46	38	39	30	53	70	71	44	48	90	66	79	37	86	63	78	66	69	37	69	75	31	42	89	51	77	98	38	63	84	82	53	37	64	49	66	37	50	54	72	52	43	59	109	55	56	70	38	68	67	50	42	65	57	27	47	51	61	74	36	63	23	59	29	42	113	56	44	70	54	56	66	32	28	44	46	85	55	65	94	91	48	61	67	42	36	69	38	46	22	81	61	47	46	68	44	53	38	77	39	97	59	66	62	65	42	88	36	54	77	51	28	32	105	47	54	46	48	37	51	55	53	47	31	37	34	38	50	24	24	31	56	50	39	78	37	41	56	55	32	50	15	36	49	35	41	58	40	41	26	64	49	31	81	22	28	33	29	78	44	50	48	32	34	66	29	34	79	52	48	54	59	64	68	57	43	72	29	64	38	56	28	33	44	41	36	53	45	58	22	32	63	44	25	25	55	78	80	41	48	53	24	39	33	53	32	62	56	44	37	62	48	30	39	12	32	28	43	25	27	37	25	40	21	34	20	34	54	38	58	50	18	28	38	44	32	53	48	20	28	62	21	47	48	62	60	49	48	34	73	30	74	42	26	30	33	50	29	23	26	42	37	24	57	26	35	35	51	38	43	36	34	14	24	42	37	51	63	48	51	59	27	15	39	27	42	30	74	16	16	17	39	19	14	24	43	46	32	48	37	29	43	29	21	31	49	47	28	45	47	34	40	22	51	26	31	37	44	110	35	13	35	32	40	24	21	22	18	59	54	34	38	33	17	12	34	24	37	36	31	19	33	45	43	49	11	31	60	49	50	14	44	32	45	40	27	19	27	52	52	46	22	18	25	36	32	54	57	26	36	27	53	27	18	35	27	27	40	50	49	24	24	42	10	25	31	72	13	23	31	32	23	38	44	46	40	37	53	28	14	21	28	13	34	31	25	35	17	26	32	30	23	29	30	44	31	21	23	13	22	12	43	27	47	13	21	11	30	30	24	32	12	15	57	20	16	17	24	22	13	17	13	24	17	33	12	25	15	33	29	33	45	14	21	30	8	16	17	27	36	25	9	27	20	19	30	33	35	15	10	13	30	17	14	25	19	16	40	14	35	15	13	27	10	14	36	29	15	32	23	12	23	8	15	18	31	28	17	28	19	30	22	34	18	30	48	8	16	36	20	12	8	13	15	18	24	21	48	16	13	12	14	9	13	15	33	31	4	12	20	20	13	26	33	14	21	24	6	13	17	20	10	20	17	20	11	9	14	31	15	20	9	23	7	12	20	17	18	16	17	15	14	12	31	36	7	38	13	13	11	26	6	21	15	10	13	28	8	13	11	8	16	12	35	21	8	23	16	15	16	6	19	4	7	18	11	10	25	11	14	33	24	11	7	17	4	16	18	4	8	19	17	24	17	9	12	10	9	17	8	11	23	13	6	2	34	23	3	2	11	5	10	19	9	15	10	17	10	12	7	12	8	18	11	2	32	6	11	6	8	9	5	13	9	7	7	7	8	4	10	13	7	3	4	5	4	11	24	9	6	7	8	5	9	10	10	7	6	16	20	8	11	15	11	25	7	11	5	10	5	9	11	13	11	27	12	8	4	7	8	8	10	10	6	5	4	0	8	9	7	9	7	9	20	5	2	1	10	5	7	0	4	2	10	7	3	5	18	4	2	5	6	7	6	3	4	4	4	1	10	5	6	4	1	7	2	6	6	3	3	1	8	3	4	2	2	1	5	8	7	2	0	5	4	2	3	1	1	3	3	5	7	1	6	2	5	3	2	7	1	4	1	1	0	0	1	0	2	1	0	1	0	0	0	4	1	0	4	0	0	2	1	0	0	0
ne0006	10587	9375	5907	5744	5035	5865	5312	4611	4442	4981	4189	4710	4845	4686	3445	3810	4348	3149	3154	3718	3236	4033	3084	3394	3148	2966	3526	3215	3785	3622	2694	3008	3023	3316	2955	2809	3262	2491	2708	2209	2886	2814	2570	2555	2808	3138	2931	2583	2879	2930	2789	2605	2372	2542	2661	3103	1994	1870	2421	2522	2565	2206	1695	2106	2330	2471	2910	2210	2248	1907	2066	1995	2122	1795	1909	2073	2319	2179	2233	1702	2432	1942	2667	1968	1618	2437	1794	2173	1678	2110	2170	1664	2459	1413	1992	1690	2212	1814	1808	1910	2025	1803	1642	2316	2012	1992	2078	2350	1623	1956	1817	1723	2451	2539	2218	1618	2207	2020	1495	2088	1815	2335	1506	1775	1742	1943	1712	1614	2157	2133	1947	1733	1536	1454	1692	1272	2105	1456	2058	1696	1826	2023	1469	1565	1243	2020	1841	1299	1872	1615	1973	1457	2083	1527	1443	1803	1783	1508	1987	1581	1676	1417	1830	1689	1733	1271	1552	1459	1320	1683	1680	1426	1885	1976	1902	1283	1433	1943	1460	1223	1615	1904	1613	1247	1502	1202	1584	1340	1268	1277	1063	1533	1214	1729	1338	1409	1339	1907	1334	1502	1256	1129	1093	1521	1164	1498	1320	1421	1754	1435	1927	1707	1726	1310	1051	1567	1273	1037	1519	1275	1142	1328	1040	1494	1244	1440	1094	1271	1320	1196	1060	1457	1183	1017	1467	1479	1073	1199	1250	1332	1588	1175	1194	1942	908	1350	1552	1161	1780	1151	1437	1104	1340	1057	1848	1730	1015	1357	1089	1041	1118	1139	985	1217	1071	1276	1292	1042	1073	996	1388	1218	1431	1161	1317	1023	836	1375	1202	969	835	977	1122	830	1080	839	1101	1023	978	1206	1077	1295	994	1026	1805	854	1463	1030	1224	1153	836	773	1015	1039	1207	890	1194	1036	1051	875	971	1064	1050	1103	897	769	1140	971	1244	1164	1234	1006	1056	1102	1024	1253	1090	1075	1073	999	1128	1229	1145	1022	982	1078	1228	778	1443	972	1086	1239	1734	851	1109	1004	1031	870	757	888	974	875	785	1003	915	1263	868	890	790	854	932	849	1016	825	1107	889	830	857	1182	1015	820	764	954	1100	1014	829	773	608	1117	934	1103	902	845	1048	890	969	852	717	913	948	831	1548	1160	865	1014	971	642	891	694	954	858	746	1115	991	1009	675	847	718	1046	820	753	774	872	1003	773	692	887	1015	841	955	728	573	935	1034	1031	671	867	972	689	783	901	742	602	805	787	911	744	683	732	839	799	841	769	694	707	804	735	694	819	772	826	765	670	798	632	687	894	690	624	963	909	620	604	584	569	783	576	1054	584	778	1161	883	649	847	1290	521	824	631	515	593	659	564	810	659	818	495	808	942	818	680	585	604	551	639	616	777	665	706	762	985	674	831	634	689	791	866	563	545	817	1025	635	867	723	668	717	562	735	728	744	865	706	604	633	715	600	757	652	632	903	549	561	722	872	617	741	612	620	692	470	599	529	604	599	712	551	986	681	562	628	870	522	653	797	646	608	615	648	566	772	631	636	1027	653	699	688	712	622	743	510	573	745	507	497	553	591	719	557	753	744	585	582	598	659	501	658	711	745	565	477	582	587	641	645	444	630	639	643	534	754	537	604	616	559	667	603	517	580	518	443	1141	610	434	555	396	544	482	465	749	558	524	469	535	452	480	749	664	526	455	536	413	613	385	586	512	480	473	443	517	490	590	447	504	536	467	499	487	443	582	478	583	552	614	515	604	595	412	552	652	567	480	554	673	578	680	752	578	523	549	584	523	675	367	493	582	444	456	450	415	579	469	448	501	394	485	470	483	693	429	269	376	471	457	552	520	386	463	502	443	741	315	556	500	383	675	628	470	756	729	583	443	452	484	445	519	421	473	412	379	463	377	492	327	397	385	445	435	423	729	520	419	590	389	466	556	457	402	369	551	414	328	396	339	479	464	515	469	279	461	410	381	435	484	336	944	395	422	600	358	363	453	407	432	492	430	487	346	898	637	333	411	363	428	601	362	448	426	367	314	469	463	668	429	417	507	365	839	421	387	325	453	316	387	364	441	389	445	445	549	366	413	509	384	329	405	372	412	453	495	416	440	217	381	433	253	442	579	336	420	519	276	479	416	419	468	575	272	395	314	360	356	344	270	360	612	326	371	353	263	270	435	298	873	462	352	341	336	427	403	403	234	383	296	350	442	241	374	305	344	308	350	515	365	383	316	388	384	297	248	318	287	335	351	519	543	340	587	470	249	297	317	386	481	434	519	315	403	610	322	304	433	321	345	243	375	372	521	360	306	314	365	410	306	361	251	229	359	410	403	191	294	300	391	443	392	332	361	291	365	394	191	679	442	227	424	297	221	366	497	356	221	308	330	343	224	220	446	256	350	258	427	267	468	287	430	327	461	323	289	355	292	337	307	188	263	189	291	303	822	264	287	406	561	349	367	266	224	372	298	247	438	300	280	295	301	259	207	336	323	319	490	394	242	237	379	223	266	346	265	278	287	223	338	200	322	241	297	210	325	443	275	274	416	208	280	252	338	334	286	294	355	354	298	305	255	362	283	226	283	263	313	330	264	274	221	231	266	288	346	279	308	254	240	338	275	287	213	310	103	264	247	234	213	291	318	242	188	389	223	322	293	271	264	270	367	321	209	210	216	270	245	273	279	318	271	284	226	241	342	230	390	266	257	351	192	289	322	270	151	213	772	280	287	642	386	174	233	180	299	370	194	240	237	280	261	262	181	153	242	318	231	252	348	333	256	227	283	253	245	201	340	250	238	172	356	280	178	178	339	194	194	184	260	231	353	123	280	278	244	223	649	277	195	335	256	210	195	324	221	253	230	224	111	245	226	247	290	189	256	154	205	182	242	218	154	143	231	204	367	179	285	337	237	202	270	159	154	112	213	161	235	207	212	140	202	258	173	212	195	165	155	228	202	157	207	232	167	236	264	180	183	338	339	153	280	229	205	217	331	230	248	220	240	185	270	128	188	196	153	140	236	150	245	114	161	217	254	196	120	148	198	232	193	254	246	146	220	181	199	148	222	163	207	174	217	264	197	209	166	199	332	265	175	145	151	196	151	162	172	166	141	230	193	273	209	141	207	155	187	168	190	230	170	120	190	216	165	190	140	246	179	222	165	235	154	269	188	122	170	139	164	113	130	139	199	221	260	182	137	143	164	198	174	182	394	143	95	151	184	183	184	167	160	244	246	103	119	178	153	211	192	182	228	188	107	138	158	107	124	145	393	158	166	140	138	97	143	128	111	166	141	150	182	199	208	162	111	125	129	189	138	292	179	147	126	100	156	170	126	87	108	141	418	216	203	102	128	126	115	156	132	158	120	161	95	144	145	206	182	109	131	190	159	239	97	203	117	218	165	129	143	93	102	124	130	87	136	112	130	149	244	212	127	99	130	133	145	88	142	121	142	138	164	144	117	126	119	66	98	156	235	145	102	142	111	145	138	143	159	113	189	183	115	117	129	142	104	120	197	102	206	90	148	136	148	81	128	100	119	183	156	107	115	117	84	184	129	129	89	237	75	205	118	123	135	102	102	184	122	74	137	107	118	105	157	74	133	101	111	80	78	113	122	132	94	114	230	100	138	93	123	111	120	154	94	125	92	116	128	171	104	373	153	46	75	115	103	79	134	105	133	84	76	88	83	93	98	92	133	351	104	178	113	130	107	65	74	117	97	146	131	90	118	117	130	124	105	90	94	100	72	94	130	122	105	58	110	97	96	118	116	249	83	75	87	79	84	54	116	143	109	82	130	105	93	67	71	86	72	77	96	67	120	81	81	83	79	90	61	62	49	59	109	65	64	80	83	72	91	60	82	76	75	56	72	69	50	92	114	48	146	95	68	74	148	39	125	75	90	50	52	71	77	62	55	68	75	87	62	52	52	73	77	52	27	82	66	80	84	82	42	75	72	53	103	72	77	69	85	57	59	67	56	42	69	54	83	60	91	31	49	63	89	75	65	97	64	41	78	51	99	67	59	65	71	64	69	43	55	84	60	47	70	45	50	38	54	47	21	87	74	39	74	80	40	48	58	59	45	49	42	40	66	48	43	38	38	33	33	27	30	63	53	46	51	29	28	46	107	61	42	70	56	87	37	41	33	49	61	33	46	55	27	36	54	38	44	27	61	34	22	36	49	40	40	42	34	31	36	56	28	35	36	47	47	36	43	29	30	26	25	47	19	22	32	28	9	39	18	70	30	52	31	21	13	32	31	14	24	23	24	24	28	51	22	14	25	18	49	18	67	23	13	20	10	19	21	17	34	47	20	36	56	29	26	23	13	16	15	27	8	5	21	11	36	16	9	15	3	6	21	3	9	7	9	16	4	2	7	5	6	1	4	3	2	9	2	7	21	38	11	11	0	4	12	3	5	2	0
ne0007	1692	1623	942	963	619	866	840	562	584	771	511	578	672	605	747	486	479	430	605	569	556	542	429	353	412	408	544	484	504	618	404	393	354	349	562	524	409	351	438	497	413	308	335	272	394	380	310	367	432	420	289	333	332	242	418	452	266	365	381	334	279	321	353	403	319	328	280	251	249	307	361	282	391	349	268	444	265	317	311	255	286	329	293	370	298	220	239	242	259	292	306	354	313	323	212	289	211	279	236	226	289	227	358	244	222	248	319	215	303	307	247	297	264	221	200	235	224	301	186	179	303	220	225	290	306	286	184	220	212	210	234	267	200	290	285	233	243	196	215	173	204	220	189	173	219	326	197	192	253	227	207	157	284	186	295	195	247	297	164	200	167	223	186	257	286	231	179	244	128	210	334	178	186	309	194	236	199	161	214	169	150	314	183	178	210	195	199	271	198	170	177	201	230	195	204	183	183	184	217	214	219	164	173	223	206	209	183	188	268	244	148	239	240	196	229	253	150	185	264	165	204	185	163	238	283	267	198	216	210	175	177	200	137	184	215	228	192	175	241	125	267	180	172	253	156	185	214	110	213	181	120	167	176	175	208	132	155	155	227	120	146	185	147	195	128	212	176	144	163	201	153	188	148	103	187	141	159	173	171	151	156	131	161	176	184	205	212	119	120	148	163	195	151	180	184	142	170	142	147	143	209	138	178	123	203	167	192	156	128	129	111	159	164	89	177	113	196	240	147	161	180	170	112	151	189	206	115	149	176	178	128	169	176	147	133	177	191	204	167	132	144	198	164	138	140	169	164	187	137	137	113	134	169	129	123	166	110	173	162	101	174	174	152	114	104	118	112	185	144	171	175	72	143	119	111	137	105	129	151	99	89	220	125	135	171	127	125	113	98	105	141	122	130	174	139	94	121	121	135	119	135	251	156	152	121	96	144	129	151	145	127	151	157	138	81	121	154	145	112	136	83	99	113	142	141	189	133	141	137	112	121	106	79	166	89	110	98	84	185	115	118	103	155	84	111	106	107	101	212	100	100	109	74	82	105	99	113	113	129	162	107	92	126	96	95	100	99	96	118	144	70	96	131	133	117	123	106	78	102	119	80	87	142	121	117	122	61	81	104	133	107	97	85	116	106	104	89	110	82	117	73	71	128	145	107	112	92	95	72	108	68	119	84	110	82	123	88	139	101	100	77	85	83	131	95	76	105	149	139	102	126	174	76	99	112	85	102	114	88	118	82	108	86	138	81	65	83	97	81	95	87	105	70	90	99	169	89	84	106	112	96	83	112	47	130	79	86	73	62	96	93	70	63	61	52	93	99	101	116	63	92	52	58	83	86	93	82	75	107	79	93	131	114	73	67	56	105	78	117	67	84	103	98	78	65	89	67	87	95	52	90	67	70	76	97	58	63	70	60	90	113	116	79	151	101	69	99	101	101	44	57	74	89	139	96	76	45	61	65	94	70	119	118	93	95	62	83	85	76	58	69	75	81	71	47	53	61	62	99	53	90	66	70	30	60	55	86	129	107	78	40	63	76	66	82	57	64	101	82	132	95	79	49	96	76	113	94	68	118	46	74	103	91	56	78	64	82	77	67	53	69	108	65	74	76	81	57	55	98	107	62	105	109	126	77	85	66	44	64	109	70	74	50	70	72	75	48	58	59	64	100	69	95	68	69	70	105	33	61	99	63	57	89	133	60	66	191	60	64	61	56	50	64	56	85	52	55	81	85	63	76	63	70	49	88	44	35	72	55	50	53	54	95	55	50	44	61	49	53	57	69	89	46	57	67	52	65	62	62	55	129	105	72	65	73	89	48	42	37	73	54	90	34	38	53	89	48	69	74	46	60	50	75	40	52	62	50	54	60	43	70	61	43	23	72	55	75	41	93	62	18	54	72	112	46	50	50	52	47	54	59	47	46	48	85	44	30	53	100	56	46	70	51	82	50	54	62	44	50	64	79	19	57	51	80	64	62	21	55	67	51	40	60	53	69	44	52	27	45	52	72	82	101	52	49	98	38	52	65	59	65	53	46	80	76	53	31	53	53	44	52	45	50	37	41	87	49	38	54	69	58	48	61	42	28	71	39	61	82	33	81	40	38	44	37	61	67	100	54	34	43	79	30	36	42	60	55	69	33	52	41	26	29	31	29	60	49	63	76	28	47	42	40	32	23	68	29	70	22	34	22	35	57	40	35	43	49	33	61	54	52	54	85	47	46	49	20	53	51	39	83	34	46	41	43	75	38	41	52	63	33	23	54	54	38	51	42	38	53	21	31	45	25	21	50	55	43	49	50	36	49	31	43	32	43	54	55	44	33	75	68	41	53	34	44	47	32	42	60	34	41	44	49	36	59	41	53	35	27	41	46	24	78	36	22	55	72	30	26	46	50	47	52	47	20	34	41	22	32	49	46	21	33	56	24	39	41	30	32	46	30	47	83	47	48	37	45	37	24	52	41	42	25	25	32	38	32	31	39	49	54	27	40	33	39	24	22	25	19	39	41	19	57	48	85	30	55	54	20	39	29	50	25	67	40	26	31	40	31	21	18	29	27	43	34	37	25	43	22	58	38	31	39	31	33	17	45	35	34	41	46	56	29	83	58	30	19	19	32	36	39	20	22	48	38	62	30	44	46	46	13	36	33	36	25	23	21	49	27	19	30	31	19	28	74	27	42	24	28	24	32	37	24	77	35	17	35	32	36	27	33	27	27	89	34	54	44	37	27	41	39	29	22	22	37	28	34	41	25	51	28	21	44	28	54	20	30	37	66	46	50	14	23	13	12	62	26	32	39	30	24	19	15	38	26	37	46	30	46	25	60	25	29	42	20	27	40	30	33	41	44	17	23	21	19	50	22	25	20	21	23	35	53	27	45	26	24	37	50	48	26	23	28	13	38	24	42	34	20	16	18	29	32	66	37	19	22	32	16	32	57	22	30	16	26	29	24	15	25	23	32	53	16	34	33	5	24	20	41	20	56	47	17	10	23	23	36	17	67	7	10	40	46	28	39	40	14	21	55	29	36	21	28	21	33	20	26	15	20	16	17	33	21	17	62	11	11	29	18	28	18	26	14	81	21	44	13	15	44	26	34	13	26	33	32	18	9	21	23	24	34	44	36	42	14	5	21	13	26	18	14	48	30	17	24	22	36	12	28	27	44	47	12	36	27	16	33	43	25	23	20	17	9	9	24	44	23	31	18	18	18	24	5	22	36	22	37	17	16	32	35	28	14	16	28	38	23	22	13	12	25	27	20	11	12	4	19	24	19	21	6	15	22	31	32	16	12	15	13	22	8	22	9	15	14	21	23	23	33	17	9	21	10	31	11	12	21	9	13	7	13	16	22	23	25	9	16	38	16	11	18	14	24	35	19	16	12	18	33	38	9	18	29	20	8	23	14	8	10	11	12	29	27	25	15	26	9	20	3	17	7	10	41	15	15	6	35	26	22	15	9	14	13	25	11	21	13	16	20	15	29	16	18	18	13	3	8	18	10	16	16	6	6	17	74	9	12	17	12	3	20	16	15	5	16	12	26	19	9	11	10	13	12	17	10	18	19	8	6	11	5	16	24	9	17	17	24	8	14	1	13	17	14	18	16	19	17	11	6	26	12	15	8	24	19	11	3	18	10	5	10	29	17	4	13	5	7	6	15	15	15	8	0	25	12	8	5	23	3	4	11	11	21	13	8	24	13	9	17	13	8	9	3	7	16	3	8	13	10	8	7	12	13	3	5	9	7	9	10	13	20	8	10	0	5	17	10	16	12	0	16	2	14	4	5	13	6	1	13	9	9	15	11	4	4	8	3	14	15	6	2	4	9	4	2	15	6	7	7	9	9	9	7	6	4	16	3	3	6	8	3	9	18	4	7	5	22	7	2	8	12	3	3	3	11	1	4	12	3	1	9	1	7	3	10	6	6	2	5	3	7	5	4	5	7	3	3	7	2	2	1	6	4	7	4	5	5	7	2	6	10	0	18	2	4	2	2	6	3	4	1	4	3	1	6	5	5	3	3	2	0	6	1	0	7	5	6	7	3	3	10	1	12	6	4	6	5	1	3	4	5	3	0	2	6	0	0	1	1	1	1	3	9	0	2	1	0	1	0	2	1	1	1	0	0	2	1	0	2	1	2	1	0	3	2	0	0	0
ne0008	2584	2517	1649	1157	1236	1520	1122	1142	1156	1305	1061	1148	1245	1035	1208	903	943	871	739	961	960	827	761	543	889	757	1322	915	1110	1181	748	746	647	708	776	878	783	800	816	757	593	601	474	577	464	610	538	770	873	693	634	670	546	336	511	871	570	600	782	471	617	490	560	686	575	629	577	528	571	582	539	532	672	462	528	1002	482	713	604	439	515	682	409	487	678	483	432	632	470	602	366	462	404	427	378	539	407	361	353	336	582	421	383	510	424	451	719	469	464	379	463	508	400	389	392	388	443	599	336	486	495	427	455	557	517	378	391	265	410	427	450	373	293	437	463	356	510	283	355	319	350	504	320	304	369	641	428	290	501	335	334	269	653	354	339	312	417	501	349	394	369	419	344	597	438	424	418	418	216	224	506	388	347	612	367	410	477	339	417	315	113	379	285	352	302	368	265	390	403	441	331	378	143	376	365	223	241	359	438	398	345	322	203	388	181	414	352	333	409	438	330	460	370	290	316	367	268	436	442	462	568	217	389	373	449	311	388	359	336	342	393	359	276	309	359	272	333	450	542	243	359	258	252	263	320	366	487	245	322	274	294	211	330	276	247	288	228	288	325	245	294	428	294	312	248	294	261	286	267	391	243	254	291	254	311	212	290	242	453	282	315	284	277	186	302	195	312	224	252	314	401	338	416	325	219	190	237	258	265	283	346	291	336	290	309	275	371	281	273	234	295	273	405	173	289	233	341	330	189	290	300	345	278	190	222	193	236	289	248	316	204	287	295	120	243	301	399	196	238	274	194	356	271	143	320	327	320	303	207	290	254	245	322	267	216	368	251	254	272	185	258	215	139	256	241	209	258	293	259	273	259	226	258	249	238	173	243	239	338	181	71	319	195	258	372	173	178	319	228	264	231	119	198	245	156	198	220	178	149	209	321	149	237	206	257	184	239	161	317	332	268	227	186	242	205	205	211	313	176	162	225	254	214	289	213	216	200	237	148	202	112	188	171	325	223	237	255	195	311	201	236	218	245	148	172	191	143	170	340	177	264	127	149	160	278	196	217	245	167	219	148	120	159	132	161	145	168	154	183	155	60	202	189	130	171	216	269	167	116	78	148	135	237	178	146	209	124	122	103	282	145	208	148	203	246	194	253	178	156	135	149	208	221	83	92	197	154	169	236	227	125	228	219	166	206	180	142	231	174	173	153	229	286	160	206	137	222	156	332	123	162	334	180	226	157	226	135	189	195	209	161	151	237	195	149	73	145	218	211	156	150	259	132	198	227	307	201	173	122	139	206	159	169	89	185	123	164	207	143	176	98	163	142	161	141	119	113	82	163	97	232	121	141	123	178	154	170	140	185	150	137	248	130	224	136	72	120	141	95	214	131	210	127	117	134	142	122	270	159	62	134	173	270	157	228	125	111	115	123	243	120	269	144	257	96	129	176	151	166	114	231	103	183	144	162	238	118	158	82	144	140	121	134	187	154	136	136	155	220	139	196	249	232	216	116	127	163	78	171	65	150	99	168	86	110	129	138	159	113	165	81	93	176	78	170	99	131	258	65	241	155	131	122	116	61	120	176	76	128	145	143	144	193	110	87	160	123	169	125	168	120	200	124	95	113	124	223	160	128	160	104	179	142	134	167	101	115	119	71	110	109	190	143	232	161	152	104	457	114	116	190	96	87	152	138	105	110	77	157	162	145	66	158	133	150	124	52	130	94	111	58	89	90	101	103	125	148	92	68	89	101	146	171	126	134	102	64	151	59	130	78	108	57	188	109	124	93	86	81	108	160	105	86	72	153	107	57	109	119	96	102	90	132	187	146	112	124	171	116	99	131	116	64	121	120	82	131	93	89	131	56	68	73	112	118	129	111	118	89	65	119	109	27	91	101	115	94	111	133	87	90	126	92	70	136	88	91	108	76	65	96	173	56	102	103	59	63	83	130	111	99	147	84	83	69	144	120	87	172	90	257	83	97	136	125	142	132	86	97	86	91	127	39	126	69	98	106	105	58	146	115	78	164	87	148	173	121	177	59	78	129	108	97	167	180	115	100	88	80	105	112	145	165	94	89	178	64	88	52	88	121	80	77	70	88	50	55	113	121	98	111	83	28	55	59	122	113	138	82	99	54	106	131	45	69	97	101	64	83	132	40	57	43	51	132	92	88	82	133	60	109	70	72	133	73	162	27	52	81	126	95	70	109	79	82	69	107	87	62	74	110	68	160	91	49	108	45	92	54	66	138	24	195	57	77	105	91	72	54	134	36	79	76	88	73	86	67	107	98	60	70	79	49	67	114	86	72	74	71	51	58	111	109	53	44	102	41	68	124	97	58	40	70	72	77	62	49	78	96	60	70	51	166	46	71	69	92	51	94	59	55	54	141	62	62	22	57	55	81	109	30	97	157	92	40	69	116	70	79	109	87	51	78	80	76	115	71	68	48	82	51	64	42	75	86	85	54	69	27	103	80	89	57	50	51	91	34	51	59	46	82	66	84	69	49	68	51	36	38	49	92	31	50	77	107	90	117	104	58	47	54	67	62	104	77	51	53	72	45	15	113	45	56	48	31	59	59	61	87	57	52	73	62	57	24	85	57	61	60	131	113	27	33	39	61	10	51	34	70	45	61	41	51	45	63	43	71	54	58	44	50	47	47	57	35	51	24	35	39	36	39	57	32	59	139	38	71	60	80	58	33	67	83	35	88	53	45	95	79	91	38	37	60	92	83	52	71	58	45	39	57	87	74	32	65	52	59	78	33	121	64	51	35	53	58	62	51	24	88	55	108	46	44	53	29	95	58	72	75	64	68	33	57	47	29	91	40	16	102	28	117	29	59	69	25	57	55	56	36	22	49	41	51	67	44	104	58	61	58	32	94	30	64	44	29	21	70	62	73	53	51	32	46	42	57	44	72	76	52	36	48	53	47	149	50	28	66	55	47	84	60	35	32	31	56	31	41	53	26	44	33	72	45	75	39	39	36	54	29	62	61	38	20	13	66	34	93	31	96	22	40	54	46	44	36	46	40	31	63	43	45	72	35	43	35	60	23	30	42	30	12	24	31	62	27	58	33	42	21	36	42	47	68	155	69	30	13	33	53	59	38	35	41	25	46	39	56	78	93	50	27	92	23	22	46	36	33	21	36	48	76	38	57	34	45	65	54	17	44	46	85	68	37	34	15	68	17	27	30	32	42	32	41	31	35	38	42	31	51	34	36	55	45	31	46	24	32	40	14	18	45	25	23	30	66	18	18	20	53	5	55	38	32	42	34	58	46	54	12	19	28	34	33	22	19	34	37	31	12	36	22	28	36	29	25	27	38	34	33	28	31	34	11	18	31	34	41	37	27	36	16	45	31	40	21	22	19	29	12	18	44	77	29	30	38	24	19	30	41	49	16	25	49	14	30	32	15	22	16	47	23	31	47	25	52	49	37	42	21	41	13	22	32	31	22	36	36	65	73	20	19	26	21	49	12	21	36	49	17	16	29	26	18	15	22	14	26	24	27	34	15	16	12	16	24	32	15	23	29	17	10	12	17	31	3	56	35	22	15	21	24	18	23	28	28	20	16	25	22	19	20	32	8	5	27	35	33	23	28	21	34	20	14	27	19	22	38	32	26	23	31	14	6	24	10	34	23	11	8	35	23	52	16	9	22	22	17	13	5	37	20	30	18	10	16	9	19	35	7	15	23	19	31	27	5	17	7	24	23	16	7	8	12	7	9	15	23	12	4	8	11	342	30	11	11	13	13	6	17	23	9	14	15	10	17	23	13	9	12	27	18	10	17	7	16	9	5	5	28	11	13	12	18	13	4	7	9	10	4	10	5	11	18	18	18	7	3	11	13	27	7	27	23	13	7	17	9	6	20	6	4	15	10	2	6	6	39	4	12	12	6	13	12	16	9	2	5	21	4	2	3	12	17	9	16	16	19	3	12	9	6	7	15	6	6	23	9	6	7	1	14	2	6	10	4	5	8	0	4	0	6	4	7	6	12	4	15	4	9	5	6	10	20	3	8	3	35	0	11	1	3	2	5	3	18	3	7	3	1	13	1	3	5	4	6	0	3	2	4	5	4	2	2	1	9	5	4	6	3	1	2	20	1	5	2	4	2	1	1	0	1	0	1	2	1	1	1	1	0	3	3	1	4	1	0	0	1	0
ne0009	6552	6014	3518	3165	3402	3493	3262	2732	2632	2904	2581	2647	2664	2459	2133	2566	2496	1925	2029	2373	1801	2507	1965	2074	1758	1784	1935	1944	1979	1988	1628	1860	1862	1862	1769	1639	1883	1481	1543	1302	1551	1571	1266	1700	1743	1730	1817	1351	1677	1662	1622	1560	1427	1339	1529	1773	1264	1239	1315	1441	1557	1566	1060	1289	1371	1315	1623	1568	1458	1284	1210	1329	1321	1177	1208	1223	1468	1255	1219	1069	1376	1148	1465	979	1167	1393	979	1248	1214	1172	1383	1103	1343	969	942	1112	1371	1132	1313	1318	1342	1076	1068	1347	1167	1206	1100	1384	931	1205	1076	1091	1554	1357	1302	986	1293	1151	843	1233	1118	1305	967	1053	934	1142	895	1011	1273	1292	1209	1151	855	887	876	903	970	867	1223	949	1049	992	1137	936	824	1122	1021	740	877	784	1043	890	1081	980	922	893	955	914	1117	1005	1012	886	1054	929	1013	740	853	859	786	1125	995	873	1062	885	1122	674	1005	1137	803	724	1033	1060	822	754	829	665	758	827	693	726	778	689	815	1064	839	897	816	1124	700	870	779	785	665	791	692	841	850	805	1083	807	1098	806	836	878	698	914	749	656	823	752	693	747	573	744	820	945	743	835	741	725	727	774	689	843	762	722	901	719	795	733	973	703	1088	668	611	743	882	662	785	700	752	645	784	582	1056	996	756	737	638	586	721	739	647	466	537	849	642	593	556	564	863	735	751	644	768	642	572	694	689	573	538	609	671	430	643	495	623	675	655	726	746	623	587	605	569	606	774	684	563	652	566	570	620	568	617	577	616	632	485	563	613	504	559	567	589	439	583	542	885	582	663	549	594	507	635	661	578	598	596	585	563	611	600	756	720	571	647	468	647	679	567	617	715	565	573	554	534	492	468	577	640	466	529	558	474	678	515	556	543	488	585	502	665	523	612	473	485	650	482	545	601	476	643	538	590	497	437	415	602	530	479	530	529	558	583	524	564	465	473	532	458	476	496	535	567	513	431	464	439	606	428	359	509	441	548	556	507	452	533	440	479	421	498	500	332	416	468	618	505	558	476	339	456	613	670	362	483	558	446	442	629	503	473	381	547	500	353	346	424	524	495	437	465	365	414	492	498	384	491	543	498	505	512	478	358	457	475	426	313	627	532	430	341	423	378	352	426	501	364	411	379	374	451	474	409	380	393	513	301	409	475	384	432	370	343	303	531	542	527	413	359	305	366	283	417	486	524	416	455	653	395	450	384	441	592	438	335	365	525	486	506	412	581	424	440	418	408	408	430	507	403	382	422	472	391	405	379	402	315	374	391	429	390	461	419	468	457	486	334	405	369	392	401	449	417	354	482	336	343	458	381	301	375	414	323	336	330	355	476	401	463	465	398	439	409	398	371	385	295	298	401	277	254	355	370	419	556	457	449	430	384	354	388	293	360	446	375	382	267	324	381	373	430	326	461	311	359	283	498	311	367	291	297	360	382	342	327	348	302	280	321	334	326	260	266	330	257	386	375	326	311	284	319	257	421	417	309	287	325	316	315	300	337	275	303	298	349	426	268	312	297	251	390	230	305	230	333	367	333	299	301	381	399	319	400	313	302	309	346	323	314	359	276	316	354	300	294	351	378	282	202	245	285	314	289	418	252	256	567	269	283	284	231	282	289	331	270	229	217	224	270	264	326	273	209	307	283	282	380	231	376	273	215	223	252	350	361	314	274	224	289	240	252	281	293	259	307	278	286	213	265	192	258	242	270	246	309	289	297	243	247	302	346	342	310	214	260	273	240	194	206	197	303	282	246	242	223	292	259	291	296	299	229	252	200	216	303	241	190	212	231	189	252	286	275	190	231	400	243	270	182	218	434	189	368	220	253	242	288	312	344	267	340	277	257	275	302	277	245	299	224	270	198	201	213	198	260	265	228	189	275	207	200	243	228	266	230	324	222	230	187	293	249	263	268	266	171	291	326	145	164	279	242	226	305	206	206	221	253	181	225	191	269	253	281	273	191	160	176	222	166	207	256	161	229	250	264	205	191	172	207	272	244	234	172	185	209	191	208	162	233	264	158	196	226	214	151	151	209	160	175	205	231	265	321	234	212	176	204	166	203	228	208	275	186	197	342	182	188	231	192	176	179	211	146	262	178	307	187	165	290	222	176	160	142	158	465	219	229	273	210	257	301	242	248	184	174	229	247	160	194	283	189	204	166	167	190	262	153	137	141	177	174	168	236	205	121	189	115	222	139	216	206	194	196	228	207	208	154	206	182	197	116	220	115	212	172	193	141	130	253	164	155	210	132	135	176	240	227	197	178	158	189	167	175	138	186	229	235	239	145	212	182	223	151	157	165	184	179	122	152	223	108	149	166	201	150	186	187	124	154	183	119	184	140	184	218	163	151	172	195	168	169	134	246	150	137	153	175	196	171	151	178	178	165	162	322	245	170	193	136	117	169	161	154	114	180	101	201	165	179	138	198	189	109	138	185	120	183	167	153	180	161	183	180	111	145	178	222	134	127	223	185	139	145	156	180	180	141	179	244	140	241	138	162	191	163	134	143	153	148	136	164	158	123	162	134	136	182	107	122	148	150	143	179	145	100	132	183	219	134	167	170	180	137	167	165	155	121	193	142	115	95	200	154	123	122	185	173	171	157	135	153	171	124	154	180	106	124	203	133	112	192	184	124	160	132	106	139	116	106	95	183	201	159	146	124	89	121	117	150	133	125	97	131	143	138	197	119	165	159	150	93	113	153	91	87	127	141	122	108	118	118	176	121	112	142	108	90	120	192	90	93	100	112	98	145	123	110	95	137	120	111	153	109	195	122	124	128	175	122	113	104	160	83	109	154	141	76	170	106	220	100	114	125	128	108	63	112	142	118	111	107	183	143	132	112	152	76	104	92	129	108	153	115	88	121	95	90	98	111	115	80	113	80	74	76	97	100	70	109	97	152	108	80	81	86	125	77	148	125	126	67	113	90	142	106	93	137	116	176	138	148	67	140	90	98	91	61	108	77	63	125	133	128	95	117	98	137	68	147	92	117	86	78	93	132	115	67	111	93	100	109	157	48	79	133	134	98	125	54	83	63	74	78	64	76	80	108	84	98	108	92	109	74	95	94	68	122	132	96	155	97	94	113	77	114	63	102	121	59	138	81	93	125	79	74	63	72	90	80	90	124	110	72	67	71	91	64	84	116	83	84	58	129	82	189	126	68	77	189	68	121	96	114	137	117	100	70	78	69	66	77	80	70	72	96	146	70	136	92	80	61	117	106	89	59	96	59	88	77	127	97	61	93	88	47	70	62	196	95	109	96	88	92	113	81	65	96	110	143	64	70	74	81	65	39	126	64	124	51	69	84	72	69	81	52	55	59	96	95	78	73	73	91	70	81	66	44	60	134	58	70	62	45	41	90	58	47	65	35	97	91	112	65	48	74	110	56	102	83	68	86	54	77	81	48	101	51	57	80	46	100	47	67	65	88	89	82	59	55	91	52	31	72	62	70	116	64	73	52	39	69	63	47	50	60	78	54	47	79	69	73	49	53	44	56	55	68	75	73	48	40	82	101	55	57	62	89	47	29	84	52	89	37	49	57	61	55	41	72	44	72	56	57	54	45	53	75	72	36	30	53	42	39	55	53	31	62	26	44	50	63	45	50	24	38	46	43	55	64	42	36	36	32	49	64	59	35	89	36	50	29	26	44	58	37	70	37	104	34	49	75	64	41	70	45	35	36	34	52	39	46	28	34	55	45	43	23	39	26	37	32	22	34	40	26	62	26	25	38	22	20	35	50	31	22	38	42	41	37	44	19	24	40	33	32	34	42	41	42	30	24	35	43	21	33	40	41	55	37	59	47	25	27	51	19	67	24	37	36	22	37	27	33	37	16	15	46	34	17	40	20	20	26	40	24	20	19	27	18	25	36	21	21	88	25	42	53	20	30	29	20	34	10	25	20	20	26	38	25	32	53	28	10	23	24	31	13	46	32	31	22	31	19	21	14	16	21	48	9	20	21	22	15	35	7	21	18	16	39	67	27	26	49	28	25	24	13	7	30	12	21	17	16	17	21	6	23	10	84	12	10	23	19	26	14	29	10	24	17	12	11	17	8	14	10	13	4	19	19	9	10	10	10	19	7	39	17	20	20	24	11	29	9	3	5	15	5	8	12	7	12	10	8	9	8	12	5	6	3	7	26	20	7	5	11	3	2	2	3	2	1	5	2	6	3	14	5	0	7	1	1	3	1	2	0	0
ne0010	1564	2509	1315	1120	696	853	763	788	665	674	647	805	710	624	785	542	565	536	677	673	594	542	617	459	568	452	660	607	569	771	499	583	415	343	529	453	389	471	457	482	409	357	443	361	516	366	384	374	518	283	314	380	304	512	531	534	362	419	489	321	362	335	472	353	316	459	327	408	364	388	389	331	471	375	381	466	326	370	454	363	231	472	308	436	353	324	398	346	274	423	415	426	266	339	330	294	316	186	287	239	307	301	428	286	299	243	353	257	260	382	299	335	256	237	265	315	264	313	300	210	285	249	436	386	501	340	291	367	228	272	256	232	273	348	301	247	326	268	236	266	197	246	257	301	222	300	248	299	326	312	223	206	281	260	270	271	304	243	228	273	275	284	244	261	334	200	258	388	175	285	322	235	206	296	208	406	336	229	249	249	234	224	233	193	192	276	198	275	325	281	254	272	378	200	197	237	285	217	250	168	163	244	255	238	304	160	225	197	268	334	186	278	296	170	174	345	196	304	274	240	312	226	226	251	290	355	256	236	191	181	273	266	233	272	239	199	170	216	276	210	287	197	166	314	147	209	210	140	208	215	189	202	239	200	175	159	201	224	234	203	275	163	248	224	168	166	159	270	254	201	253	178	145	154	232	165	158	205	241	168	214	170	158	218	163	221	220	148	128	186	218	147	220	179	336	197	270	160	167	207	213	199	151	160	235	145	223	286	166	179	190	176	222	150	189	140	226	279	173	126	205	206	224	192	225	226	167	184	166	154	215	125	155	144	167	207	228	236	158	169	160	237	181	149	124	201	219	233	144	186	173	190	188	156	165	144	186	196	158	156	109	198	190	131	165	105	122	187	161	205	202	110	167	127	181	190	139	189	161	183	300	111	171	99	282	183	118	163	152	157	179	261	141	246	122	115	150	138	178	118	213	167	123	164	221	128	151	111	119	208	154	140	102	115	193	125	113	162	180	145	91	140	123	111	182	206	124	157	154	168	169	183	148	213	121	108	191	101	111	150	125	115	122	125	125	132	91	116	173	108	198	146	87	141	187	163	151	152	125	118	88	117	122	103	96	129	120	58	137	144	410	147	110	132	159	137	133	65	93	138	129	87	84	146	89	139	93	144	162	186	107	171	133	137	135	129	169	124	109	119	98	102	101	130	136	122	150	133	160	111	82	177	98	111	145	210	148	137	108	84	127	110	178	108	149	150	138	84	134	89	103	164	141	105	104	125	143	141	190	163	128	75	139	119	63	231	102	109	157	103	156	193	135	120	138	129	97	104	169	119	95	135	101	69	159	112	142	107	118	88	74	99	84	125	125	150	102	90	134	100	113	82	116	107	135	100	84	169	131	123	119	108	145	132	71	152	107	124	62	112	134	82	122	69	109	125	75	95	115	131	105	75	110	110	132	87	88	97	94	122	118	110	118	183	134	77	79	65	146	112	109	63	95	95	89	102	52	93	92	104	70	92	176	76	115	95	87	94	140	79	133	95	87	98	74	115	115	122	121	75	61	80	55	68	112	76	126	127	132	118	52	101	84	100	91	67	94	110	79	116	130	139	61	60	85	108	103	54	98	52	97	59	119	84	82	111	59	111	91	91	84	111	59	94	92	90	116	92	85	93	84	98	153	41	108	112	129	97	66	83	81	100	97	87	96	88	104	92	80	60	120	100	71	64	78	70	92	70	82	97	78	82	85	78	59	81	131	85	65	98	79	86	105	71	67	53	92	97	98	52	125	55	80	55	74	77	71	98	71	94	78	54	42	67	52	56	63	69	73	66	86	64	88	63	56	40	74	94	66	84	107	133	106	53	84	66	40	80	86	82	85	93	48	52	58	68	46	114	58	74	103	84	50	29	45	38	56	57	84	78	54	79	59	36	63	58	56	59	87	89	63	71	93	83	80	48	98	247	80	36	81	98	82	72	71	52	85	69	67	101	63	95	48	87	61	76	87	78	85	74	67	75	48	114	87	51	88	89	54	101	63	111	76	68	92	93	86	89	44	82	103	69	89	80	68	103	72	79	80	56	103	81	74	44	114	44	56	29	60	53	100	63	74	50	80	66	72	60	48	86	56	86	102	56	61	74	37	54	79	69	57	96	71	38	51	62	51	111	83	49	64	78	57	58	76	71	66	64	49	102	31	41	39	52	49	52	53	53	58	51	53	64	92	54	74	78	44	86	85	39	68	45	63	40	44	60	72	61	22	55	84	41	69	60	88	42	35	59	93	81	78	59	73	72	49	79	44	33	42	70	70	56	45	54	48	46	64	37	35	56	56	43	71	50	37	70	37	42	45	45	63	40	33	32	26	53	35	58	51	73	82	67	41	78	62	55	71	73	34	39	39	34	84	53	36	61	40	60	33	46	32	40	71	39	33	30	37	47	37	60	50	47	43	44	34	34	43	31	25	40	81	17	31	42	39	38	26	17	49	35	59	42	71	48	26	53	65	52	32	46	57	41	30	24	35	61	47	56	31	36	83	48	53	47	43	45	65	47	29	23	61	36	47	45	59	57	68	63	51	31	67	51	51	49	40	48	45	52	22	85	38	35	40	29	53	39	46	35	41	40	47	53	34	39	51	39	19	35	31	39	72	15	30	75	46	49	28	56	43	44	27	45	56	40	24	70	39	14	84	49	25	18	33	26	41	34	58	57	31	35	40	32	49	36	55	29	36	61	46	27	34	42	26	69	28	22	26	35	46	26	25	99	43	67	42	52	38	17	47	33	30	31	57	23	65	38	41	47	32	45	49	27	77	48	44	34	39	49	50	47	36	44	38	22	18	56	28	40	51	57	41	44	54	27	37	34	50	21	59	24	42	37	34	58	27	36	35	50	30	68	22	31	48	38	24	44	50	37	32	34	32	38	44	23	37	21	49	46	27	37	42	24	23	40	45	18	33	59	31	51	42	58	33	54	48	35	30	25	14	41	65	40	36	58	42	16	34	27	39	47	41	33	19	19	30	16	24	36	41	45	57	30	30	25	46	14	51	28	35	52	37	50	42	33	23	36	21	22	39	26	18	45	17	30	21	17	13	21	41	53	67	17	28	35	38	19	30	13	12	33	18	38	31	52	44	31	27	7	20	25	24	21	31	32	62	32	24	45	33	42	53	43	30	32	15	27	38	33	32	26	39	19	46	22	39	30	39	11	37	22	44	56	31	37	7	20	23	30	24	17	22	21	34	51	48	29	32	26	38	26	25	28	18	27	19	25	27	25	44	33	26	21	20	44	23	80	9	32	18	16	34	21	18	37	46	17	27	27	20	32	23	17	43	23	31	12	10	36	74	35	24	26	23	12	19	17	23	40	18	12	24	23	28	26	30	14	15	22	34	58	18	20	23	24	37	42	20	43	13	25	31	44	20	14	9	34	24	18	20	25	30	11	23	18	13	38	29	4	24	6	24	24	11	12	20	21	25	23	27	18	31	15	20	34	18	24	32	24	25	26	6	22	17	8	20	12	19	23	36	18	11	21	19	11	7	23	11	16	9	38	5	14	16	15	18	10	15	14	19	4	0	12	20	21	23	20	12	19	13	23	13	24	17	24	17	12	19	18	15	20	5	12	22	11	22	11	7	35	14	6	12	17	19	6	17	12	10	7	4	8	24	40	5	29	19	4	17	18	25	14	20	29	27	4	23	20	20	12	6	9	17	20	8	7	14	14	4	8	10	7	15	4	15	11	11	14	14	18	16	11	4	23	11	12	12	22	27	6	10	7	5	23	4	10	16	12	7	12	11	17	12	7	19	7	21	8	14	4	4	3	9	5	19	14	12	10	7	2	9	5	6	20	2	7	9	6	3	5	4	6	6	7	3	19	5	16	21	11	4	12	5	1	3	16	10	10	3	21	6	7	4	5	17	7	12	13	14	4	15	8	14	11	6	8	3	5	1	9	25	10	6	10	7	7	5	9	12	5	8	0	12	6	3	14	14	8	4	10	1	7	3	4	4	1	1	7	6	2	7	2	14	9	2	7	4	6	2	1	3	5	1	1	4	2	3	2	10	3	1	18	3	5	1	1	5	4	6	1	2	13	5	2	3	5	6	3	2	5	0	6	3	3	2	3	2	7	4	1	7	3	0	4	0	1	3	0	0	2	2	1	2	0	0	3	3	1	1	0	5	0	2	0	0	1	1	0	0	0
ne0011	4197	3767	2253	1990	1638	2389	2424	1812	1411	1857	1445	1612	1788	1762	1431	1607	1839	1132	1519	1617	1086	1541	1223	1382	1047	966	1122	1358	1207	1306	1061	1163	1262	1319	1210	1223	1401	844	907	883	1116	1150	716	988	1107	1125	1157	1145	1472	1170	1169	1032	756	928	914	1306	599	741	816	814	1001	798	595	818	1021	747	1068	775	806	698	837	672	860	719	544	563	813	738	723	592	1064	641	931	801	604	851	602	783	787	700	1015	872	878	605	580	712	864	768	704	834	750	791	707	889	731	796	643	890	839	734	707	614	1075	884	814	984	863	893	418	727	643	855	483	692	577	691	640	576	872	755	759	853	462	595	553	429	483	486	769	541	734	915	562	485	513	737	629	377	548	571	780	543	726	707	645	388	760	443	732	722	626	537	690	594	728	413	532	490	383	782	635	487	747	600	691	482	515	714	402	418	589	628	500	513	479	307	524	607	416	411	483	509	541	696	462	643	488	750	477	510	615	373	400	552	366	643	503	510	822	402	660	499	491	658	589	555	412	302	525	434	388	511	349	471	518	500	554	470	486	423	399	445	409	362	512	513	441	360	495	452	540	407	558	426	282	440	580	410	472	520	451	358	513	392	738	612	487	448	392	369	572	428	404	440	320	579	501	311	327	385	464	428	504	373	394	375	488	537	487	338	286	361	323	229	337	251	512	450	380	463	392	538	304	364	416	340	516	438	443	373	330	338	469	404	385	344	332	387	360	322	264	389	328	529	319	248	323	355	630	406	430	400	384	266	290	433	384	374	380	312	331	530	405	460	316	331	383	287	485	392	364	332	534	355	592	363	306	355	191	273	339	312	302	409	309	398	337	312	257	221	434	320	416	277	454	331	365	429	341	328	362	253	358	385	308	273	294	357	325	326	422	403	315	535	375	326	262	263	349	278	268	285	333	271	405	316	261	295	223	412	362	283	531	320	398	263	253	305	354	276	224	260	305	426	315	227	396	351	287	380	407	160	359	434	515	259	365	321	254	238	382	316	285	294	283	389	245	245	319	259	372	205	264	259	239	278	328	209	319	298	292	348	313	276	208	204	340	254	215	484	308	271	176	233	234	221	176	354	254	296	185	320	269	330	275	231	301	215	171	225	188	229	425	199	244	209	302	367	402	336	174	222	202	161	200	271	227	286	234	496	192	344	289	285	446	266	187	249	358	359	257	317	262	218	256	247	231	176	248	277	227	192	219	409	247	218	226	326	210	227	263	282	239	194	209	219	215	291	179	268	228	196	210	243	208	157	258	208	198	315	263	248	268	212	220	203	268	186	306	234	228	341	283	230	194	249	220	236	151	181	308	162	107	166	218	297	261	375	251	226	216	219	260	148	252	228	279	183	191	226	168	308	221	138	242	197	251	168	399	186	236	160	153	272	204	180	154	195	164	147	152	225	160	114	145	132	154	236	236	192	176	150	175	187	272	256	176	267	140	169	192	162	200	191	162	172	171	317	137	148	238	236	179	183	141	129	210	247	146	167	150	211	191	177	233	177	179	259	189	144	212	244	142	215	242	208	212	257	209	172	180	126	172	245	183	184	134	144	234	183	188	166	210	161	126	155	207	109	118	110	136	187	181	142	127	136	235	163	259	106	193	233	148	150	235	242	186	126	192	179	133	191	175	275	184	141	326	129	348	165	182	127	204	105	148	139	169	210	173	104	201	143	224	236	131	151	111	238	158	102	141	89	172	210	203	130	97	123	183	165	107	160	95	152	99	164	198	163	111	101	158	177	181	203	136	105	113	241	104	162	130	173	333	102	173	139	215	127	202	146	208	147	200	168	131	142	165	278	103	147	146	151	133	85	122	227	200	233	144	122	129	189	115	206	228	185	155	178	154	177	94	112	212	121	146	235	83	153	162	65	158	195	98	129	179	160	189	138	134	125	159	105	95	160	147	125	123	102	79	131	95	127	210	141	137	156	117	132	103	116	143	143	123	132	128	102	165	120	103	86	117	125	147	163	152	84	83	100	109	96	76	158	130	197	143	145	127	114	117	118	138	155	96	157	109	125	199	85	135	146	111	124	70	141	113	154	171	150	122	136	191	168	111	135	92	76	229	107	90	121	125	153	171	155	124	155	80	144	187	83	136	166	106	151	132	77	113	169	174	69	81	119	76	132	93	112	70	149	101	131	57	139	81	142	139	133	159	175	97	141	109	105	78	123	76	106	144	119	91	70	120	80	120	129	74	66	100	135	69	83	95	119	108	113	139	64	130	116	156	161	147	100	101	109	49	127	110	80	92	113	140	124	58	105	68	107	119	111	121	124	78	128	62	145	83	109	101	61	79	116	134	135	76	61	155	93	70	75	93	112	130	81	98	81	71	97	129	115	149	104	85	69	128	122	119	66	102	48	115	100	82	94	128	163	52	56	138	77	144	145	82	112	147	113	124	60	109	109	136	70	103	81	74	115	80	136	115	91	139	125	100	96	114	73	69	96	87	47	74	96	83	108	74	170	59	112	46	98	97	80	81	84	81	97	100	56	57	53	112	95	91	145	114	143	85	93	102	79	60	138	75	100	49	129	102	89	62	91	96	63	79	76	72	89	39	96	98	101	81	144	103	51	126	103	68	122	95	63	71	88	68	47	69	75	69	132	63	72	49	70	78	57	60	56	70	87	87	115	100	75	129	68	42	60	40	41	34	61	88	77	64	80	87	164	69	67	67	53	63	65	98	55	50	86	88	42	55	71	83	72	84	77	65	101	80	95	123	103	60	131	76	79	64	104	47	55	67	74	45	111	55	62	51	139	57	96	80	42	65	98	106	70	73	112	63	67	57	80	44	60	81	63	49	71	65	36	58	33	61	87	63	53	48	36	89	49	34	48	48	60	85	58	75	97	39	38	40	64	32	55	90	51	37	98	59	51	49	74	70	102	93	62	68	48	65	75	55	63	37	64	23	42	73	70	70	33	90	44	80	47	101	108	52	49	76	98	51	64	37	82	47	61	74	62	39	55	81	58	116	69	52	56	22	26	32	47	36	36	60	105	41	82	79	47	39	38	35	56	82	72	41	71	84	65	51	41	35	50	42	66	30	100	62	45	44	47	52	27	40	48	29	53	64	51	59	51	27	42	34	70	112	59	61	30	71	40	84	78	29	91	83	46	57	31	67	31	81	79	40	60	41	62	46	73	53	42	44	78	42	59	113	49	42	55	46	42	27	57	34	51	65	64	40	45	61	58	24	42	47	113	48	57	43	37	73	38	48	70	48	71	79	33	30	44	51	60	21	39	52	110	31	53	31	43	29	30	36	31	80	30	28	59	43	23	45	37	65	39	75	32	78	42	38	54	37	19	65	19	25	37	32	35	64	61	41	45	59	36	25	50	30	52	62	35	54	34	20	54	22	30	47	35	43	33	23	30	31	25	31	39	32	30	27	31	44	53	28	71	23	42	21	37	52	36	39	25	41	48	41	30	22	48	22	28	12	11	27	22	61	60	34	59	20	55	34	59	20	29	47	32	22	38	33	50	19	37	21	28	27	22	48	28	17	20	27	38	24	30	107	32	20	26	40	25	25	56	97	10	19	22	17	32	39	20	19	13	15	41	20	23	21	52	19	27	24	33	15	22	24	57	33	27	18	14	22	21	18	83	11	81	13	20	25	22	10	38	44	19	37	42	27	13	42	28	30	45	35	25	5	23	19	29	32	18	38	16	11	48	20	12	23	14	15	19	27	11	15	31	14	23	24	18	8	7	27	32	28	21	24	16	17	19	10	12	36	33	8	16	55	36	18	23	22	24	29	31	17	17	37	12	31	18	19	11	22	16	9	10	21	7	18	24	9	11	11	16	17	14	10	13	6	20	17	18	5	22	9	11	19	25	18	58	7	8	12	17	12	22	12	6	12	23	26	7	14	6	8	46	10	9	11	11	20	23	12	12	64	20	11	10	20	9	15	8	9	15	6	5	14	38	6	7	17	9	6	10	61	6	9	2	5	7	5	19	7	5	15	5	13	5	18	6	5	14	4	9	10	8	8	11	11	8	10	7	1	16	5	12	3	11	63	4	3	10	5	9	1	18	10	9	11	13	15	4	3	4	8	8	2	2	8	4	1	2	5	6	6	5	3	3	2	5	0	2	3	4	6	5	0	0	2	3	1	4	2	0	3	11	6	0	6	0	1	3	1	0	1	1
ne0013	691	987	616	482	689	423	354	374	450	357	481	371	317	329	376	277	172	416	197	215	366	276	360	255	338	323	376	315	145	278	409	155	215	206	234	263	215	334	280	189	234	241	235	218	217	134	185	172	141	203	234	302	310	210	159	168	370	327	195	243	202	411	404	187	230	149	155	246	234	291	238	281	189	156	225	483	212	240	143	169	177	187	164	181	496	207	253	308	369	144	132	112	159	150	260	214	102	119	123	54	173	114	104	119	156	157	126	95	134	111	107	136	89	94	145	154	137	182	161	102	77	98	266	80	160	217	129	113	101	106	226	97	243	178	172	224	114	238	86	149	141	80	149	154	173	114	147	199	102	178	105	132	99	92	113	138	116	117	98	135	128	156	129	159	123	256	165	155	211	111	74	176	109	176	99	159	192	87	178	167	166	94	123	83	176	442	98	100	123	139	117	122	53	140	136	149	141	75	70	103	115	191	73	141	179	110	91	121	98	80	81	87	51	59	107	133	142	257	156	261	317	56	173	73	120	144	159	93	65	137	181	102	145	82	84	81	147	245	197	135	69	185	48	134	335	138	115	79	98	110	160	143	143	109	56	70	94	171	72	137	81	187	77	119	127	67	66	168	193	139	173	95	123	115	137	101	128	67	106	109	165	117	93	155	165	121	98	90	101	32	172	75	266	70	129	127	117	79	57	151	146	168	117	41	68	138	128	147	55	149	187	134	246	75	81	78	66	166	25	128	82	57	100	154	132	75	67	82	45	102	64	73	100	95	100	52	76	138	103	84	95	57	73	48	74	106	67	111	106	89	106	106	175	48	141	90	94	62	348	100	91	117	130	78	85	54	92	75	82	46	81	124	105	71	97	113	45	89	115	113	105	110	84	64	82	82	125	122	74	79	101	128	119	80	46	99	111	87	73	80	102	113	71	94	52	41	69	113	77	153	139	111	85	83	43	21	86	80	49	62	84	123	74	57	37	42	29	51	63	75	43	132	68	63	91	32	85	60	44	74	80	87	51	40	46	111	262	20	71	25	68	44	65	75	150	136	103	56	90	36	43	18	91	59	42	131	101	72	90	46	69	58	54	93	81	68	28	34	135	50	73	59	82	92	59	42	34	81	63	35	91	65	67	109	362	99	19	39	38	44	85	64	34	59	52	60	80	60	42	30	38	51	38	39	80	110	64	63	50	39	99	94	112	29	62	76	63	23	46	72	33	94	37	55	104	88	40	23	151	19	46	61	122	45	79	25	65	116	118	35	41	51	55	42	80	77	36	88	16	69	38	63	30	57	50	29	74	17	31	71	17	21	66	111	65	89	37	12	55	60	128	57	59	61	53	46	40	43	53	38	40	43	56	119	39	74	16	64	20	50	27	71	96	98	70	59	110	116	76	80	90	108	105	80	54	107	79	55	30	125	33	141	37	82	63	49	64	15	62	41	28	32	50	44	59	118	43	14	71	54	23	41	120	50	56	90	57	13	125	74	86	52	59	83	67	27	58	41	69	25	25	53	64	58	28	32	22	37	69	34	47	83	24	45	55	11	66	87	2	102	126	38	33	62	99	23	55	99	36	95	94	26	40	34	32	97	22	75	8	137	31	39	35	40	39	35	49	39	78	47	41	92	55	54	77	50	26	39	45	50	51	75	20	120	80	107	30	59	50	46	25	48	46	46	36	46	45	41	49	42	72	70	31	17	10	70	15	27	33	40	52	60	69	19	30	41	35	27	39	54	18	33	35	36	38	76	55	29	30	23	72	23	16	65	29	52	37	36	29	33	31	32	34	33	70	18	6	26	79	24	62	18	33	89	84	15	10	11	26	22	31	43	49	17	23	9	33	77	49	12	132	44	43	14	79	12	49	28	64	85	18	22	37	11	35	41	55	39	36	59	45	60	53	42	52	45	51	23	77	40	26	38	24	43	23	65	68	74	34	68	55	20	12	30	32	49	24	32	94	77	78	13	24	29	11	40	24	27	58	35	11	35	52	23	35	31	32	23	52	16	55	15	29	28	19	69	31	93	9	57	39	44	93	53	58	14	19	57	29	14	28	17	28	16	75	64	43	9	35	16	291	22	19	23	32	19	22	26	25	72	22	15	5	25	20	69	16	24	24	53	35	29	43	22	61	31	74	10	32	38	250	17	29	21	45	16	27	15	61	25	20	24	68	37	26	39	38	34	66	31	29	50	16	14	47	23	43	22	36	68	35	24	12	49	27	62	24	13	50	27	12	21	14	21	37	32	20	24	24	35	14	33	50	253	39	12	31	10	29	20	16	10	44	27	30	27	22	16	25	30	2	20	34	39	17	20	30	22	48	29	21	17	15	72	22	10	0	66	11	11	12	24	7	14	5	14	15	94	16	13	27	30	36	9	35	59	4	34	17	6	32	19	16	25	27	54	30	52	27	49	34	1	23	32	56	13	11	11	24	26	17	28	13	24	41	15	21	76	57	17	24	16	23	21	34	13	28	41	16	32	29	9	19	41	8	51	38	15	27	21	25	19	15	27	30	24	11	26	19	34	13	13	28	11	12	15	49	17	57	40	45	33	14	15	56	9	17	7	2	18	6	38	19	11	31	17	9	11	17	11	32	38	34	3	17	6	25	35	60	32	16	55	19	10	57	15	21	8	8	8	23	17	25	23	32	43	59	11	8	51	23	10	19	6	20	10	25	49	32	41	9	11	48	8	36	15	36	11	33	32	14	22	32	43	11	19	8	11	236	9	25	8	43	14	22	16	9	25	22	18	17	15	57	6	8	8	32	12	41	13	12	39	13	17	3	29	12	9	35	16	38	26	29	15	9	39	12	7	19	17	32	22	23	25	2	33	24	12	18	13	7	39	15	18	22	26	25	11	21	8	10	10	42	8	42	11	10	4	12	20	12	15	11	33	8	14	47	12	35	29	18	31	16	11	14	25	12	20	18	33	7	9	41	37	11	7	3	11	15	11	21	27	9	12	22	13	19	14	9	30	36	48	21	9	33	19	46	1	3	15	20	6	20	1	11	15	40	18	34	31	29	21	4	4	10	38	32	45	12	40	24	5	10	42	10	18	19	21	42	15	22	20	14	19	7	235	11	46	18	11	6	19	5	15	38	13	5	21	34	7	28	26	12	10	10	5	9	3	9	11	42	15	45	18	17	5	12	4	12	6	18	3	14	8	19	9	12	2	9	2	9	6	8	30	6	15	19	16	3	11	20	32	13	7	4	11	5	13	14	20	8	5	17	14	2	6	42	4	8	5	25	3	5	3	27	23	25	54	9	11	4	7	1	12	2	10	4	20	12	18	21	17	5	3	30	20	2	8	39	8	8	7	0	7	10	3	3	14	4	11	4	7	3	9	28	20	7	7	21	16	10	28	5	9	11	16	9	20	4	4	6	5	44	2	4	3	7	8	10	23	17	18	3	16	12	2	30	3	8	7	19	11	12	5	6	13	8	7	6	1	12	4	4	2	9	1	9	4	28	2	14	2	19	9	31	40	8	9	19	13	5	4	1	13	4	13	18	7	2	4	16	4	7	12	6	12	4	13	6	4	4	1	2	2	2	12	15	5	9	6	9	3	12	10	37	6	4	20	1	3	3	10	10	9	0	4	6	14	1	0	24	1	4	7	11	7	0	5	0	1	9	10	1	3	6	7	5	4	5	8	2	7	0	11	4	10	26	0	10	22	6	3	8	2	8	2	2	16	1	18	2	8	7	13	2	2	14	3	4	2	3	5	11	2	2	2	6	6	7	2	3	4	4	1	5	1	0	3	2	9	3	4	5	0	5	2	0	7	0	2	1	2	7	9	0	1	4	2	26	1	5	2	2	4	8	3	0	4	4	4	1	2	3	5	6	4	1	3	0	1	3	3	5	1	5	1	1	1	2	12	6	3	0	2	14	219	4	5	2	4	2	4	2	1	3	1	3	0	1	3	0	2	1	2	0	0	4	1	5	6	4	4	4	1	5	11	0	1	2	1	8	2	2	3	0	1	1	0	0	0	0	0	0	4	3	1	6	0	3	1	1	2	0	0	1	2	5	3	4	4	1	0	0	2	2	1	1	0	1	3	0	0	1	1	1	4	0	0	1	0	1	0	0	3	1	1	0	1	0	0	1	1	0	0	1	0	3	0	0	0	0	0	0	0	0	0	0	0
ne0014	744	1141	641	510	531	357	367	322	473	411	425	353	261	261	394	258	147	471	253	216	313	245	359	214	258	296	302	268	220	288	376	180	175	201	263	317	194	314	274	249	221	241	297	241	139	112	113	145	193	220	137	239	175	232	206	211	427	290	199	156	173	202	424	196	206	175	111	189	227	285	178	298	218	159	260	392	147	262	176	191	175	180	120	150	308	137	272	264	208	153	171	143	107	169	242	187	97	102	121	97	179	119	168	108	157	133	79	72	184	123	123	145	69	63	118	111	94	171	324	73	103	76	271	91	192	156	120	127	74	65	196	73	197	153	182	192	169	148	75	121	126	79	76	132	211	135	122	204	130	122	113	123	85	74	137	154	73	147	54	79	144	159	163	152	137	173	148	147	276	111	102	170	111	137	66	187	181	60	139	156	88	153	118	96	95	267	88	119	126	110	155	97	101	128	132	138	150	51	117	94	121	131	101	147	140	119	109	101	69	110	48	99	108	59	80	137	155	237	155	222	286	54	181	63	126	142	134	113	109	139	177	79	144	149	120	117	169	200	217	101	119	158	108	166	166	109	98	101	113	91	129	138	128	160	78	40	86	136	85	137	77	152	89	86	134	79	66	141	165	144	104	86	90	99	114	120	116	69	142	144	144	112	95	143	112	225	121	85	108	48	158	69	207	71	132	143	86	76	48	121	147	147	140	67	66	132	127	131	81	142	206	117	187	96	101	96	71	146	50	120	100	93	77	143	126	85	67	78	66	126	84	66	70	88	112	61	91	98	94	88	84	54	98	51	62	99	70	99	128	79	75	101	140	71	104	76	77	67	137	127	103	141	93	110	126	91	88	84	58	49	112	91	109	74	74	122	68	96	75	75	85	88	72	51	112	67	145	129	60	61	77	147	66	90	47	75	85	101	124	68	100	62	63	82	56	54	72	109	66	141	108	113	96	62	55	57	83	80	82	65	76	131	36	68	39	48	38	65	74	56	56	87	68	54	77	49	85	72	58	68	74	77	34	73	86	82	32	56	59	25	50	63	50	59	131	103	95	82	90	27	49	47	111	74	64	79	99	40	104	53	80	52	45	79	87	73	34	54	83	73	86	66	61	83	30	78	30	47	51	60	60	67	84	110	117	77	47	50	50	55	71	63	55	82	60	72	103	72	39	23	38	36	50	35	45	121	45	63	62	62	76	99	136	45	60	56	77	34	60	58	53	105	35	76	111	71	31	28	136	60	70	98	111	76	97	59	94	87	116	37	86	84	53	50	75	91	42	61	17	66	77	69	51	82	76	31	54	32	69	62	21	46	80	81	52	62	52	16	50	31	111	83	64	78	61	32	24	32	50	22	59	42	31	134	33	88	43	83	14	43	27	69	68	52	46	46	91	76	68	94	45	101	100	96	67	98	58	31	69	100	41	128	45	73	67	49	68	21	57	58	56	44	41	60	60	117	44	23	72	53	27	101	57	59	97	78	59	24	113	50	74	57	55	87	33	37	53	36	76	36	22	57	68	65	41	39	35	46	22	33	33	77	41	34	39	40	55	102	22	75	84	48	51	70	63	43	53	40	43	65	71	36	55	45	60	83	25	69	26	84	34	51	38	59	35	32	29	50	54	60	74	68	56	46	67	55	28	45	29	46	44	71	29	102	73	81	39	51	30	35	37	50	42	30	42	26	96	39	37	43	65	65	14	33	24	59	58	55	49	43	29	33	74	27	54	41	49	42	55	91	36	55	18	37	66	91	86	30	35	53	159	23	17	60	15	44	34	69	28	45	23	30	38	38	60	33	10	25	79	31	46	22	31	69	44	21	40	27	33	35	30	57	82	26	27	30	40	43	21	25	89	24	16	6	27	16	42	30	36	73	20	23	26	19	25	41	32	43	49	45	24	57	22	51	42	46	40	38	94	32	28	25	22	33	48	34	43	88	31	85	39	32	14	28	41	49	34	34	90	36	52	20	34	59	16	30	44	32	62	36	20	54	55	11	77	44	27	24	45	29	45	7	23	38	23	63	38	86	28	41	24	37	74	37	39	18	11	34	27	24	50	22	47	12	65	60	30	17	24	38	41	26	43	27	12	26	18	30	26	73	44	14	26	17	24	50	23	25	26	45	44	30	44	27	55	42	72	21	28	25	82	24	39	25	22	25	47	36	54	13	30	45	105	21	30	48	26	52	64	72	28	37	28	26	33	25	52	29	25	8	38	20	43	52	46	57	25	20	20	39	9	31	24	23	37	26	14	30	17	47	21	30	50	51	39	26	33	22	27	15	36	16	67	21	42	31	31	28	46	21	15	17	38	54	7	36	43	40	57	15	33	26	18	79	18	14	5	26	15	23	30	20	18	22	19	25	10	63	28	14	35	32	59	5	71	40	5	25	23	23	31	27	25	18	37	65	42	66	19	49	27	11	16	21	48	25	11	21	18	24	24	31	40	32	25	23	17	43	33	24	25	23	31	18	27	20	70	20	26	34	37	26	25	34	12	45	60	23	27	11	34	21	19	38	46	27	17	12	26	17	18	24	29	41	10	32	24	11	32	37	38	29	29	27	52	12	25	15	13	23	24	60	30	27	20	15	14	25	30	18	28	11	32	10	27	14	20	38	67	22	20	40	14	22	39	8	25	2	14	14	22	11	14	31	28	50	69	10	13	34	20	15	25	10	14	13	23	40	36	34	14	19	49	19	17	39	29	25	19	16	7	26	29	18	23	21	18	9	24	10	25	8	42	21	60	26	6	37	30	11	15	11	48	13	18	10	32	34	40	22	30	37	8	4	24	43	10	12	24	13	28	28	17	17	12	26	22	17	13	58	21	25	6	31	13	59	18	8	14	22	5	59	9	11	44	12	45	11	34	17	14	29	37	15	15	14	10	6	14	7	25	22	8	26	8	28	32	14	33	24	38	37	15	8	11	41	14	30	9	21	9	9	26	28	13	22	13	7	38	22	14	21	16	19	34	52	10	16	17	29	30	9	14	19	41	11	68	15	7	21	26	8	14	6	24	16	31	8	36	18	18	12	12	10	11	35	56	29	29	16	32	8	8	24	27	21	15	12	15	16	18	16	19	13	9	14	13	33	22	12	2	11	10	27	30	15	13	4	26	19	20	25	0	14	7	6	9	5	11	9	42	12	21	15	25	5	21	10	16	3	24	4	13	15	7	18	22	3	5	9	11	10	16	31	11	12	27	17	7	7	25	16	12	12	8	19	14	11	26	21	8	9	12	25	7	14	18	12	9	5	15	4	10	12	11	23	15	28	10	14	5	7	12	18	6	4	10	16	15	52	38	20	4	1	28	10	8	7	27	13	21	6	3	11	11	6	4	32	23	19	6	6	3	20	18	22	13	18	21	12	8	6	13	8	14	4	20	12	5	7	12	6	45	66	19	5	21	3	9	10	13	17	8	9	4	9	24	6	7	11	25	11	16	29	23	18	13	9	14	3	5	5	4	3	20	9	5	3	15	5	22	18	6	12	12	13	7	16	8	13	2	13	1	5	13	7	10	2	4	0	22	0	13	17	7	7	14	9	12	1	21	9	5	9	1	9	15	3	10	4	10	0	22	9	11	5	9	4	2	7	9	14	11	2	3	8	3	4	11	3	13	18	1	8	22	1	1	9	3	2	7	7	3	14	9	2	8	4	9	7	6	5	4	1	1	12	19	1	8	15	7	12	10	1	12	8	7	12	2	15	45	13	4	13	2	2	7	3	3	2	5	2	1	6	1	2	1	5	10	7	9	8	5	2	9	11	15	1	3	11	3	8	2	4	4	2	3	14	4	8	4	6	3	9	0	8	5	6	9	5	0	4	0	2	9	2	1	2	1	3	0	1	2	2	4	9	3	10	17	4	12	4	2	0	7	6	4	1	5	2	3	4	0	2	3	1	4	1	5	3	1	5	3	1	4	4	12	1	1	2	9	3	4	5	9	4	0	0	2	2	5	2	5	0	3	17	0	22	5	1	9	10	4	2	2	0	3	4	0	2	1	5	0	7	8	2	16	0	9	2	3	1	1	4	0	5	0	7	2	1	1	0	0	5	5	1	2	1	1	0	0	0	4	1	4	0	0	0	1	0	0	2	0	3	1	4	1	1	7	0	0	1	0	0	0	0	0	0	0	0	2	0	1	0	2	0	0	0
ne0015	678	902	597	472	617	392	384	338	335	317	377	351	310	320	363	248	194	379	266	223	281	253	350	238	299	247	315	316	176	258	371	163	205	204	263	257	211	250	264	113	206	240	163	167	136	113	159	181	182	197	196	279	257	292	179	192	225	273	192	160	211	147	284	132	212	130	120	164	201	230	177	247	196	118	215	377	152	209	209	166	167	186	158	154	262	140	210	290	147	157	130	115	122	109	172	200	92	60	106	72	204	108	131	103	125	151	99	87	155	115	106	128	96	84	117	161	121	180	147	94	61	96	309	91	176	167	120	121	101	88	197	96	185	116	167	163	108	183	89	132	115	101	88	123	149	126	139	128	98	165	110	103	113	94	110	96	89	101	83	121	140	143	147	135	121	176	151	106	157	84	110	148	103	128	72	146	183	79	119	139	113	84	106	57	135	194	88	74	109	96	119	101	52	130	121	158	148	79	87	106	111	168	74	100	131	92	58	128	85	82	65	84	71	58	128	132	137	232	124	218	250	48	146	63	87	90	178	75	75	95	183	95	155	83	75	51	159	222	194	97	76	188	100	165	63	132	99	77	83	123	134	143	104	110	42	61	82	113	93	143	73	137	93	97	61	81	69	84	159	83	75	61	65	106	73	110	139	48	105	97	129	104	79	130	81	98	61	95	121	42	176	72	218	70	143	97	90	57	46	99	183	130	114	48	61	117	110	145	50	92	142	96	191	98	74	44	67	140	29	100	67	68	104	76	102	113	67	65	59	99	62	67	74	76	102	59	66	69	66	110	77	52	68	53	72	60	77	88	80	69	75	112	146	32	83	68	79	50	111	82	88	76	182	81	136	56	77	58	76	54	67	82	90	46	85	75	53	93	94	109	144	105	89	53	91	98	54	110	64	58	75	164	76	58	34	70	97	84	73	54	98	72	61	84	67	49	61	113	82	128	127	98	40	76	63	23	76	73	63	41	67	102	43	46	38	18	51	67	35	50	56	114	43	74	72	49	39	38	34	57	80	52	31	41	61	82	33	32	55	38	65	22	49	74	126	97	86	49	66	32	66	21	117	64	51	101	84	38	75	40	119	61	37	52	93	56	40	25	106	46	60	38	60	69	43	38	30	43	68	62	52	98	43	60	113	62	32	37	46	63	53	47	45	131	64	35	59	54	39	36	25	30	33	55	61	90	56	39	49	53	80	85	131	49	81	56	61	35	47	64	50	73	28	56	124	89	65	33	163	31	55	41	96	54	59	15	62	106	124	25	40	53	39	44	71	81	33	101	13	56	28	43	28	36	50	24	56	42	40	62	13	26	39	80	68	84	24	19	49	34	114	71	48	70	52	21	25	38	27	49	32	46	25	113	22	65	19	69	18	33	29	34	47	61	53	30	88	74	71	96	69	56	99	71	53	86	107	41	44	113	26	108	25	54	83	23	53	7	46	52	28	58	42	46	47	114	31	28	36	50	18	54	69	50	77	64	22	12	107	71	70	33	63	69	38	44	31	39	59	26	18	25	40	42	17	44	25	20	22	23	23	48	25	64	33	12	43	77	8	61	83	30	48	54	70	17	42	58	11	62	92	32	21	35	30	55	18	92	19	76	14	41	55	67	41	24	17	40	41	28	39	78	34	48	107	54	37	46	45	40	57	54	21	101	69	78	28	49	38	25	36	60	57	21	27	22	61	30	41	37	82	39	29	20	25	58	9	41	27	21	39	42	44	18	36	40	44	36	58	41	18	36	39	33	46	87	24	36	27	52	53	26	27	40	24	41	21	39	17	34	12	29	43	33	40	18	10	37	54	25	50	31	21	50	41	21	18	14	23	22	23	50	17	14	42	13	39	30	23	32	90	45	25	20	42	12	29	22	41	79	26	29	49	8	30	17	29	22	45	24	6	42	31	39	32	26	52	30	65	18	31	30	37	44	29	40	46	22	17	43	29	42	12	5	33	32	34	23	90	38	62	14	27	40	23	37	30	37	47	45	18	36	73	12	28	13	30	37	32	22	28	5	25	29	19	61	11	88	9	41	37	39	63	41	41	11	13	33	17	19	47	20	43	14	87	44	43	12	14	36	38	19	11	22	30	33	23	29	20	38	29	12	4	20	30	31	31	25	32	26	47	26	37	39	47	44	49	15	38	14	43	14	9	20	27	27	31	19	32	20	25	21	73	26	42	38	21	43	100	20	10	35	19	26	44	26	32	24	26	43	33	17	19	52	26	39	31	18	38	35	5	28	20	36	30	28	9	24	16	54	15	22	34	20	33	23	29	22	12	13	14	13	35	10	27	31	21	12	21	30	6	7	27	40	5	25	45	35	53	18	28	19	22	32	13	18	4	34	4	16	14	21	15	11	10	22	32	71	15	12	32	21	33	33	39	36	11	28	25	14	20	12	12	17	33	18	29	10	16	44	32	2	11	21	44	7	20	10	14	19	24	32	21	20	36	24	9	51	48	19	9	13	30	13	29	21	35	32	17	15	29	9	9	25	6	30	53	17	30	46	38	21	18	17	31	25	10	10	23	17	11	26	11	14	12	23	28	6	26	31	20	16	15	17	53	13	9	10	11	24	10	50	8	26	39	18	14	5	11	10	24	29	22	12	18	10	27	12	38	20	12	49	21	14	29	17	20	4	8	8	17	6	25	16	27	23	60	4	8	48	12	13	23	12	13	2	12	34	20	38	10	11	34	8	17	30	20	19	18	23	9	25	32	19	9	23	10	12	32	9	19	11	15	17	20	19	12	40	4	8	4	9	44	9	13	9	32	13	23	17	18	32	12	5	13	29	3	7	55	13	32	18	24	14	18	19	12	7	10	27	18	29	13	18	8	32	31	15	9	10	4	22	6	20	20	14	35	7	31	7	5	6	30	14	16	7	21	5	4	20	10	14	8	30	9	28	31	8	42	20	29	20	12	9	12	33	13	20	16	22	12	13	18	33	12	13	2	4	33	22	8	14	12	11	22	16	9	21	16	25	16	16	18	11	36	19	45	10	7	12	14	16	8	3	16	9	29	20	16	11	14	14	12	8	12	24	8	12	11	25	35	3	5	30	12	24	9	12	34	28	5	39	10	14	4	12	13	30	13	12	2	9	9	9	38	14	7	11	26	12	19	24	6	6	5	8	5	3	2	10	32	10	30	11	34	7	21	4	10	5	11	7	8	12	16	7	6	9	10	3	9	11	9	18	9	11	21	17	11	6	17	26	6	11	4	9	0	9	10	9	14	13	9	10	8	6	39	11	7	7	11	5	12	5	10	18	20	38	14	17	7	1	11	5	6	3	8	24	18	18	4	5	7	3	19	5	4	14	25	4	1	5	0	5	14	3	7	7	14	10	10	9	12	2	14	30	6	11	8	11	4	13	4	3	2	6	1	15	2	3	5	3	49	12	1	4	6	2	9	12	7	19	0	10	8	3	22	3	2	5	16	6	4	4	12	16	14	9	10	2	3	2	3	2	8	9	1	5	13	0	8	9	5	5	10	62	3	13	6	21	3	3	0	9	9	1	6	6	2	3	20	2	1	21	1	12	6	8	5	5	3	10	3	3	6	3	21	5	5	6	14	5	14	26	18	8	4	8	4	2	0	10	3	0	1	3	3	5	3	0	11	0	1	4	16	12	3	1	1	2	11	7	5	1	3	9	13	1	3	9	4	5	0	31	2	12	3	1	12	10	3	2	11	4	4	11	5	20	0	8	2	3	0	6	2	3	18	2	3	3	3	2	2	1	0	1	3	9	12	1	5	8	3	1	17	2	1	7	9	7	1	0	9	1	5	2	1	3	2	2	13	1	4	2	0	3	3	1	3	3	0	7	4	0	4	1	3	5	0	5	0	0	1	0	3	5	4	12	1	0	6	3	4	1	4	2	2	1	5	5	1	7	0	5	2	0	1	4	2	7	10	3	2	1	1	3	3	0	0	1	2	0	3	5	2	0	1	4	2	4	2	0	1	0	2	6	4	0	4	0	1	3	0	2	3	0	0	1	0	0	4	3	4	4	8	1	13	0	4	2	3	1	0	0	0	0	0	12	5	6	0	1	0	0	0	0	0	0	0	1	0	0	1	2	2	1	0	0	1	1	0	0	4	18	0	0	1	0	0	0	1	0	0	0	1	3	0	0	7	0	2	1	0	0	0	0	0	0
ne0016	1003	1083	688	661	529	655	469	629	505	407	496	579	491	462	518	321	326	402	382	446	414	326	460	314	341	328	403	335	304	402	316	174	246	316	322	342	262	297	277	212	268	270	363	247	202	240	220	241	192	219	346	350	217	315	303	233	306	424	234	190	329	191	255	218	231	186	238	224	251	233	232	322	268	180	183	383	181	272	232	164	213	216	254	171	274	232	234	339	155	228	175	252	236	173	220	155	198	106	115	119	285	133	149	211	159	177	148	168	246	209	167	150	189	178	204	140	299	229	180	194	130	180	414	133	224	199	128	154	213	172	209	94	184	191	249	143	259	174	171	142	151	145	139	151	161	167	143	199	120	196	146	109	136	109	123	182	118	99	178	141	168	157	158	194	236	199	149	215	143	162	143	168	147	213	163	184	264	157	169	144	98	118	134	108	100	191	104	110	137	155	202	125	82	160	138	157	193	155	136	154	107	167	111	163	153	132	99	164	87	117	153	133	150	75	71	210	156	247	146	271	274	74	188	81	151	161	286	125	111	123	230	102	187	110	134	103	122	264	261	92	115	258	114	162	138	139	154	111	139	99	129	119	199	135	87	140	92	187	111	164	93	140	94	98	124	102	93	162	172	148	122	86	132	145	175	147	232	85	128	108	117	131	96	108	76	96	97	109	85	46	230	108	234	84	169	144	116	85	71	132	163	185	101	71	79	184	97	223	82	139	186	124	202	121	105	108	84	145	67	129	114	97	111	129	144	110	68	102	89	91	116	105	103	149	121	62	81	95	111	120	88	61	88	54	104	94	78	116	96	91	98	164	191	81	139	135	118	59	120	112	68	106	159	86	121	109	103	78	96	65	104	61	102	73	74	83	74	146	113	149	152	79	108	84	139	86	88	149	70	67	85	142	99	66	48	76	92	111	84	68	111	120	115	106	93	49	84	92	119	154	155	94	94	92	109	46	62	73	94	84	73	107	48	45	72	64	51	86	44	82	75	106	67	86	75	61	102	52	27	61	158	79	34	64	106	77	47	50	88	57	60	46	49	74	166	72	156	69	82	43	66	45	122	53	56	99	92	65	97	52	219	80	41	94	108	45	47	49	106	65	62	44	61	76	62	42	45	60	72	80	62	71	59	102	133	59	46	42	64	61	75	45	65	141	68	69	80	74	57	58	28	61	57	52	57	147	57	84	79	67	76	78	142	36	101	62	91	39	57	48	62	123	34	46	79	130	73	70	241	46	65	37	138	52	48	116	47	146	188	46	75	66	70	64	82	94	61	135	32	55	47	71	31	71	49	55	68	50	48	60	28	43	64	122	54	101	34	33	68	34	139	82	82	56	88	33	29	76	72	75	40	81	44	138	26	106	39	66	41	59	58	52	66	85	51	61	60	121	72	97	59	107	118	62	56	99	75	37	38	133	35	86	43	101	81	63	85	18	107	64	45	86	47	62	52	144	29	25	91	51	25	44	124	67	73	61	43	25	129	84	65	64	79	71	42	40	66	47	106	36	39	35	51	74	43	34	61	43	46	48	22	37	41	60	66	23	51	62	21	52	55	41	52	73	99	52	49	36	42	43	86	47	40	40	32	108	16	99	33	81	42	46	87	65	49	30	37	41	66	53	44	76	62	37	96	72	83	50	27	48	68	61	35	123	111	70	39	82	38	26	40	43	39	32	46	35	58	35	53	70	117	50	43	36	22	79	31	39	29	47	45	31	82	63	38	49	57	51	42	43	34	55	39	50	52	54	112	40	29	47	45	30	36	59	30	61	32	46	24	33	42	61	37	24	61	30	25	81	71	46	91	70	42	87	63	23	28	36	36	35	26	46	50	39	81	15	43	74	46	28	119	36	35	6	51	27	34	30	64	88	59	13	40	19	49	33	48	29	34	61	25	51	39	50	42	27	48	32	71	12	59	56	42	41	31	52	57	76	29	63	20	41	26	20	41	43	56	46	113	40	53	16	30	29	21	33	40	32	36	35	62	40	44	25	42	46	49	37	33	24	59	9	16	35	28	65	19	113	13	51	25	35	59	31	31	23	24	26	23	18	54	16	31	14	78	43	38	28	20	30	23	20	31	21	28	22	32	33	14	56	33	15	26	26	30	65	41	35	30	48	52	22	66	38	56	36	41	25	43	35	36	28	27	29	37	12	42	25	34	28	26	30	71	18	32	50	22	40	112	54	34	67	28	21	55	27	35	19	16	39	31	24	26	102	41	48	43	17	66	38	14	29	30	31	24	28	20	20	16	30	28	36	37	20	24	44	31	27	20	21	16	22	35	13	34	42	14	13	26	30	23	12	34	51	8	39	49	25	34	21	37	42	24	62	15	21	11	49	11	19	16	20	35	32	12	41	39	78	34	11	23	29	26	11	32	17	27	34	13	25	22	14	12	32	50	35	37	38	21	41	71	8	15	10	96	12	5	12	20	21	39	40	14	21	40	14	22	30	31	50	22	30	31	20	53	30	20	31	16	24	28	25	21	24	19	43	43	22	47	15	25	21	15	30	32	25	18	16	40	32	11	42	8	16	26	14	31	12	23	37	29	15	33	19	63	18	26	13	10	29	19	40	14	35	28	32	17	22	18	3	38	8	24	15	17	14	29	30	48	18	14	34	23	16	22	31	50	8	7	11	19	18	24	21	22	34	81	5	12	20	24	19	15	15	18	15	16	80	20	43	5	20	50	8	26	19	38	15	22	35	16	36	26	20	16	26	18	14	26	20	36	14	32	15	22	18	29	11	12	7	24	15	37	9	27	21	20	17	30	9	21	26	19	12	17	36	15	19	25	17	21	19	24	20	15	24	12	10	4	101	16	17	18	24	7	32	31	20	10	9	14	49	8	22	20	8	25	10	32	15	18	19	38	12	12	19	16	15	14	24	7	17	20	37	15	25	25	35	36	30	20	32	13	20	7	59	13	22	7	16	45	14	33	36	16	10	9	16	29	15	6	14	14	23	28	14	7	31	23	34	37	13	23	7	25	15	29	19	10	13	30	24	8	6	16	13	27	18	20	27	34	17	22	8	5	19	38	13	11	20	27	14	6	66	11	7	11	8	6	12	16	18	19	13	11	9	15	17	24	23	7	20	9	11	43	20	8	14	52	15	29	19	8	12	12	5	9	8	11	17	49	5	42	3	37	10	16	1	23	7	12	7	14	10	7	17	13	7	13	5	8	14	19	26	2	9	6	29	14	6	25	26	21	11	4	15	7	20	19	14	10	9	9	30	12	8	4	20	16	2	8	9	12	8	20	25	15	28	10	38	7	4	10	4	4	8	4	6	30	19	13	8	9	3	26	6	6	10	20	8	15	8	1	11	25	9	2	20	65	3	14	4	10	8	37	23	9	13	52	5	6	24	18	6	15	12	14	3	13	13	11	12	28	8	13	9	9	8	17	19	5	8	1	11	10	4	64	6	16	7	18	9	9	5	7	13	19	6	8	3	8	8	10	5	15	8	13	6	35	7	20	16	9	5	3	28	24	15	2	11	4	7	2	5	13	5	13	5	8	6	10	0	8	18	12	8	8	7	6	7	7	7	4	3	5	3	10	8	5	12	7	4	17	32	14	4	12	11	3	3	6	6	18	4	2	7	2	11	2	5	31	1	3	11	15	1	2	8	2	8	3	13	6	5	0	4	7	7	5	11	9	4	1	3	4	8	6	0	12	18	2	5	13	1	1	13	1	11	3	17	3	54	5	22	2	4	17	0	7	5	3	15	8	22	7	7	6	3	7	1	2	41	9	5	9	7	3	1	12	5	2	14	2	4	7	0	3	7	5	6	6	0	5	4	3	4	2	2	3	1	5	4	12	1	11	0	8	5	0	4	0	4	4	8	1	6	2	7	3	1	5	4	7	1	1	3	3	1	5	2	4	3	0	5	1	1	3	1	3	8	7	7	2	0	4	5	5	7	0	3	1	2	3	3	1	1	6	2	6	1	3	1	1	1	4	7	1	1	15	0	10	2	3	3	2	0	2	1	1	1	0	2	5	3	4	5	13	0	5	0	1	1	0	0	1	0	7	2	2	0	2	3	3	0	1	0	0	1	3	1	1	0	0	1	2	6	1	1	2	1	0	0	0	5	2	1	0	0	0	1	0	0	0	0	1	0	0	0	1	0	1	0	0	0	0	0	0	0
ne0017	578	872	638	549	429	324	323	299	373	274	393	339	203	232	237	210	127	452	200	166	268	204	308	326	274	307	301	216	143	186	338	178	165	161	196	206	177	327	269	131	226	221	188	167	143	93	109	91	81	172	147	234	181	150	162	151	353	343	189	181	165	208	339	239	213	147	134	170	220	270	170	212	115	102	223	340	122	159	133	170	135	133	152	219	265	188	256	208	130	116	95	92	151	106	202	138	117	109	69	70	126	122	128	98	137	110	118	72	107	110	100	95	63	71	127	109	103	168	215	85	115	73	359	61	144	163	149	125	69	83	167	50	214	171	156	332	115	187	62	151	74	74	117	182	151	82	130	250	75	92	80	138	48	75	102	138	78	136	57	85	140	108	103	72	119	186	131	87	153	93	87	171	72	68	56	129	182	49	150	207	95	167	103	86	84	180	63	69	137	110	124	89	80	91	107	130	144	50	48	82	96	144	109	126	196	106	95	86	61	73	51	92	88	32	65	96	183	181	96	188	228	112	182	43	56	105	124	74	79	131	153	75	144	103	87	76	95	183	148	134	97	199	66	291	260	101	68	71	83	61	107	141	125	368	28	45	90	143	93	143	79	131	83	60	112	75	50	121	131	168	159	93	113	91	102	132	104	61	105	102	122	111	114	176	113	218	58	135	116	35	172	60	164	54	162	141	154	53	44	127	136	195	133	39	48	78	107	82	24	155	262	126	151	109	64	175	53	131	60	94	74	48	91	119	92	90	60	71	62	178	75	53	55	95	63	40	91	59	72	103	126	41	76	40	59	81	51	112	135	75	78	115	142	23	101	55	146	118	124	187	146	143	82	105	63	67	85	100	50	32	102	107	80	58	122	118	54	57	96	102	71	72	75	41	87	68	99	109	46	69	81	149	111	67	29	70	87	105	109	50	74	27	42	58	64	67	57	91	50	118	116	107	64	68	55	28	83	90	38	31	50	146	31	40	38	46	48	63	71	97	62	92	45	55	63	14	128	53	47	57	97	85	40	65	53	90	75	19	30	21	49	37	43	58	124	119	95	47	87	28	46	17	83	55	51	107	144	69	68	94	148	49	57	120	100	63	34	47	70	71	83	76	47	82	59	58	43	64	61	48	56	60	82	114	139	70	72	39	44	44	110	30	35	83	60	51	94	90	27	41	56	43	64	49	53	70	46	50	51	40	73	88	109	7	67	98	26	19	29	37	41	59	31	66	108	75	41	13	156	33	38	54	94	51	98	32	77	99	98	30	34	53	56	42	43	63	30	59	18	62	31	43	28	35	62	31	70	33	125	65	13	14	119	71	58	108	64	15	88	34	129	44	32	57	39	37	29	60	25	31	62	30	25	115	37	70	6	67	18	40	18	68	79	43	62	35	102	60	81	144	65	39	86	93	51	61	62	44	53	90	57	76	48	53	86	39	36	13	65	52	30	41	28	33	46	98	29	16	62	49	18	40	43	56	87	97	36	25	117	44	62	45	51	66	54	28	41	59	47	97	17	47	49	102	27	16	17	68	22	25	107	82	45	62	59	46	58	87	21	56	103	22	50	84	138	20	54	52	33	60	75	24	28	27	72	87	16	59	8	53	27	34	45	76	45	28	35	71	45	32	45	60	50	38	71	46	21	44	16	50	63	76	21	93	73	63	45	42	39	53	48	50	73	42	34	103	61	39	37	33	69	73	18	14	10	46	44	62	35	41	55	41	62	51	59	37	32	25	49	59	27	44	29	27	39	67	46	16	9	7	88	28	14	49	36	30	36	60	26	27	13	53	29	37	42	13	3	20	56	35	44	23	25	51	35	4	9	20	39	46	54	48	36	16	23	23	43	47	37	12	139	37	28	0	14	6	28	21	98	130	5	28	28	27	17	38	30	33	29	46	74	45	23	48	49	41	32	27	84	14	31	25	50	46	35	54	33	36	22	49	53	14	13	30	55	33	20	30	77	28	47	20	12	37	8	28	49	35	47	43	26	30	53	22	44	34	21	24	15	19	38	3	16	27	17	69	36	106	21	49	29	40	73	33	52	20	8	19	23	12	13	16	36	13	62	47	8	22	10	38	48	44	18	11	30	26	16	23	12	43	32	12	13	12	25	58	12	17	39	68	28	17	29	28	48	50	63	18	19	19	62	15	58	15	43	16	37	16	49	8	34	90	78	22	29	34	26	70	53	40	18	47	13	12	34	25	32	24	24	8	33	15	11	66	37	62	16	18	35	81	5	22	13	24	54	25	35	30	20	73	17	26	40	35	32	29	27	14	27	5	25	15	62	23	25	27	56	35	19	15	5	33	56	46	3	18	38	34	72	16	6	20	20	36	22	30	13	46	18	21	18	27	4	5	17	22	8	113	8	9	30	20	24	10	48	61	0	182	5	10	17	21	6	24	18	69	27	18	23	31	44	17	43	17	69	8	5	14	15	38	23	23	50	53	27	27	11	44	45	8	35	12	28	14	42	34	44	20	5	29	27	7	18	23	4	34	60	40	17	15	16	16	3	27	31	26	17	9	26	16	19	19	29	17	11	17	27	13	43	32	31	12	15	4	104	10	20	10	12	16	11	46	16	12	39	16	15	59	23	13	59	17	21	9	16	8	15	78	45	21	10	37	22	24	27	10	25	2	5	14	16	8	34	24	24	10	125	10	9	30	20	17	31	6	14	13	17	47	44	28	0	21	19	19	25	33	36	10	20	24	6	10	24	16	10	22	8	3	30	3	34	5	24	25	23	21	9	25	31	10	12	38	55	1	8	12	19	18	22	12	14	30	6	12	15	29	13	5	22	17	28	5	12	36	17	19	11	80	13	36	17	22	11	15	12	49	24	10	16	18	4	18	9	6	35	23	40	10	28	21	9	6	33	12	8	24	4	5	12	14	2	34	8	43	9	23	26	20	18	28	34	46	7	7	7	32	17	12	11	13	6	0	40	32	12	1	5	5	28	24	9	16	15	4	31	26	9	31	6	12	30	13	23	17	32	38	44	13	4	49	34	6	8	4	14	9	38	13	25	13	23	18	7	14	25	24	7	16	22	15	14	2	5	40	4	9	25	16	13	13	15	11	8	8	7	18	31	24	13	15	1	24	10	26	15	10	10	11	32	32	10	19	6	12	16	7	8	3	3	2	16	10	21	11	6	11	10	9	2	6	16	3	15	8	2	19	27	4	11	3	4	2	7	44	14	9	19	2	12	1	18	16	10	10	7	17	3	5	18	7	14	19	17	12	2	4	21	7	3	0	26	2	7	7	33	18	14	27	4	16	11	7	4	4	6	7	3	34	16	21	11	13	6	0	40	35	9	1	18	14	52	6	0	16	16	6	5	11	15	12	5	3	0	5	18	55	8	8	12	24	10	17	8	17	7	20	7	35	12	3	12	2	44	5	14	1	3	5	9	21	7	11	2	10	12	2	37	5	11	0	50	1	17	54	15	18	2	4	8	3	5	3	2	2	29	1	3	5	19	2	10	2	7	8	61	78	17	5	7	21	1	12	0	11	1	3	8	4	1	4	2	6	4	4	42	2	7	3	17	15	15	8	2	2	18	5	35	2	13	9	5	2	8	16	19	2	3	20	3	2	1	13	10	5	2	6	5	3	0	0	23	1	12	6	6	4	2	15	0	0	16	7	3	5	1	5	2	5	11	15	2	1	0	18	5	17	18	0	18	14	4	6	13	8	3	3	11	19	0	0	15	46	14	7	8	0	6	1	1	4	7	0	3	2	2	7	5	12	3	2	5	12	3	1	2	0	1	2	5	0	1	0	1	4	5	3	6	5	3	6	17	3	22	11	0	17	2	7	5	1	26	14	7	1	8	0	25	3	0	0	0	0	3	3	0	4	21	7	3	2	22	8	1	4	5	3	2	4	2	13	5	12	0	1	2	5	28	10	2	1	3	1	3	12	10	3	17	0	0	3	6	0	2	5	6	0	9	5	0	6	0	5	1	0	7	10	0	2	10	7	5	0	2	1	0	1	0	4	0	0	0	1	0	4	1	23	6	0	5	1	8	0	0	1	0	9	0	1	71	1	1	2	1	1	6	1	0	0	1	1	1	0	0	0	3	2	0	1	0	0	0	0	1	1	1	3	0	0	0	0	0	0	0	0	0	0	0	0	1	1	3	2	0	0	0	0	1	0
ne0018	802	748	531	359	322	482	364	364	297	330	240	303	349	288	301	219	286	221	186	318	240	229	250	152	293	131	272	266	166	254	194	156	178	207	212	255	195	199	244	156	168	206	126	154	113	159	187	179	211	166	213	173	208	145	135	221	113	194	198	193	166	86	163	214	159	155	170	104	135	152	232	112	212	149	93	233	114	141	190	142	174	187	124	146	153	151	181	154	104	129	136	191	116	147	108	144	104	107	107	92	86	98	208	118	80	119	158	121	150	103	118	113	107	110	106	174	163	138	75	125	113	118	152	165	113	81	104	79	139	114	129	113	99	96	98	87	87	124	115	74	114	126	93	76	131	76	87	95	112	115	108	76	95	158	93	70	101	115	109	140	99	115	100	106	114	101	113	111	85	47	100	100	88	96	104	151	77	105	68	116	107	101	64	78	155	103	124	68	130	112	99	85	44	95	92	45	70	95	87	59	82	89	59	85	64	88	77	66	129	95	93	89	78	87	121	126	72	125	100	93	119	78	103	102	92	48	162	64	99	58	78	92	62	61	84	76	60	107	142	58	52	67	70	70	69	65	61	65	62	71	77	52	62	91	50	86	60	57	118	62	77	93	107	84	38	79	68	75	128	114	78	106	68	72	79	68	115	71	113	64	98	80	60	54	65	57	88	66	89	76	80	73	106	65	54	66	45	66	90	62	76	102	90	69	75	58	122	80	72	54	71	70	89	43	81	63	72	171	41	59	57	116	124	63	71	54	73	82	63	59	56	72	84	43	49	63	63	116	36	94	58	72	42	91	88	108	80	92	38	91	61	76	87	55	56	62	42	84	58	78	44	50	35	47	57	42	40	76	51	63	71	41	63	57	61	44	86	127	66	65	86	60	60	66	89	68	33	52	83	58	128	20	31	138	54	50	55	42	56	58	70	54	53	45	43	64	61	49	38	62	65	71	44	54	81	51	44	46	44	39	47	38	66	42	94	54	105	34	51	47	34	50	27	62	55	56	36	44	88	47	79	32	95	49	37	45	31	61	93	35	52	39	38	54	58	51	54	71	44	83	68	58	60	44	30	40	49	41	67	48	64	50	75	42	22	57	68	38	58	37	51	42	40	34	38	98	37	30	28	90	39	80	35	51	56	45	59	37	47	38	29	40	42	16	16	38	35	70	55	53	23	48	60	19	48	45	39	100	45	30	55	32	53	34	64	52	41	51	50	55	34	68	26	57	38	37	30	47	71	55	61	26	45	48	32	18	32	68	66	46	42	50	33	33	54	54	52	49	38	46	27	29	30	31	36	27	48	30	20	43	42	49	26	50	80	49	13	33	33	21	38	57	36	28	22	33	57	59	39	35	27	96	38	47	39	19	21	32	33	56	39	53	19	32	37	55	30	44	40	5	41	31	45	26	42	21	15	41	20	39	37	43	31	43	21	30	63	46	46	86	46	29	52	47	42	60	33	40	18	37	39	57	49	20	43	24	21	41	51	49	34	24	32	24	33	67	31	17	50	20	27	21	40	38	58	42	33	48	27	55	10	27	33	18	30	15	37	28	14	58	40	35	52	27	30	11	34	38	48	22	44	37	25	29	45	35	32	49	59	30	19	36	19	23	35	22	28	30	39	38	17	66	27	20	45	28	51	29	36	49	57	46	39	41	46	48	12	36	40	28	55	25	43	23	25	16	29	15	27	43	44	33	17	19	20	41	17	11	34	19	22	33	14	31	34	16	34	26	46	17	52	54	37	21	31	15	11	23	32	56	18	37	23	35	25	28	20	11	18	20	33	25	11	11	33	22	18	50	19	8	34	35	25	21	26	47	32	25	31	19	20	43	18	33	54	34	20	21	46	27	37	28	23	27	26	11	17	43	23	21	22	33	19	25	22	12	14	27	30	20	12	42	18	11	36	24	36	31	24	20	30	20	12	31	37	38	17	21	20	31	18	66	24	10	27	29	27	14	34	27	28	24	26	36	41	33	23	62	21	23	30	25	17	11	19	23	14	56	32	41	30	26	52	30	31	26	8	34	29	47	17	31	18	37	46	19	22	19	19	15	28	70	31	18	45	37	11	38	17	10	52	15	20	28	15	22	20	19	25	21	17	21	10	25	36	15	40	39	14	23	7	30	15	17	18	26	16	17	15	29	17	14	8	9	21	10	12	39	20	8	26	27	31	20	54	37	8	21	34	6	7	16	21	28	32	38	24	25	11	24	28	26	20	30	21	21	23	16	6	15	43	25	46	16	22	17	12	23	20	26	15	7	11	15	14	18	7	11	14	13	11	14	10	6	20	21	6	16	11	18	13	7	9	10	5	24	10	12	12	13	31	10	19	19	30	24	14	17	15	14	12	17	25	8	18	17	38	18	13	23	12	14	69	27	12	5	31	37	20	15	37	20	13	14	14	15	10	11	10	27	25	13	8	27	25	9	24	8	13	7	21	26	10	18	16	24	13	14	13	21	15	6	11	4	9	6	11	22	8	10	7	21	26	14	6	13	9	4	15	6	22	6	10	13	23	23	25	33	11	10	8	16	8	39	18	47	21	19	9	8	19	21	10	7	14	13	7	18	26	13	22	17	13	14	10	20	26	6	7	13	16	15	2	7	13	4	21	24	18	19	18	13	14	12	46	16	15	13	5	5	6	12	26	16	10	11	19	13	17	8	22	25	55	8	34	8	14	22	8	8	5	12	18	18	14	9	10	17	14	16	12	6	11	14	20	8	14	6	10	9	5	26	8	3	12	5	9	14	16	35	12	8	9	10	11	9	19	9	15	14	21	16	15	7	13	22	14	6	15	10	14	26	9	9	10	9	10	6	27	4	34	2	9	22	6	22	14	9	11	32	7	4	7	16	9	42	10	10	15	6	6	41	14	4	16	4	21	10	10	19	13	7	1	18	9	10	13	9	7	21	9	9	7	35	4	4	21	8	30	18	23	9	9	2	5	9	7	11	23	8	6	16	7	18	19	2	11	10	17	13	16	18	15	9	15	20	14	5	12	11	9	12	12	7	9	16	6	12	8	4	8	9	10	7	13	11	5	16	16	2	5	5	16	21	6	5	2	13	10	16	2	10	10	36	13	5	7	4	13	24	10	6	8	9	20	20	4	18	9	5	1	10	5	7	5	2	1	3	17	24	15	9	15	6	25	18	10	8	8	9	25	2	3	26	5	9	9	8	20	3	11	4	7	8	2	7	5	16	11	5	14	17	2	8	4	6	5	4	4	8	11	10	3	10	9	10	9	5	4	1	6	6	8	8	8	15	5	9	3	1	2	5	8	8	7	3	3	12	1	10	2	4	6	5	12	6	3	28	3	1	4	5	0	13	12	6	6	5	4	9	21	2	14	8	4	4	1	2	4	1	4	11	2	6	3	4	2	8	7	6	7	3	9	6	3	3	4	4	6	10	3	6	12	4	6	6	20	6	8	13	4	2	6	4	2	10	5	12	13	7	1	2	8	7	2	4	7	4	4	38	8	4	5	3	2	1	2	2	9	2	4	13	0	14	7	6	2	6	11	8	2	2	0	11	5	7	7	11	2	12	0	7	6	2	6	3	3	4	6	23	6	2	5	5	6	1	7	4	15	1	3	9	3	7	6	4	6	12	3	5	6	0	0	8	1	6	3	2	10	6	3	16	4	4	4	6	6	3	3	4	5	4	7	5	3	1	5	2	0	2	2	6	7	5	1	5	2	1	6	2	3	0	5	4	5	6	6	1	0	1	4	6	1	6	2	0	1	2	7	5	7	0	2	1	5	4	2	2	0	3	3	4	3	2	10	3	3	0	5	1	0	1	1	2	2	1	7	3	1	2	1	15	3	8	1	5	4	6	7	0	2	0	4	4	1	3	0	1	1	0	1	0	3	1	2	2	1	4	2	2	2	4	11	4	3	1	0	2	3	1	4	1	2	0	2	2	0	4	1	1	1	0	1	2	1	3	4	4	0	1	1	2	4	1	1	1	1	2	1	2	1	0	1	1	2	0	1	2	1	2	1	1	1	3	0	1	6	1	1	0	0	3	0	1	2	1	2	0	0	2	0	0	0	2	0	5	1	2	0	3	5	0	0	1	0	0	1	1	1	2	0	0	1	4	3	0	0	1	0	0	0	0	0	0	0	0	0	0	0	1	0	2	0	0	0	0	0	0
ne0019	3839	4063	2696	2973	2216	1910	2503	1596	1797	1222	1597	1267	1377	1273	1690	1181	1055	1256	1202	1317	1416	1267	1138	1645	1190	1467	1381	1053	1432	1328	1197	1527	1047	803	1355	1185	1139	970	1015	1020	943	919	1182	926	1113	775	785	881	823	1009	771	1060	929	893	1075	773	1169	986	894	919	681	1004	906	1157	895	839	649	1047	822	774	933	717	897	882	822	936	960	812	864	798	791	898	645	919	768	654	740	856	546	773	908	880	515	674	828	642	702	1049	678	673	803	675	737	487	783	686	651	491	713	684	615	586	501	438	478	651	604	578	724	475	752	477	712	753	577	799	609	681	596	517	725	487	512	555	664	543	669	598	471	670	753	469	673	684	587	672	686	1185	605	578	601	566	582	622	577	584	433	598	384	589	551	616	630	697	509	561	543	776	488	732	653	615	605	606	456	718	647	357	570	565	894	502	501	604	681	447	538	454	525	520	739	568	794	609	536	551	566	361	663	504	455	577	600	469	1014	452	531	462	416	478	387	691	611	327	391	764	443	522	400	644	531	520	470	414	757	781	639	595	510	462	522	470	613	532	460	601	348	526	638	484	559	455	434	621	633	413	474	397	459	352	449	476	401	640	411	301	571	454	519	557	504	491	564	462	669	441	361	497	468	448	689	503	331	407	453	426	611	346	498	418	445	408	430	750	807	554	369	512	407	318	472	533	473	453	459	395	765	547	328	460	370	630	392	257	367	331	535	455	479	384	404	471	435	349	424	500	354	473	515	470	418	394	485	418	414	506	277	363	407	425	355	275	262	522	360	349	485	340	408	422	309	373	425	366	305	391	309	450	400	478	375	352	374	291	480	362	568	526	427	283	364	389	353	325	401	429	315	369	436	306	354	466	281	340	368	587	355	497	412	382	401	367	369	274	369	333	408	330	333	316	308	489	408	563	484	273	253	313	404	349	341	300	301	393	295	376	388	223	348	365	322	302	257	331	507	440	280	364	295	303	281	370	197	352	340	224	290	305	377	306	422	423	238	387	202	223	315	424	282	357	385	271	261	309	300	285	249	419	404	276	313	509	257	352	304	302	286	301	247	256	233	233	264	227	288	253	343	338	275	432	322	276	238	306	366	237	321	349	245	465	298	501	263	412	235	406	388	374	294	295	412	300	274	276	300	337	393	297	258	211	246	244	261	338	276	328	307	204	223	255	305	244	231	261	317	293	294	339	194	238	289	243	289	178	218	318	262	187	353	171	249	251	274	282	212	236	302	210	332	350	226	194	287	276	258	333	193	321	260	200	209	359	287	269	281	331	196	204	289	349	237	330	194	312	284	215	286	252	207	223	269	328	333	243	301	340	293	277	299	314	277	220	221	225	266	355	291	246	192	181	213	368	328	253	263	407	219	199	173	218	206	219	262	326	258	265	309	180	189	277	204	270	247	197	238	307	192	223	157	249	319	212	214	251	307	164	210	156	197	265	148	164	224	230	231	278	249	318	236	249	202	155	326	185	220	185	275	224	218	229	214	221	170	238	309	223	204	266	261	187	262	189	183	155	182	197	195	229	305	265	363	182	213	228	185	177	191	253	197	219	178	186	144	185	278	278	256	113	161	272	226	175	247	178	262	161	153	208	134	194	192	146	167	200	176	271	238	220	133	154	145	303	272	180	168	214	267	158	172	184	177	172	182	215	255	187	132	174	204	192	123	132	117	176	321	158	226	161	196	215	155	164	159	160	140	182	335	188	173	140	189	203	144	206	166	142	148	173	269	154	280	137	174	172	179	142	196	193	99	145	303	233	181	166	124	189	139	291	145	122	180	170	150	160	146	157	256	263	122	190	167	192	131	168	122	117	157	123	132	154	180	143	224	141	252	165	159	267	151	137	239	182	140	138	187	181	141	206	248	234	227	231	185	110	121	171	156	109	163	177	181	150	203	175	158	139	118	151	124	216	166	175	199	163	171	243	194	186	215	125	222	255	133	183	118	145	219	177	184	148	158	176	107	163	212	121	111	157	131	133	144	183	134	171	131	138	170	198	134	194	131	116	189	240	118	156	171	175	221	143	182	105	122	161	228	127	57	76	86	100	90	131	168	62	137	155	166	117	129	221	92	169	192	234	137	217	122	146	138	81	197	154	270	97	126	191	124	103	148	125	120	182	183	164	105	152	158	121	177	125	92	122	123	138	102	134	134	90	124	93	144	81	125	197	167	84	103	129	171	150	141	139	174	117	109	141	142	107	75	108	141	96	119	97	114	81	94	103	156	170	105	225	155	104	86	218	104	116	176	109	142	138	123	157	140	138	124	123	119	62	165	124	97	99	96	148	124	109	98	216	117	90	107	115	58	122	125	104	134	154	79	100	115	455	71	129	174	198	105	86	103	101	128	114	77	155	105	187	66	132	129	122	138	57	91	91	82	152	67	142	152	86	119	92	87	99	82	117	135	137	63	145	76	81	64	66	58	145	150	104	205	118	195	174	100	89	159	91	98	73	100	111	110	95	50	166	134	114	104	89	85	63	119	77	82	78	103	100	75	35	122	92	100	135	121	98	95	108	139	82	89	78	144	77	66	84	67	89	126	93	95	97	109	95	175	70	109	96	138	91	61	89	64	118	79	70	71	70	92	130	129	129	61	146	94	323	179	95	71	84	43	150	85	67	54	71	129	40	81	97	93	85	192	84	99	107	179	133	55	82	115	63	125	79	141	77	81	57	90	73	64	81	102	164	81	68	120	81	68	96	76	119	71	123	84	102	103	47	73	79	66	80	131	130	89	103	83	84	154	85	61	106	79	56	96	87	41	192	87	70	91	102	90	167	57	97	64	74	97	85	87	100	53	66	74	94	61	80	108	70	105	87	66	86	48	93	63	78	90	180	117	112	123	75	75	93	85	63	74	141	85	71	66	79	58	109	85	63	116	106	160	68	83	60	135	44	71	76	76	61	83	60	72	96	110	118	56	80	45	75	79	44	85	97	93	71	117	115	37	72	75	46	59	66	79	62	43	39	109	84	156	54	398	57	78	84	88	74	92	65	64	93	109	79	83	60	54	46	72	63	58	91	86	79	58	50	130	29	63	46	77	34	36	75	58	38	80	67	33	48	82	57	72	82	41	86	130	119	92	38	41	64	52	152	81	89	55	65	51	63	95	116	53	101	32	59	61	42	68	42	82	47	75	26	63	56	87	41	71	88	35	49	76	109	44	64	154	48	25	49	21	61	69	46	71	94	39	111	47	46	54	39	98	55	54	68	86	62	76	46	82	32	48	122	77	86	26	35	30	58	68	45	52	51	61	39	69	55	45	68	53	38	48	49	42	31	58	28	40	46	58	63	43	32	74	89	46	73	45	48	33	43	57	65	44	33	38	79	58	44	70	34	28	37	69	49	26	43	202	65	59	41	44	48	72	49	88	81	64	53	49	64	80	64	21	18	77	58	53	13	50	39	47	52	49	39	20	79	30	37	48	20	86	37	45	35	40	38	33	34	25	40	37	50	125	16	28	38	59	22	79	39	49	51	39	41	73	20	45	26	23	26	36	25	18	28	157	18	27	26	70	42	37	32	27	42	48	24	27	46	58	33	42	43	37	40	28	27	92	34	34	14	36	27	25	25	40	29	35	21	33	51	31	34	44	33	40	17	21	28	41	39	138	45	25	74	18	64	29	20	19	61	43	23	20	22	24	15	18	39	23	24	11	29	25	10	64	21	47	29	22	18	30	23	29	24	19	45	31	28	19	45	110	29	45	24	18	18	23	19	34	30	18	18	17	40	19	11	17	7	16	28	19	20	20	40	35	9	17	13	22	18	22	22	21	20	13	3	29	33	21	51	28	83	8	14	15	15	41	13	26	30	33	5	14	31	40	20	12	20	8	20	16	23	24	24	26	35	22	30	44	22	21	58	13	14	8	8	11	10	14	7	11	16	25	24	23	23	10	53	8	9	14	4	11	11	16	23	92	14	21	5	7	9	28	22	3	22	4	23	12	13	10	9	14	11	1	21	18	17	3	13	6	8	3	10	13	19	7	12	10	25	6	7	6	22	42	30	10	30	3	8	9	8	11	8	3	11	14	6	21	7	23	6	18	5	17	5	17	23	1	20	6	5	9	5	7	6	5	2	2	1	0	5	6	5	54	2	2	1	0	2	1	0	24	1	4	2	0	9	6	3	23	0	2	1	1	0
ne0020	812	830	580	785	693	410	358	380	449	308	462	438	272	323	282	265	191	444	242	261	366	269	360	318	292	314	307	253	283	212	318	217	179	178	224	260	157	348	239	159	208	177	371	252	193	125	178	130	110	155	223	211	273	392	290	165	336	377	197	257	201	191	231	212	185	176	165	225	227	287	176	298	163	195	215	358	228	216	195	206	114	176	166	142	281	164	230	234	133	176	113	161	135	214	202	170	139	114	142	137	140	118	140	107	151	106	78	97	163	167	129	181	103	104	136	117	143	151	271	110	122	92	348	107	224	178	110	176	111	99	149	59	228	139	197	212	223	189	93	156	122	78	151	182	147	86	128	265	134	148	94	169	67	94	124	213	93	135	86	171	160	154	91	98	180	229	141	109	225	220	102	205	75	99	89	121	191	79	182	166	194	123	187	95	179	262	132	78	137	156	211	98	129	89	128	144	156	73	73	94	133	216	98	128	181	90	110	72	44	111	75	131	142	60	77	118	165	185	103	231	210	128	162	79	68	102	188	80	82	143	179	109	201	144	142	44	113	229	192	119	106	211	78	173	154	92	75	88	139	82	138	144	168	126	73	65	76	135	87	179	80	116	93	73	97	60	47	160	157	98	133	85	119	115	100	123	178	81	99	117	139	120	111	176	140	153	41	121	70	42	166	68	216	66	170	193	130	95	38	97	138	200	122	41	77	160	79	111	39	177	166	99	193	105	74	110	83	166	84	85	74	64	97	118	138	71	57	92	47	106	120	56	81	186	128	77	50	108	68	99	85	81	59	73	68	87	76	69	131	86	91	162	144	45	111	72	132	77	81	127	96	72	62	112	93	101	77	57	60	67	102	69	64	64	98	156	59	78	93	158	187	71	83	43	74	97	150	112	60	70	116	150	88	71	73	63	67	110	137	89	54	51	64	61	75	56	79	90	63	122	150	83	47	54	82	64	79	72	53	90	73	119	73	42	35	75	55	52	59	90	44	100	61	40	85	31	82	52	24	70	96	73	36	58	94	75	57	47	43	45	54	82	71	67	144	110	121	73	79	26	72	58	75	57	62	98	146	62	86	56	231	49	61	69	86	75	53	44	63	97	96	44	48	104	43	91	41	71	34	43	95	52	55	117	129	61	49	40	55	63	83	45	55	71	34	74	96	53	51	43	48	36	48	71	42	72	47	94	79	60	65	94	110	28	82	57	74	28	39	66	44	55	55	48	55	77	64	40	172	43	41	53	99	71	45	122	63	167	128	53	72	48	64	57	48	53	54	97	72	48	51	45	42	66	76	40	69	34	76	67	41	31	72	109	57	62	40	40	62	42	112	62	82	59	46	45	34	38	24	50	54	39	41	99	38	91	41	60	24	48	40	49	68	134	57	62	56	84	97	147	98	63	103	58	47	98	62	39	40	96	56	99	33	31	44	55	94	16	60	55	34	62	57	43	60	99	56	29	80	74	19	33	70	55	89	90	37	23	105	69	40	45	57	64	47	40	60	35	50	41	33	39	62	65	24	28	30	35	36	37	28	56	34	28	50	35	59	76	23	59	59	39	49	41	141	62	62	67	57	42	86	28	33	34	60	91	31	37	7	100	39	53	28	43	55	24	33	36	56	35	33	41	34	41	73	53	45	33	21	27	60	64	27	95	119	72	31	40	41	48	40	56	27	41	30	44	52	40	28	60	105	59	34	22	23	78	35	52	41	64	68	36	95	72	50	30	33	28	60	67	41	29	22	42	57	56	149	32	21	30	36	19	24	68	47	42	32	50	30	37	25	28	21	19	80	39	18	45	90	43	47	40	29	49	80	26	19	21	43	32	48	49	49	23	40	19	18	45	42	19	123	62	26	8	40	16	40	21	35	108	25	26	70	20	51	12	26	36	42	34	47	71	38	40	41	41	31	23	45	28	43	60	19	44	23	78	36	40	28	46	22	28	26	34	18	45	16	33	87	69	29	17	26	29	22	36	37	34	40	26	33	33	45	25	48	46	45	32	32	21	27	9	13	29	29	50	28	79	39	52	24	40	85	33	30	19	15	14	20	18	23	14	24	9	71	41	59	25	37	42	32	32	36	13	29	21	40	23	17	76	16	20	19	37	36	46	31	12	52	54	44	24	38	19	72	34	42	17	28	22	77	18	36	34	31	12	33	11	44	11	27	47	69	21	38	33	32	29	54	32	42	23	26	19	42	16	30	41	22	60	26	25	18	41	47	66	33	21	28	27	10	24	15	33	45	20	27	43	23	41	39	49	37	45	54	28	15	19	25	10	58	15	20	21	25	24	39	33	37	28	24	15	47	38	25	33	58	42	51	17	19	42	22	50	30	14	18	36	3	43	18	31	14	13	20	27	23	94	17	7	44	27	19	18	45	35	14	37	12	9	31	15	10	23	38	28	27	24	24	36	26	19	33	23	49	6	12	13	7	18	29	28	19	34	26	20	26	48	58	53	27	11	39	23	16	21	26	24	20	23	20	10	35	32	9	61	66	20	33	37	23	29	14	11	34	21	14	9	34	21	24	24	20	5	23	18	27	15	23	44	36	13	30	11	86	16	26	5	17	18	13	34	9	21	40	24	18	35	28	10	33	21	27	13	29	8	28	45	76	24	15	48	27	16	55	13	31	2	8	13	21	24	23	27	21	32	90	6	6	14	23	18	21	11	6	16	15	38	36	36	29	25	39	29	26	12	40	23	16	20	10	24	9	17	13	24	10	6	28	9	24	12	23	18	20	30	13	14	23	6	15	26	25	4	17	24	23	36	17	7	8	37	14	16	19	39	16	8	24	15	13	15	17	34	21	26	17	14	5	99	9	21	16	24	12	21	23	16	23	33	20	41	21	12	21	26	24	20	19	12	4	11	31	9	48	22	8	5	11	28	5	22	11	26	9	24	38	15	26	16	24	32	7	21	13	80	9	19	12	25	19	12	24	36	9	7	4	2	33	22	6	9	11	7	13	21	9	21	18	21	22	41	10	34	26	20	34	14	9	3	22	12	10	3	20	12	19	22	13	19	23	7	8	17	4	40	60	24	44	25	29	2	9	25	25	14	7	13	6	12	18	13	13	3	4	32	21	15	23	12	3	14	6	37	33	9	12	5	36	19	34	17	19	24	17	3	1	9	10	18	25	17	16	9	18	9	15	12	5	16	5	9	23	14	22	14	39	4	6	2	6	8	7	25	5	16	14	25	9	2	15	13	16	22	11	20	5	3	7	13	15	8	17	24	1	4	14	32	3	10	22	10	7	7	21	18	20	18	8	42	4	13	17	4	1	11	2	9	29	11	23	19	12	1	29	19	0	5	15	10	21	11	0	9	12	6	8	5	16	4	3	3	5	6	14	16	31	6	8	23	10	10	12	4	20	17	22	5	10	9	6	14	31	12	11	8	3	10	16	17	4	11	2	10	8	3	23	5	6	4	14	0	36	3	8	23	2	7	5	3	11	5	10	1	29	2	5	7	16	7	18	6	7	17	27	8	9	10	11	15	0	12	0	8	5	7	8	9	8	10	4	4	6	11	10	5	6	7	7	22	15	12	9	6	14	26	3	0	9	4	9	10	13	12	10	1	11	13	3	3	1	10	13	5	3	12	4	2	4	7	17	1	18	4	4	5	2	10	3	3	11	14	2	7	3	3	6	3	4	7	1	2	0	9	3	14	15	0	16	14	10	5	8	0	0	5	2	12	4	19	2	38	3	11	2	0	9	4	6	3	6	2	2	10	1	3	8	12	7	2	2	22	4	6	5	4	0	1	1	3	3	4	2	14	7	4	3	11	3	2	13	3	4	6	0	5	5	1	10	10	14	17	9	1	9	4	6	3	0	2	1	1	7	4	2	1	12	12	6	1	8	2	1	5	3	2	0	0	2	6	3	2	1	3	1	3	9	3	4	5	2	0	1	2	1	4	4	16	0	3	1	0	11	10	1	2	1	8	3	16	1	4	2	3	5	9	0	0	7	6	4	0	1	4	1	1	5	0	2	0	0	2	0	1	3	2	4	2	2	5	2	0	0	3	1	1	5	0	2	1	1	8	0	3	1	1	0	0	2	1	1	0	1	1	3	4	0	1	0	1	1	0	0	0	0	4	3	0	3	0	2	0	0	0	2	0	4	0	0	0	2	0	0	0	0	1	0	0
ne0021	873	886	605	948	764	495	468	460	546	362	501	442	332	353	284	281	196	587	263	281	398	270	435	295	384	363	367	333	291	249	341	207	261	196	252	259	276	368	303	215	245	256	827	311	156	139	200	179	94	217	216	356	290	241	400	185	445	420	194	298	250	162	299	274	291	163	171	191	271	353	151	348	219	239	244	425	224	240	224	201	229	185	173	229	330	239	336	328	173	176	125	132	143	237	222	164	190	172	147	131	174	122	158	112	168	201	142	109	145	170	149	203	101	127	145	156	159	197	282	121	106	115	378	107	232	165	164	184	138	111	256	78	229	157	224	257	368	274	111	188	166	108	152	180	166	84	138	250	140	118	162	270	81	105	147	264	111	161	91	122	238	164	134	89	159	191	162	127	159	137	113	269	123	86	112	139	257	91	208	238	148	124	173	125	146	176	114	93	158	173	205	109	151	187	165	111	177	80	87	112	141	231	115	168	210	156	110	132	68	104	85	133	237	68	55	133	211	214	108	278	262	148	175	72	62	105	182	112	131	202	258	108	131	128	139	51	114	259	234	173	83	234	100	177	196	159	110	111	174	103	165	140	165	212	72	74	109	126	81	123	76	146	97	72	147	82	60	154	162	197	183	102	152	137	117	127	155	130	105	145	116	114	166	170	132	171	48	131	82	43	243	89	206	94	153	204	130	97	56	121	149	225	113	50	75	133	116	102	66	176	185	100	209	110	67	158	80	113	49	98	83	55	127	140	178	81	63	103	90	160	138	81	92	86	93	65	84	63	85	162	147	73	44	78	92	85	70	76	165	64	97	140	167	54	132	102	130	135	115	178	94	74	71	133	80	86	99	53	82	59	108	103	114	82	117	71	83	93	113	138	78	84	89	67	146	96	160	145	69	98	99	120	97	68	59	98	73	119	104	72	89	73	92	65	49	95	117	106	55	148	156	119	95	82	205	75	68	82	66	69	55	110	48	31	45	98	67	74	55	140	49	99	93	87	96	43	164	67	38	80	126	72	38	66	121	94	78	67	55	74	44	75	77	77	182	99	118	80	93	39	94	205	89	75	88	100	156	70	91	104	174	61	80	62	72	89	47	73	44	105	108	66	53	112	48	74	42	54	39	65	63	83	61	174	170	76	73	62	80	56	144	38	67	57	42	74	142	131	49	31	53	63	56	70	64	78	65	83	94	91	84	93	126	21	107	52	81	52	56	58	75	56	52	58	79	116	70	31	172	35	61	54	154	112	55	312	60	165	115	47	58	57	44	73	52	53	53	105	64	68	57	47	46	78	109	60	60	52	77	90	42	49	149	115	76	71	31	36	47	45	150	72	67	77	41	56	51	67	53	57	74	50	21	147	44	106	28	100	28	73	24	78	45	73	78	67	63	80	81	51	82	69	131	74	39	90	92	47	39	126	37	81	32	40	37	68	99	16	72	71	40	65	48	32	57	136	26	34	113	90	14	27	36	55	130	109	49	17	127	83	69	72	107	77	57	60	66	49	36	75	23	36	73	147	27	36	30	32	26	53	49	66	25	57	53	38	74	79	25	47	77	68	65	91	121	42	55	42	82	56	90	50	50	54	47	88	28	40	25	57	45	62	49	58	45	21	42	40	56	34	51	57	63	35	75	70	47	23	31	17	55	50	23	121	90	56	36	45	43	49	32	50	18	45	39	57	68	43	49	208	85	96	31	23	24	71	78	62	51	53	79	41	111	71	49	51	35	33	48	77	44	44	31	34	82	57	240	39	38	26	56	43	20	60	43	44	32	83	22	45	36	48	25	20	77	43	39	46	89	36	27	37	48	85	41	18	19	27	30	33	56	72	67	22	42	36	44	22	42	26	111	69	30	12	31	12	46	31	51	112	14	30	54	37	52	30	26	14	64	43	111	73	40	32	56	50	37	35	61	20	45	72	33	28	22	84	68	62	46	33	58	43	31	29	46	41	44	48	104	43	50	39	18	27	21	48	74	48	38	38	29	31	32	26	55	28	21	42	42	21	38	9	19	14	40	46	37	108	32	72	40	34	77	30	42	34	16	13	28	15	27	20	33	19	73	53	23	17	86	18	41	47	38	18	55	6	36	24	18	81	15	20	61	48	31	56	38	22	47	31	45	43	24	28	74	42	34	13	20	25	51	13	63	24	39	29	32	18	53	7	21	54	64	41	70	50	38	45	51	45	29	23	41	21	30	32	42	32	26	23	29	25	34	45	48	66	43	32	42	39	4	34	33	28	51	24	41	39	31	38	38	42	56	46	29	31	24	31	38	11	88	18	27	16	31	32	52	26	37	36	23	16	67	58	12	36	57	50	67	19	12	46	26	55	40	16	9	64	12	28	21	27	13	17	16	25	22	104	30	16	43	16	27	4	31	29	5	43	11	16	154	9	2	22	44	51	40	34	23	42	43	22	49	22	65	7	11	25	9	35	15	27	61	60	41	25	24	38	31	54	48	14	54	25	23	15	26	12	16	36	47	7	32	27	12	56	68	33	59	22	48	33	20	10	53	25	5	15	30	35	26	19	27	18	25	23	36	21	22	44	24	29	45	14	89	16	16	8	13	11	13	35	11	13	40	27	20	73	33	7	52	16	17	11	31	24	33	105	59	25	9	41	26	19	35	15	22	9	18	14	20	14	33	41	26	35	95	8	12	14	13	18	9	13	13	13	20	43	46	43	17	16	42	24	30	13	35	18	7	16	5	18	21	28	12	15	15	8	32	10	30	9	31	11	39	25	25	16	35	8	9	32	45	5	14	16	14	45	13	11	9	16	19	8	36	52	16	8	52	16	15	18	17	40	35	27	15	52	16	87	17	23	9	17	5	36	25	17	55	26	7	69	21	6	16	17	21	9	32	36	9	7	34	7	14	31	13	13	9	18	6	33	21	37	22	23	36	18	32	12	21	83	18	17	15	75	17	25	7	19	11	10	26	20	9	12	9	7	20	43	13	13	20	16	28	9	11	21	9	25	17	18	20	65	26	23	35	21	25	14	24	5	20	5	47	9	18	22	12	37	38	10	16	37	12	27	35	13	10	19	22	9	23	29	18	12	18	15	9	13	25	18	2	19	11	31	41	12	14	30	3	11	7	35	17	14	15	10	33	42	17	18	8	38	28	13	5	3	7	8	10	4	9	9	22	3	12	7	9	11	10	19	34	23	10	22	33	6	6	3	4	6	14	66	11	22	7	25	17	4	21	17	12	32	16	16	5	5	13	22	5	14	18	31	9	4	1	15	6	19	30	1	13	6	59	22	21	27	7	38	17	13	10	12	2	9	8	19	50	31	14	20	13	1	36	15	6	7	4	18	68	9	19	20	5	3	4	17	15	9	8	9	6	12	6	11	18	2	17	19	17	27	17	12	11	40	15	7	7	19	26	15	31	19	20	7	6	6	17	10	13	23	3	7	30	8	28	22	9	11	18	5	14	13	8	16	14	1	3	1	8	8	5	2	29	2	11	2	5	12	11	5	5	15	22	25	11	8	14	8	2	17	9	8	15	13	7	5	1	25	6	18	8	4	53	3	8	9	11	22	12	9	5	11	13	56	4	4	13	2	12	3	9	10	14	8	10	30	7	1	3	11	11	10	2	18	8	1	12	2	18	9	24	6	59	2	3	2	3	8	12	12	2	5	1	3	1	6	8	13	3	5	0	10	5	15	18	2	19	20	7	14	13	4	2	2	2	6	11	26	11	25	12	20	1	4	7	5	3	4	7	3	8	13	1	6	11	13	0	1	5	10	9	3	6	6	7	3	2	3	0	16	4	8	3	6	4	1	5	2	19	19	5	11	2	14	1	4	12	0	12	12	3	1	4	5	30	1	2	3	0	0	14	7	4	2	32	5	3	3	18	2	1	14	5	5	3	0	3	4	2	10	0	0	3	2	9	18	1	4	9	2	2	4	3	4	5	18	1	4	9	0	0	9	9	13	18	5	1	2	6	1	2	0	1	16	0	10	9	8	4	2	0	3	0	0	4	8	1	5	0	7	4	18	1	2	6	0	10	2	4	1	3	2	0	1	7	1	19	1	6	0	0	0	6	0	0	2	5	2	0	2	1	1	3	4	0	0	0	2	3	0	0	3	0	1	0	0	1	1	1	0	0	1	0	0	3	0	0	0	2	0	0	0	0	1	0	0
ne0022	877	1005	634	942	578	545	448	527	486	411	467	448	403	377	324	317	277	544	292	339	373	330	396	300	352	376	352	335	341	304	322	245	286	226	237	308	235	322	296	149	238	243	730	283	191	185	202	188	153	185	274	332	242	249	446	248	332	398	223	213	245	193	287	280	247	184	214	219	252	359	149	266	285	225	205	404	238	247	234	184	197	219	182	237	304	198	273	289	163	198	139	191	186	158	240	181	194	157	161	143	230	121	161	155	209	207	174	144	203	175	152	198	152	162	177	168	192	202	230	167	144	150	342	123	226	191	144	186	158	172	221	122	210	133	223	205	349	179	120	210	150	140	169	193	165	122	154	211	180	149	147	181	124	105	145	259	160	141	126	134	219	150	149	147	166	183	133	134	182	139	107	246	104	126	121	149	289	117	219	181	266	121	180	134	137	202	135	114	140	159	178	122	181	165	147	128	171	115	124	118	122	249	188	154	158	153	114	143	104	95	124	148	208	97	98	145	184	216	131	227	241	96	159	92	97	87	177	111	114	189	169	103	143	120	168	68	126	228	215	155	122	186	122	188	181	179	173	107	169	114	144	138	139	194	84	97	134	134	93	140	111	142	112	74	155	78	74	161	149	152	122	98	152	119	121	131	163	122	131	115	135	120	122	159	121	145	62	174	113	72	242	92	201	104	81	173	128	96	69	122	117	217	118	89	70	127	145	124	63	184	168	100	188	99	83	132	92	149	63	113	113	101	93	128	179	90	71	93	99	154	155	99	123	96	119	68	86	81	99	156	90	73	70	85	93	94	70	110	100	88	102	157	165	104	107	121	206	138	123	122	115	74	73	78	101	70	116	85	66	69	120	107	121	118	117	78	83	82	111	131	140	83	95	65	107	93	158	135	72	101	101	126	104	62	72	87	110	105	98	69	106	57	136	67	91	89	79	80	75	150	128	120	78	79	158	71	78	97	83	101	40	88	60	33	68	34	74	81	94	109	45	106	61	106	101	39	106	52	40	71	129	79	72	50	65	93	73	75	82	64	77	84	73	60	146	90	98	75	93	59	71	192	91	50	60	114	187	79	66	134	176	69	60	60	81	80	57	51	56	77	86	75	48	106	56	50	43	40	37	80	58	93	61	107	144	82	80	62	77	64	78	54	67	66	45	94	105	83	49	44	56	52	59	99	77	78	54	85	91	70	78	73	119	30	79	45	64	44	53	70	63	95	40	62	63	119	91	40	145	64	52	49	132	95	65	218	62	126	132	50	58	71	67	71	66	63	43	77	66	61	46	58	37	68	102	51	40	39	101	86	65	47	110	101	58	60	32	31	48	45	127	52	63	88	58	32	51	109	47	76	59	70	20	116	52	81	29	74	44	90	37	65	56	77	59	82	76	101	84	60	87	80	114	74	48	95	56	43	42	108	37	78	43	69	48	50	55	21	69	68	60	46	47	50	41	115	39	35	72	63	30	23	31	41	94	112	37	23	101	73	110	54	101	89	49	48	79	39	58	69	40	48	78	81	49	39	52	37	21	69	80	63	61	43	53	32	71	108	19	72	77	56	54	80	158	60	46	79	23	63	78	47	35	49	49	93	23	76	20	66	35	62	44	49	49	33	64	32	80	48	28	72	53	37	58	64	52	50	29	32	52	37	29	103	102	73	41	49	40	59	37	51	15	28	48	53	46	60	54	140	83	48	44	21	32	54	83	42	34	53	69	36	65	76	49	50	50	35	52	61	57	44	22	51	89	49	178	43	45	24	57	24	36	69	41	54	31	57	19	53	30	54	26	33	65	41	59	51	72	37	59	41	64	62	52	27	33	52	36	23	48	65	45	37	47	29	51	32	41	27	124	63	49	16	47	18	25	32	30	128	18	26	67	31	73	23	42	27	63	37	63	71	30	40	52	33	54	53	57	32	36	83	32	30	33	68	93	45	28	36	72	32	35	27	36	43	23	38	102	38	51	29	37	32	23	36	49	47	37	42	25	59	25	34	34	24	30	39	41	43	32	22	34	17	39	44	39	94	31	67	44	36	76	30	47	21	25	17	19	21	23	12	49	26	54	42	21	15	31	29	32	43	44	13	23	13	37	28	22	80	21	16	99	60	31	54	19	32	45	43	37	61	39	28	62	32	26	18	39	23	38	13	44	45	37	15	43	14	32	18	22	43	50	42	37	49	24	27	37	23	33	43	29	20	36	20	57	52	27	52	39	38	29	59	46	88	32	33	44	29	26	45	26	38	37	39	36	20	16	42	28	47	27	29	19	26	15	40	26	15	32	23	36	34	39	36	55	28	27	50	25	28	41	35	11	31	33	45	62	31	29	35	38	57	28	21	2	21	15	47	16	31	15	18	32	26	15	108	26	13	44	25	33	4	40	17	7	66	23	19	106	18	3	16	29	49	18	24	24	41	49	20	39	23	69	15	19	40	17	57	21	33	11	38	31	28	20	56	32	65	25	9	63	30	35	40	29	18	25	28	28	11	21	34	11	56	54	29	29	24	32	43	13	17	53	37	10	29	26	43	52	16	20	25	19	36	40	15	47	27	29	37	73	32	100	17	16	9	30	24	19	34	6	18	33	23	16	48	14	16	36	10	34	21	29	23	33	40	67	28	23	42	35	18	44	39	28	3	19	13	30	17	34	19	51	48	110	8	15	29	18	18	18	12	18	33	14	48	62	20	20	17	46	15	24	29	25	21	19	17	4	19	17	25	20	16	13	6	20	8	33	15	36	11	19	20	24	20	20	14	21	35	25	24	13	23	28	32	21	13	8	41	18	11	19	54	23	11	37	16	25	23	24	35	24	33	14	31	19	12	27	38	23	26	16	29	21	22	25	19	15	35	27	7	28	28	21	16	29	18	18	10	41	11	25	36	21	10	10	24	2	28	16	30	13	20	48	21	28	14	23	42	21	24	7	13	8	32	6	22	24	5	20	26	5	24	10	8	25	33	9	8	27	20	29	16	2	35	13	24	15	23	27	7	19	17	35	27	24	10	25	15	15	4	47	11	29	23	23	21	34	23	13	48	7	40	19	16	17	18	20	5	8	32	15	19	13	27	7	19	32	12	10	16	14	15	49	35	28	15	10	9	10	20	25	10	11	24	28	24	26	12	13	27	18	13	4	15	26	11	29	7	14	12	16	3	8	13	13	12	15	23	15	11	7	22	19	6	9	5	10	10	15	36	5	26	7	25	10	7	29	27	13	18	8	8	7	15	11	41	9	6	25	18	12	6	9	17	7	20	28	8	14	25	22	23	17	13	5	39	31	14	10	8	5	5	5	13	106	14	38	18	26	2	24	21	3	8	10	15	31	11	8	5	8	10	3	19	15	8	6	7	4	17	16	12	12	7	22	28	6	19	43	3	11	26	11	4	5	16	4	9	37	18	12	4	8	5	12	6	7	9	2	6	3	8	31	14	7	6	8	4	9	18	7	15	6	11	6	3	9	9	5	7	15	5	13	3	16	11	25	14	11	7	25	35	21	5	17	18	4	14	25	13	10	16	17	2	4	5	2	6	14	4	31	3	4	14	9	9	12	11	8	7	4	5	2	5	17	9	38	5	6	12	7	6	8	12	6	1	5	7	14	7	2	7	6	5	5	6	16	2	12	7	15	2	3	6	2	4	12	14	4	5	6	4	3	5	5	12	2	5	0	11	4	22	22	2	5	20	4	4	13	1	2	2	4	6	4	27	8	22	11	13	3	7	12	3	5	3	8	3	11	16	3	5	6	22	4	2	3	1	7	4	8	8	4	8	5	6	3	5	4	9	1	4	1	8	7	2	6	39	9	11	3	1	2	1	16	5	3	4	6	0	7	3	11	5	0	1	1	2	4	4	3	1	7	6	0	3	18	1	6	8	6	5	0	0	4	7	4	8	1	2	0	0	4	2	9	5	5	3	2	17	3	3	3	24	2	4	6	0	1	9	7	11	5	6	3	3	2	4	3	2	2	4	1	3	2	1	1	1	2	2	2	2	1	2	0	3	0	5	0	3	1	4	9	1	2	2	8	2	2	4	0	3	4	3	28	0	1	4	0	1	0	0	0	0	2	2	0	0	2	1	0	3	0	1	1	1	7	0	0	2	0	0	1	0	0	0	0	0	0	0	0	0	2	0	0	0	0	0	0	0	0	0	0	0
ne0023	977	1348	1016	330	507	468	444	204	263	259	307	333	412	272	597	221	405	224	521	457	261	214	474	151	274	216	334	422	362	544	384	246	195	233	506	264	341	281	256	358	209	282	242	144	166	277	168	202	633	216	55	191	135	225	114	430	148	186	252	118	223	211	230	205	191	170	64	168	312	227	412	291	359	257	193	199	132	233	180	179	206	234	46	204	379	225	338	206	198	245	194	349	133	121	314	172	109	168	118	90	127	159	141	120	218	113	153	73	266	120	143	177	199	46	61	225	46	352	184	35	102	103	192	147	209	269	133	88	43	100	126	150	134	180	230	239	80	227	36	104	84	290	78	120	246	149	167	203	123	124	198	175	110	155	155	248	278	85	42	89	51	147	151	132	327	223	227	259	192	38	202	124	192	224	25	334	161	45	148	241	81	345	109	106	89	114	122	327	155	136	117	45	90	86	125	46	171	72	101	75	137	124	111	144	156	91	143	96	324	111	28	90	102	99	294	181	79	350	272	171	185	67	274	96	216	73	169	129	128	106	220	140	166	156	72	224	158	242	128	100	104	117	120	452	126	148	159	44	69	143	93	69	202	84	143	25	139	184	162	135	60	111	104	49	57	213	119	174	79	285	175	222	76	133	44	150	111	183	96	163	146	118	173	200	48	340	237	124	261	164	145	45	223	101	174	127	36	98	126	125	259	147	201	45	102	139	88	170	46	169	225	192	153	50	169	68	101	226	34	76	86	255	79	210	102	278	128	54	85	63	52	78	53	32	65	86	117	235	118	56	224	87	109	106	118	166	169	148	74	65	85	131	191	98	154	37	158	78	116	148	90	279	39	77	166	27	42	85	53	96	85	44	74	19	77	220	92	125	72	105	67	65	132	67	201	124	31	144	92	58	65	115	34	169	47	80	95	63	202	74	157	168	70	42	148	42	90	253	77	131	50	60	124	57	46	77	52	125	64	50	139	122	65	45	280	31	67	66	104	70	14	87	39	39	47	85	41	50	133	74	27	134	217	91	103	105	80	35	181	58	56	54	46	65	101	98	147	78	64	206	25	58	61	79	121	29	103	87	59	104	72	23	130	113	157	79	125	21	66	92	89	57	46	40	40	133	26	71	52	172	31	142	55	124	129	76	32	64	21	203	136	38	53	24	97	33	51	227	116	38	35	43	62	47	68	84	68	59	52	14	86	72	142	234	92	98	29	92	98	43	84	211	26	22	119	90	51	136	59	38	90	43	100	17	89	46	193	69	173	48	83	23	57	20	81	95	52	47	68	65	31	103	49	24	18	41	99	29	52	58	8	31	25	61	77	68	21	11	37	31	102	39	36	34	54	29	25	135	126	30	29	30	28	153	26	107	15	41	147	80	36	52	88	44	62	140	86	12	34	107	12	24	163	53	81	36	24	62	63	104	204	82	25	191	57	58	44	29	36	51	15	37	76	113	92	112	45	74	44	16	57	236	23	66	42	29	32	170	159	38	83	13	51	66	58	83	24	12	43	22	38	34	38	108	25	50	62	57	23	33	40	52	40	15	13	16	20	39	20	59	41	19	82	87	68	15	51	33	11	25	57	75	56	16	57	18	113	71	36	145	17	134	50	98	19	24	29	70	68	140	37	48	29	28	78	11	23	68	29	140	27	88	48	87	40	94	27	37	68	57	133	158	113	35	33	56	82	23	25	68	53	34	8	34	52	67	17	36	40	15	24	70	17	28	33	26	30	53	117	51	144	25	24	66	12	129	53	150	44	126	24	37	77	35	22	62	15	59	15	24	30	54	36	12	8	5	46	17	15	40	129	75	17	34	22	41	59	34	61	39	20	22	22	21	13	32	22	12	20	60	60	62	18	10	11	13	21	21	24	55	4	18	18	8	20	24	20	139	49	64	11	20	27	86	33	63	85	43	70	19	47	43	5	22	64	17	44	51	39	105	24	57	13	27	50	40	22	30	90	11	33	12	69	37	37	9	35	48	29	56	22	24	107	26	49	41	18	20	29	18	130	10	55	61	10	55	21	93	32	15	48	33	53	51	30	20	39	21	30	19	53	70	67	3	151	10	8	96	10	34	34	17	22	14	51	20	21	16	64	48	76	34	15	24	49	15	22	139	8	91	74	14	48	32	22	70	11	77	36	28	51	3	32	14	20	15	100	20	27	16	19	48	77	44	16	41	32	102	59	45	38	19	21	27	48	32	24	13	52	5	15	32	25	18	25	14	4	22	31	72	8	7	30	47	34	43	4	5	20	115	41	28	37	17	28	35	31	10	17	16	11	27	20	36	20	10	14	58	18	7	8	27	5	26	1	29	25	10	22	17	41	11	48	49	49	10	1	11	24	12	20	39	17	17	79	32	14	43	35	8	31	2	21	18	43	37	15	45	48	51	5	105	14	44	5	14	5	5	14	48	11	36	6	22	3	6	67	13	31	4	15	11	30	27	22	19	9	49	68	25	27	37	49	6	20	40	17	6	9	42	11	72	27	42	4	12	76	29	7	47	22	13	43	35	21	11	112	11	29	4	40	63	45	39	51	40	57	26	24	16	128	5	50	9	41	30	9	80	11	63	4	32	33	12	12	10	20	36	17	14	44	23	15	18	2	26	36	107	38	25	20	14	43	81	8	11	36	26	27	3	7	15	25	12	22	6	77	14	12	35	21	4	19	18	24	29	13	10	40	19	4	11	25	90	12	14	45	18	32	36	5	6	20	7	18	7	9	6	39	9	13	52	25	54	14	11	13	67	54	50	41	8	47	13	14	7	9	39	1	46	12	20	3	5	7	14	37	21	11	10	16	37	55	5	9	22	11	5	19	24	5	43	16	12	7	36	20	30	33	47	44	12	18	4	13	15	31	5	11	25	10	8	61	47	3	21	17	5	4	6	7	28	15	17	75	139	9	14	17	15	25	18	18	14	4	28	10	23	13	23	58	14	16	58	27	5	6	7	16	22	10	16	18	11	9	11	4	13	15	16	105	10	35	17	30	11	37	18	4	12	38	12	8	3	67	8	35	6	14	7	54	6	21	6	7	11	5	68	43	41	26	56	1	3	7	34	19	3	11	85	0	6	10	7	4	7	19	14	12	3	11	7	8	33	9	7	6	13	7	11	12	6	10	11	25	26	5	10	11	20	26	23	11	29	39	6	14	3	7	9	50	15	15	10	3	9	39	5	7	17	22	16	3	24	8	1	38	22	21	4	18	14	5	2	13	43	15	5	14	9	11	29	29	8	2	28	12	17	3	8	1	6	9	5	16	3	26	10	31	9	21	3	30	12	61	11	7	24	6	8	5	34	7	29	12	7	6	34	42	3	27	2	1	5	10	15	3	11	8	35	2	6	19	11	6	12	3	26	16	71	6	4	30	8	2	4	7	28	3	6	6	0	27	19	12	16	12	0	16	12	6	4	2	9	12	15	12	19	9	11	11	6	2	14	14	11	0	21	32	3	8	12	4	4	33	43	2	5	5	11	5	6	4	8	26	15	20	25	6	8	4	4	2	3	8	3	6	14	60	10	0	4	1	2	12	3	2	12	10	17	4	7	11	15	23	16	14	16	5	5	14	28	12	2	46	3	12	3	3	0	11	12	24	5	1	2	2	1	18	0	18	3	7	3	8	4	0	11	8	2	13	14	2	48	18	7	9	3	12	12	2	23	2	1	1	31	6	13	4	2	2	4	0	0	2	2	8	18	0	6	8	9	16	3	7	22	27	4	1	4	3	6	0	1	2	1	5	28	4	56	6	6	4	2	1	1	9	0	5	0	0	1	3	0	4	1	0	19	3	7	6	6	17	6	3	3	13	4	30	6	19	1	1	0	2	3	1	1	0	14	1	2	0	7	1	23	5	7	4	16	4	4	7	4	3	2	1	7	32	1	6	11	20	0	2	2	4	1	2	6	1	1	2	0	1	10	1	2	6	4	6	0	6	5	6	1	3	7	0	7	0	1	5	1	4	18	7	0	11	0	4	4	11	0	0	2	3	1	1	1	3	0	6	7	4	4	5	2	14	24	0	0	1	0	0	3	1	1	11	2	0	4	1	2	0	0	0	1	2	0	0	0	4	0	2	5	0	6	1	2	1	0	2	18	0	2	1	0	0	0	0	0	1	5	0	0	1	0	1	1	1	0	0	0	0	0	0	0
ne0024	5127	4496	2867	2480	2567	2665	2482	2052	1915	2234	1960	2185	2004	1969	1325	2162	2053	1528	1860	1760	1451	1741	1615	1950	1483	1348	1657	1427	1470	1568	1385	1613	1481	1478	1271	1282	1499	1178	1160	912	1258	1334	899	1395	1324	1342	1518	1066	1361	1380	1285	1293	1137	876	1206	1361	987	993	1030	1152	1208	1239	901	1068	1220	999	1332	1172	1090	993	1149	1080	1116	779	799	1050	971	921	910	935	1162	894	1319	718	906	1136	706	1077	1130	932	1124	851	1197	676	858	1046	1027	1149	914	927	804	885	932	1130	927	986	882	1099	810	883	813	836	1245	1045	1089	939	1079	856	649	952	938	1107	831	896	829	846	733	743	1038	1025	1004	825	723	814	716	732	688	655	1013	768	865	816	807	712	649	715	745	558	745	557	911	690	719	784	847	675	736	793	929	721	787	612	872	593	918	579	653	628	575	941	733	619	903	635	909	588	655	931	698	553	545	732	677	615	678	437	677	594	517	502	708	561	537	912	726	793	648	912	525	543	608	605	505	698	542	645	697	572	824	554	903	602	529	641	790	654	605	499	608	611	542	580	439	531	506	754	560	602	562	522	490	570	450	633	605	541	484	546	574	633	610	676	858	606	454	581	551	616	603	526	667	497	675	505	823	822	613	560	505	402	720	564	509	459	563	543	484	438	496	359	623	533	581	536	573	521	467	481	518	494	469	481	548	343	549	310	471	505	557	573	501	571	524	415	519	435	816	501	432	530	376	338	476	432	497	455	483	525	413	416	485	579	501	561	489	396	471	443	666	415	556	420	484	402	468	542	438	512	491	549	312	491	414	616	498	416	567	327	512	420	439	494	494	388	567	538	441	382	388	454	492	439	387	430	469	385	362	437	431	369	442	470	600	387	370	441	367	464	388	445	514	509	435	358	431	361	356	272	496	432	323	421	431	465	497	374	393	339	377	394	326	448	418	360	518	419	319	339	261	457	315	260	400	416	427	347	463	463	360	373	382	396	405	385	360	328	372	453	385	424	447	273	361	393	481	216	329	420	358	286	482	369	355	311	370	408	448	352	391	386	351	326	349	268	321	343	528	305	400	333	412	365	426	341	276	322	438	339	271	493	439	372	225	421	284	318	296	362	268	305	293	288	269	440	437	308	329	295	253	269	242	258	404	296	353	296	414	401	508	381	291	237	351	320	322	390	370	308	326	498	321	449	257	388	505	370	233	245	324	416	323	308	347	363	305	390	322	299	340	410	323	288	303	406	274	342	276	290	268	394	288	332	342	291	331	319	309	424	297	293	275	312	306	379	342	191	345	198	267	346	326	206	341	347	240	257	279	275	284	309	331	384	275	421	303	296	278	300	205	237	347	236	212	295	280	450	340	328	371	275	287	316	386	243	296	398	368	281	173	285	253	263	322	255	374	304	294	219	371	221	285	244	237	217	300	343	243	218	248	247	240	275	256	203	235	230	280	297	285	243	245	262	242	213	309	303	207	218	239	223	223	220	302	229	201	217	233	356	263	229	218	228	264	257	234	218	257	222	228	216	251	310	250	248	352	241	186	362	296	241	207	306	258	296	252	268	242	335	297	209	584	218	187	341	220	227	227	201	373	241	251	188	200	234	162	240	247	153	142	238	226	216	235	254	214	238	285	203	256	181	316	226	173	199	181	240	325	268	243	189	217	191	258	233	210	205	237	177	239	165	187	169	190	181	216	206	183	240	233	152	270	227	236	388	163	169	170	268	145	159	214	139	271	187	243	181	114	223	237	253	145	223	162	138	182	158	260	162	138	169	170	180	174	203	191	175	149	249	153	221	152	162	332	159	301	159	209	213	182	253	273	120	212	225	159	266	154	206	153	262	168	190	118	174	144	175	150	244	168	162	213	142	129	183	161	201	168	247	180	167	122	131	214	194	216	257	181	217	203	103	235	195	145	271	170	154	182	181	166	183	251	129	165	254	195	189	132	163	164	227	83	146	303	155	174	122	159	195	146	137	173	201	155	190	165	139	178	172	145	150	194	194	159	159	180	133	118	110	180	141	134	180	244	233	229	218	136	115	187	131	202	160	177	209	120	218	265	152	140	187	121	139	140	205	153	274	149	159	173	193	186	152	125	132	99	150	178	125	127	142	168	152	241	234	160	144	130	140	176	135	152	178	123	190	170	136	162	163	123	126	89	132	103	116	140	170	109	123	128	158	80	195	186	180	215	183	135	172	131	146	100	144	100	111	94	169	122	184	119	122	175	121	109	180	132	137	138	148	137	155	130	124	131	141	127	94	200	118	143	206	151	108	87	156	94	136	98	153	146	108	173	138	96	151	133	110	123	156	178	113	131	151	114	143	150	130	152	125	90	159	143	148	105	103	257	132	117	102	112	127	129	113	123	134	84	80	221	141	159	157	151	108	155	115	112	71	141	49	152	124	146	143	150	189	131	97	173	104	138	149	100	85	100	150	207	95	151	130	198	137	107	181	135	86	104	99	167	135	96	145	95	118	150	80	126	112	118	112	87	120	111	126	101	157	93	107	97	141	147	80	100	104	124	118	126	122	86	154	198	112	90	157	139	101	115	106	78	169	72	120	113	92	79	117	76	107	75	98	123	99	106	79	67	130	61	79	133	112	124	120	89	106	115	109	97	161	121	94	109	99	108	52	115	134	108	133	84	67	79	95	89	119	111	68	137	70	81	115	83	119	155	160	52	108	86	74	51	44	93	86	104	81	123	89	115	60	76	94	97	105	143	71	74	82	100	95	179	117	102	81	69	97	87	128	112	83	83	130	91	108	103	72	90	154	65	90	102	69	52	140	86	102	83	79	99	98	76	48	85	89	90	151	118	198	90	93	85	85	47	90	80	76	73	86	80	83	54	110	99	76	97	77	49	95	93	76	54	89	65	58	88	63	102	117	81	100	61	111	36	61	84	56	47	92	72	95	58	79	71	114	121	96	97	66	103	97	67	74	82	74	63	72	68	109	134	73	64	63	92	79	111	137	55	73	76	68	98	102	63	96	44	63	104	109	34	93	78	109	70	103	168	68	52	36	69	65	65	39	51	64	65	57	81	68	40	60	73	87	74	99	60	85	62	119	113	56	63	79	55	76	75	104	57	82	95	80	87	58	77	71	94	62	90	92	65	68	38	69	63	55	77	89	66	56	86	36	120	83	42	49	77	65	83	43	92	99	122	53	61	62	38	85	88	69	70	59	55	89	60	96	125	42	55	89	111	128	36	60	33	67	70	59	58	67	49	81	30	54	72	87	74	97	83	70	69	56	50	63	53	88	84	64	56	60	47	59	29	51	60	58	32	67	57	71	56	58	53	47	100	47	98	69	54	70	55	65	42	43	41	47	75	51	49	45	58	54	87	22	48	80	37	46	62	60	50	49	44	78	40	51	27	55	47	52	63	99	36	71	33	30	45	49	67	43	43	52	55	26	49	42	72	72	37	52	101	47	39	129	54	36	28	37	28	48	40	39	48	61	58	47	79	65	37	63	37	25	30	21	69	32	44	35	38	44	28	32	59	51	60	34	35	52	39	57	42	36	32	47	60	31	56	50	78	37	38	41	24	52	84	41	48	92	50	36	24	32	41	34	24	36	40	50	56	26	31	21	30	31	38	38	41	38	28	33	41	38	46	28	24	54	38	34	24	39	25	27	35	50	26	46	58	30	52	45	20	41	37	20	20	38	32	45	20	27	24	63	33	31	19	33	21	29	20	22	29	45	14	43	19	28	35	25	18	26	25	28	30	26	25	27	27	22	14	17	42	18	35	46	24	18	17	26	24	35	32	40	21	20	53	42	17	30	32	19	29	17	11	20	27	37	33	20	11	21	31	33	27	25	31	32	27	34	18	28	23	45	26	26	22	33	78	27	13	39	18	23	7	22	18	6	19	20	11	27	16	41	26	30	26	15	16	16	36	38	15	19	25	20	23	21	18	13	20	6	28	29	28	18	14	13	10	26	21	9	15	15	11	17	10	10	8	10	24	19	10	20	9	20	17	4	33	14	8	15	24	10	15	7	33	13	34	5	2	18	5	18	19	12	21	18	10	6	19	13	12	27	7	11	5	21	5	5	10	6	8	12	16	13	5	18	7	11	9	9	3	6	5	15	6	10	5	8	8	17	10	3	6	2	4	0	1	16	4	3	7	6	6	3	1	2	0	1	1	3	0	1	5	10	2	4	12	0	5	5	1	3	0	0
ne0026	1430	1966	1118	971	898	964	758	838	566	917	544	669	647	627	839	717	635	561	584	585	701	615	568	337	499	426	526	548	440	660	411	407	403	420	466	539	426	438	399	606	473	402	238	313	252	399	402	467	444	304	437	384	381	364	256	474	298	424	359	337	371	271	263	394	341	357	343	281	430	318	411	436	430	306	241	473	268	354	324	299	313	367	255	301	362	272	288	371	417	310	272	286	264	330	216	314	274	219	283	277	278	245	288	312	248	265	235	260	283	177	255	272	239	270	259	377	316	283	197	319	285	253	377	367	325	249	217	241	268	298	271	178	239	225	284	156	261	201	224	187	217	250	259	194	175	377	222	171	207	260	227	168	287	207	203	173	245	187	227	271	230	217	218	326	234	217	227	267	199	158	271	198	190	366	217	292	275	196	175	161	267	219	176	242	209	279	214	255	171	227	252	252	117	204	136	154	183	214	247	195	185	189	132	200	234	196	253	178	203	196	207	223	218	157	420	278	189	230	270	225	317	189	226	183	299	230	236	225	165	195	193	175	188	162	181	201	221	277	291	153	229	274	226	206	117	228	212	125	233	179	193	138	183	143	163	178	257	220	148	180	150	221	178	183	99	176	133	217	145	181	162	136	172	151	167	129	235	151	234	159	201	199	189	92	158	89	238	171	119	142	208	182	205	184	171	186	121	151	146	153	215	268	151	192	156	162	126	231	172	140	176	205	192	137	213	96	180	122	116	144	208	204	166	169	124	157	146	174	126	136	121	179	141	89	169	129	151	256	168	164	143	161	197	228	180	129	137	186	102	174	135	175	163	151	135	196	129	116	95	134	115	112	68	139	144	114	129	208	178	131	172	97	178	104	121	76	148	203	150	162	182	142	108	159	207	186	88	180	150	117	234	111	108	97	105	105	113	146	96	113	189	249	154	171	156	92	105	224	164	172	178	115	97	141	113	108	108	124	95	138	162	88	198	192	88	172	101	113	95	113	67	100	91	158	120	137	120	83	108	92	172	76	81	120	125	111	102	108	111	100	128	91	127	91	178	108	136	147	66	82	94	77	102	119	92	115	90	59	113	70	128	131	139	85	103	107	158	51	93	51	123	66	108	96	77	72	121	112	96	157	148	111	58	105	118	115	153	105	76	78	104	136	116	60	55	74	95	83	144	117	85	158	78	108	108	117	97	73	87	69	84	111	163	172	139	75	99	101	213	144	115	160	110	94	112	118	121	108	171	114	102	53	111	115	52	37	78	175	149	105	121	147	100	93	162	210	93	127	67	79	70	101	81	58	104	92	81	112	63	46	88	106	55	110	86	61	55	72	145	72	118	95	94	80	141	66	89	105	98	128	88	124	74	107	60	59	80	115	43	116	102	77	111	80	85	63	71	171	106	55	151	102	121	68	139	71	82	67	66	135	58	109	92	195	110	74	107	118	92	86	119	65	86	73	72	131	70	112	44	58	62	54	122	78	87	81	76	94	107	96	107	99	115	93	54	91	99	24	107	45	111	65	61	36	92	66	57	122	59	97	107	67	67	34	80	73	65	123	48	145	76	76	91	53	134	74	71	117	146	50	97	104	117	56	48	109	81	106	64	65	50	92	36	91	94	80	67	65	44	109	67	109	119	59	97	71	121	68	63	64	79	80	56	106	128	80	65	80	67	57	100	57	64	92	61	32	37	47	67	58	97	47	96	101	67	79	28	41	57	83	71	68	49	56	77	50	71	61	31	30	49	83	123	81	69	34	17	97	44	94	39	69	45	80	108	71	72	60	67	52	108	72	79	42	65	53	47	104	62	65	60	56	98	87	141	83	65	81	53	58	65	82	31	41	101	40	33	91	28	71	88	79	40	105	78	69	41	86	45	65	83	62	72	31	33	62	52	53	72	46	36	56	62	53	57	47	58	49	29	32	67	55	20	87	44	39	75	38	77	83	64	77	51	53	40	57	93	61	87	116	78	41	69	85	76	47	49	58	45	65	60	66	61	71	53	77	74	56	44	66	59	53	34	51	112	66	50	89	45	48	47	39	47	76	66	28	55	57	50	58	58	59	81	61	62	47	63	48	14	61	62	43	59	27	40	57	53	82	59	62	83	58	17	38	56	65	54	74	56	34	27	47	61	34	61	73	36	78	32	60	32	43	39	41	112	45	58	53	31	32	58	28	29	67	37	56	14	44	53	23	61	30	65	47	37	49	60	46	34	88	45	37	82	84	70	59	27	44	58	42	94	30	144	45	25	109	38	62	35	69	40	57	33	28	29	25	32	36	21	37	30	36	31	46	43	50	30	27	43	44	41	33	31	16	42	58	32	56	55	50	60	31	44	34	43	46	42	29	48	31	26	42	68	25	33	44	35	56	31	40	34	29	59	40	19	16	53	54	62	104	38	23	125	55	27	27	56	31	43	59	77	19	35	46	95	33	40	13	21	22	17	43	30	37	48	38	38	38	22	55	26	61	14	25	25	36	12	36	30	17	50	52	19	26	32	46	23	31	20	31	34	39	63	63	61	36	54	38	44	36	29	48	17	45	45	89	42	36	36	32	44	31	33	21	50	33	27	53	48	51	23	44	8	33	43	110	25	25	12	64	62	86	26	33	42	24	29	31	43	13	28	43	36	19	66	19	44	25	32	28	46	21	33	19	31	19	35	48	17	31	32	23	33	35	40	21	36	58	28	31	16	33	50	14	42	11	22	40	70	36	27	37	32	32	61	32	52	33	23	32	39	72	19	23	26	11	57	26	11	34	44	36	46	45	31	42	49	14	72	76	72	30	37	18	13	54	38	40	26	24	22	43	23	29	7	23	36	2	30	11	32	20	51	46	12	37	9	40	8	11	29	22	39	52	22	20	29	22	26	14	35	41	37	35	85	14	43	40	21	31	29	12	16	28	41	40	43	39	36	46	33	29	44	49	26	16	41	7	27	35	22	31	31	34	27	35	17	20	38	15	32	35	16	36	29	11	31	29	15	21	48	86	80	5	34	13	39	13	34	42	19	40	28	16	18	40	15	19	36	29	8	24	48	10	20	39	6	15	14	13	24	20	24	60	17	21	15	22	8	22	23	43	40	46	35	21	6	12	15	24	28	7	21	10	33	27	36	24	42	15	15	27	32	15	25	15	11	21	24	22	57	21	50	17	42	20	21	11	12	25	47	26	21	14	34	17	9	20	8	13	25	19	15	18	24	23	20	14	22	36	15	22	15	6	20	15	31	28	16	12	33	15	8	25	23	7	82	56	14	17	19	25	16	35	14	35	16	21	12	4	14	6	10	24	20	15	37	9	5	14	2	10	20	16	19	11	8	15	28	15	13	13	9	18	14	17	15	7	19	22	16	23	30	18	39	15	8	32	8	4	23	18	13	13	5	8	5	6	3	8	26	7	27	9	12	13	26	4	9	13	22	6	40	7	10	33	46	8	19	22	14	31	5	11	14	15	15	24	15	21	4	17	15	20	10	5	9	15	39	9	7	25	14	8	10	11	7	14	7	14	17	6	11	13	18	12	8	15	25	0	10	8	8	24	4	42	13	9	5	6	6	13	10	13	19	17	2	23	20	17	10	22	11	1	19	6	7	9	18	20	12	8	15	11	18	10	11	13	10	17	12	16	10	32	13	13	16	6	6	22	9	14	9	4	12	65	14	3	3	10	9	18	12	17	11	2	14	16	4	13	7	6	19	7	3	1	7	16	6	12	5	4	2	8	10	17	21	3	4	3	7	7	5	8	5	5	6	3	12	2	6	7	5	5	7	9	10	11	5	8	12	3	3	0	15	3	2	0	14	5	1	4	5	1	6	16	7	11	4	6	2	3	4	10	3	10	2	11	2	13	5	16	7	3	6	6	0	7	4	4	3	8	6	5	2	7	12	3	20	8	6	5	0	10	6	0	1	3	9	9	9	4	4	2	1	11	4	2	5	2	1	5	3	13	1	3	4	1	0	4	0	1	6	1	3	1	4	1	1	2	5	1	4	10	8	1	12	0	2	4	5	1	1	1	2	1	14	1	2	0	2	3	3	3	3	1	3	2	0	1	0	6	3	1	2	1	0	3	0	0	2	3	0	0	1	1	4	2	3	2	2	8	0	3	0	3	0	1	1	0	0	0	0	1	0	2	1	0	3	1	0	0	0	0	0	0	1	0
ne0027	3200	2765	1818	1500	1731	1576	1538	1330	1157	1519	1510	1317	1347	1229	855	1131	1126	898	982	1069	796	1174	843	1155	899	820	953	874	946	905	857	975	887	896	774	743	902	773	738	595	850	749	578	948	817	852	865	658	863	870	861	714	819	571	883	793	518	495	729	862	747	780	522	523	670	685	770	863	755	571	698	524	640	493	728	569	604	542	665	636	711	579	748	515	596	695	465	635	600	674	647	529	652	464	546	565	634	529	754	690	544	572	456	666	637	566	667	677	423	706	565	579	742	626	671	443	617	519	379	592	427	661	362	590	522	571	570	442	595	617	572	588	374	513	395	423	411	413	589	499	559	449	519	461	433	497	540	326	590	475	536	467	488	416	456	376	495	464	537	501	467	441	553	430	496	397	476	376	329	551	502	408	544	458	504	290	414	547	361	361	290	450	473	317	515	282	499	405	349	398	316	383	334	501	343	507	457	555	318	417	367	301	408	448	292	365	457	344	525	409	522	405	355	446	320	436	335	323	405	364	280	451	305	484	365	447	344	399	413	357	282	465	374	358	448	309	492	353	334	396	317	292	496	308	301	354	441	367	346	402	409	335	378	275	480	480	317	386	300	346	384	307	318	329	281	376	360	225	291	245	404	290	386	328	289	316	236	373	341	277	285	329	270	197	261	157	310	369	314	472	289	363	316	252	299	251	412	326	299	312	299	241	289	281	384	296	242	360	253	255	276	313	299	303	262	227	355	224	459	311	368	312	256	248	296	312	325	353	311	263	278	300	358	362	415	361	414	132	287	246	281	357	358	224	234	339	354	181	176	261	381	238	235	296	267	267	152	279	257	190	245	239	463	325	257	333	246	300	280	340	240	290	242	310	291	235	182	141	282	238	157	293	276	268	231	281	275	186	238	313	150	255	227	145	320	293	224	232	173	338	259	188	229	302	209	202	238	160	262	226	204	245	228	231	211	157	251	277	216	304	204	174	227	274	300	288	259	246	214	223	354	293	219	204	268	281	248	151	278	208	204	179	221	145	197	259	244	148	235	213	203	236	222	222	181	191	236	205	167	344	237	227	184	142	183	183	192	212	200	228	118	208	162	298	282	171	232	238	156	172	166	110	238	145	223	144	248	310	299	212	176	137	227	168	163	201	210	212	191	304	193	250	155	263	326	209	164	138	202	310	188	155	261	192	202	210	226	186	205	220	201	248	184	243	177	222	176	189	180	181	197	171	188	158	174	142	160	195	87	152	146	220	219	231	217	94	193	152	125	285	180	141	190	168	184	169	207	176	183	194	172	256	192	169	229	218	196	270	189	144	286	122	181	172	173	225	282	224	200	194	193	148	206	171	182	195	213	152	115	156	171	182	188	134	181	117	255	129	259	148	178	126	125	192	196	142	164	194	200	168	109	97	159	138	145	150	177	195	150	134	138	147	154	100	222	171	140	122	139	93	173	134	185	136	144	153	188	190	93	133	122	136	195	148	125	133	135	179	128	154	129	172	104	135	169	123	138	190	169	165	167	257	124	157	188	165	183	161	208	142	144	128	128	184	146	222	148	145	361	128	171	111	115	146	79	132	133	85	127	126	146	141	122	137	118	97	136	131	159	132	145	134	105	151	107	150	188	217	146	102	161	121	136	154	145	125	129	136	106	78	141	119	140	140	76	111	151	206	156	64	149	95	180	162	104	125	107	195	106	96	75	77	112	144	159	130	106	118	172	132	124	145	80	117	94	93	175	127	99	146	92	144	161	131	107	100	95	153	120	112	99	110	223	78	174	105	128	116	255	173	141	83	145	138	102	136	151	113	73	182	144	136	92	118	63	97	118	157	99	95	113	86	122	144	101	162	104	186	86	133	61	102	120	158	136	211	121	186	160	83	222	117	93	132	159	77	112	106	102	146	94	76	81	113	144	122	88	83	87	129	82	77	162	113	131	115	76	110	120	109	77	84	82	100	70	89	97	81	85	52	129	105	93	102	102	168	68	59	114	66	84	97	89	132	108	107	98	54	108	101	113	126	97	123	80	129	152	81	85	148	59	85	87	107	71	187	83	173	114	125	124	143	92	78	74	76	142	96	60	82	115	114	82	108	176	90	84	97	122	84	95	134	92	118	89	67	90	101	101	93	105	98	81	108	85	86	57	83	74	115	58	116	98	169	93	147	107	92	75	69	90	78	57	102	47	72	84	109	49	92	80	89	80	114	120	62	123	106	119	64	90	84	75	96	68	70	82	100	107	114	69	82	85	127	81	73	86	93	74	60	94	61	56	78	153	84	93	75	113	64	111	79	88	89	76	86	108	76	79	122	101	114	59	88	95	76	84	71	71	84	61	85	79	74	92	91	155	120	104	74	95	59	91	70	85	65	78	33	87	92	57	104	64	81	114	69	117	64	82	99	100	95	114	85	88	89	82	83	69	68	69	122	90	59	43	79	66	95	121	116	97	91	127	53	91	93	48	70	83	80	93	56	59	144	61	65	45	84	94	57	86	83	78	96	99	64	90	63	82	169	78	112	79	65	67	73	67	92	70	130	52	65	53	76	79	68	61	73	103	58	66	94	91	87	42	88	83	68	60	92	93	40	86	73	79	54	92	52	71	69	61	73	75	80	52	70	47	62	47	97	58	60	78	55	51	70	75	96	47	102	113	91	28	46	40	52	26	48	61	69	38	100	64	100	74	53	50	44	41	48	149	52	47	19	69	102	52	47	52	45	67	45	72	77	93	78	60	85	46	85	62	76	35	131	41	53	79	93	37	107	54	60	47	61	74	64	61	21	66	66	72	64	66	58	67	49	43	72	74	52	67	53	47	49	58	34	46	60	58	51	53	37	35	54	52	39	56	62	53	36	54	63	49	59	58	56	32	95	55	75	63	50	36	68	26	79	43	49	72	71	50	107	59	37	40	42	39	42	50	61	25	55	56	58	53	38	51	75	100	55	72	28	50	55	43	27	82	52	30	52	48	48	71	64	28	55	74	84	80	51	9	21	30	25	31	35	27	39	39	44	32	57	38	41	35	43	69	58	51	48	32	53	60	29	52	24	56	58	45	86	45	55	33	31	36	81	32	46	70	29	25	57	81	62	36	32	43	32	32	42	52	41	54	11	54	26	116	56	28	32	52	23	63	14	52	55	65	34	46	53	32	55	48	33	25	41	47	70	23	80	56	24	29	25	70	21	9	45	27	41	36	50	26	33	33	28	23	29	33	71	38	46	22	38	41	24	40	45	46	89	62	45	25	33	39	17	24	27	22	29	30	47	26	49	30	34	39	35	24	23	39	40	56	33	35	71	36	25	25	26	11	20	43	64	32	25	56	12	37	24	10	31	57	44	25	39	40	22	29	33	28	45	43	21	31	48	26	25	20	24	32	17	32	51	26	24	28	14	38	22	39	33	28	15	47	27	28	30	32	88	28	31	26	24	22	25	19	43	38	23	42	41	20	28	18	14	16	32	41	29	42	37	16	30	29	23	26	14	38	46	14	34	18	49	30	20	18	18	26	18	42	45	34	22	21	29	25	38	17	40	38	20	39	25	14	22	42	48	19	34	31	24	40	33	23	20	12	13	13	14	40	22	10	56	24	33	7	20	19	68	25	18	10	39	33	24	21	58	14	39	14	22	125	29	18	56	23	16	25	22	42	9	15	16	25	12	16	11	11	12	21	17	7	12	40	11	16	34	18	7	16	36	13	32	27	9	22	17	22	28	38	11	8	6	30	14	21	20	19	30	37	24	12	18	13	17	10	9	30	23	8	120	14	15	13	21	10	26	11	30	16	14	18	12	14	13	13	11	23	10	21	33	13	12	13	14	16	9	12	8	12	7	13	26	8	10	12	7	6	13	21	38	7	6	11	14	22	12	43	10	8	7	23	8	4	17	9	16	5	17	5	11	6	14	10	6	8	7	13	10	15	13	19	19	11	6	10	4	19	15	8	7	15	7	7	10	8	11	6	10	10	8	8	12	15	6	12	4	4	227	17	9	12	4	14	9	11	37	10	11	17	3	3	4	1	6	6	3	2	8	8	8	4	24	10	8	7	108	7	5	14	5	8	5	6	2	4	7	2	3	2	10	5	5	4	3	5	3	2	1	1	10	2	1	4	3	2	1	1	1	1	0	1	1	0	0	0	7	1	1	2	1	0	1	0	0	1	0
ne0028	3994	3382	2140	1681	2276	2264	2067	1805	1601	1897	1648	1856	1946	1832	1211	1602	1655	1220	1249	1625	1098	1378	1138	1483	1131	1019	1193	1162	1123	1223	1046	1045	1080	1371	1026	1045	1146	894	901	783	972	993	704	1089	1013	1191	1286	921	972	1004	1231	935	992	877	885	1126	785	668	847	1004	1049	791	611	754	935	816	1138	819	813	686	767	666	739	581	624	654	752	787	808	635	856	708	1087	592	615	1000	555	771	651	808	778	745	962	507	692	657	921	714	629	791	799	642	607	960	683	780	654	1019	687	683	573	682	1109	958	937	530	982	706	426	923	645	948	535	694	635	631	622	607	939	922	705	679	481	534	622	383	566	531	869	563	652	667	532	478	412	655	587	443	660	593	613	498	753	553	545	404	704	507	854	662	668	458	640	625	681	469	515	493	315	813	531	504	642	537	811	440	576	853	439	429	473	459	544	501	532	333	546	535	439	446	411	555	389	667	497	659	509	853	477	490	471	800	382	526	338	519	466	502	633	500	823	543	437	545	447	592	447	379	517	497	394	575	353	518	450	534	569	413	457	433	380	494	769	325	502	438	417	447	466	443	439	533	546	458	315	533	547	463	441	399	529	362	470	374	554	765	413	523	437	735	452	368	398	517	339	468	409	281	331	330	489	426	492	420	385	383	359	449	432	294	294	400	338	343	352	240	351	424	312	376	461	447	381	370	453	277	514	404	465	426	387	283	396	368	400	492	403	476	352	338	331	356	369	395	311	298	381	334	512	412	430	346	350	265	410	381	345	325	357	295	311	438	453	571	406	370	409	192	371	397	367	428	359	224	390	343	340	285	260	285	351	303	267	350	395	377	252	258	302	279	359	328	423	323	344	281	326	307	376	367	302	304	378	351	330	435	265	267	433	304	246	379	370	378	342	269	431	218	326	296	221	333	254	313	418	325	225	284	226	430	283	191	350	319	321	233	256	235	343	329	282	270	302	357	207	278	319	336	289	360	273	187	239	267	399	264	299	308	213	266	344	526	221	248	309	287	271	243	247	293	293	196	210	239	266	317	249	249	326	297	276	324	276	276	238	256	331	223	146	353	327	183	196	229	204	209	216	253	257	214	228	263	245	333	295	260	339	240	141	190	201	183	318	211	444	253	335	374	329	297	152	201	209	246	220	268	260	254	282	393	252	309	222	253	308	290	170	187	317	323	235	251	246	214	279	224	240	275	268	301	249	274	219	246	240	234	225	251	198	226	229	274	306	221	200	262	200	289	195	229	169	192	202	218	240	105	217	192	284	243	190	174	261	259	285	213	206	207	212	230	228	270	222	263	214	231	211	277	168	192	368	193	129	216	211	278	244	347	259	224	224	232	288	189	244	243	255	217	162	197	167	230	254	180	209	192	248	151	304	205	213	161	172	220	219	206	172	239	194	196	125	162	178	126	182	189	176	224	187	186	208	202	178	133	210	227	204	128	206	159	182	179	218	212	185	182	193	215	168	182	143	119	219	195	159	157	166	179	166	194	179	205	225	166	217	152	150	234	196	173	155	237	176	241	184	245	255	176	202	201	228	129	177	221	169	208	141	151	250	163	181	154	117	157	90	173	220	78	127	116	173	188	193	201	128	185	175	184	203	124	215	185	129	129	120	148	246	209	152	107	165	235	145	209	191	157	190	142	129	144	169	105	155	129	153	171	166	177	169	115	195	168	127	195	171	121	131	195	146	96	131	119	158	183	176	165	73	134	150	149	108	166	99	134	139	130	233	139	119	112	108	153	230	160	159	113	224	229	136	149	138	110	295	119	196	129	121	115	128	142	189	169	166	154	142	140	123	180	121	164	194	208	131	115	99	158	157	193	123	126	153	104	98	134	156	129	142	194	87	156	102	113	114	152	188	170	92	187	160	89	155	173	103	179	174	125	140	110	120	128	130	118	112	191	137	130	116	82	103	144	121	121	190	121	133	99	110	132	113	109	100	151	120	144	82	125	145	133	99	67	130	128	143	119	133	102	72	81	118	78	110	145	112	198	112	118	113	74	128	121	127	189	105	151	133	127	179	94	119	169	78	92	95	153	155	169	146	157	129	109	137	132	130	100	95	84	276	100	77	99	125	116	156	169	102	93	75	180	140	104	93	175	73	142	100	80	118	150	78	85	80	110	98	110	104	113	139	133	71	121	62	171	78	153	132	149	133	101	97	111	120	99	69	96	71	93	61	102	96	102	141	81	78	114	114	69	127	124	91	103	114	110	132	114	77	89	152	99	117	156	133	77	80	359	66	109	114	92	100	84	80	99	62	91	120	95	78	84	134	119	99	95	79	107	90	102	97	105	80	130	104	121	67	81	166	111	74	60	71	119	123	75	90	106	75	78	126	107	107	96	69	51	138	98	96	85	114	56	78	111	74	86	162	87	77	31	120	77	113	105	78	88	78	137	157	76	99	90	105	95	96	104	87	99	107	70	83	98	96	124	91	124	143	87	110	91	101	65	50	83	84	109	66	154	54	99	58	134	142	59	72	88	94	103	68	70	94	58	148	80	54	132	113	97	76	84	79	67	69	119	74	79	51	120	97	59	55	115	124	63	86	94	66	131	56	93	121	70	94	93	95	73	84	62	57	89	80	77	66	83	93	34	68	76	74	62	58	50	77	78	81	92	54	36	103	88	74	107	64	77	133	84	33	62	40	53	46	93	55	75	62	71	61	113	68	64	97	67	53	50	91	89	64	61	87	67	63	74	83	44	76	77	66	93	96	82	79	99	54	89	55	80	64	125	57	55	72	47	49	103	53	76	64	57	72	65	56	59	50	61	90	82	103	93	49	71	54	82	54	79	74	78	69	52	67	53	74	78	66	54	80	37	39	55	60	52	31	68	56	44	73	74	93	99	56	53	36	70	51	46	67	61	36	82	23	61	50	59	93	64	105	51	74	58	75	51	61	66	63	55	37	50	58	70	88	50	75	52	74	60	123	56	60	78	47	38	62	68	56	64	62	79	62	84	31	59	87	80	57	64	60	24	26	34	44	35	27	19	45	58	47	79	49	39	26	59	35	36	52	36	49	92	65	44	70	45	168	49	49	58	48	65	58	51	51	58	42	27	44	42	45	54	88	66	45	39	30	36	51	32	54	62	47	39	56	45	125	68	46	36	49	74	59	31	55	33	74	56	62	40	43	57	63	39	45	52	55	67	51	67	77	37	22	80	93	46	38	50	44	55	54	66	53	42	35	41	18	26	36	73	60	42	63	44	51	30	50	54	52	81	93	31	33	57	51	31	13	36	26	36	22	62	46	60	31	28	34	31	40	38	33	27	80	17	40	41	48	33	48	35	30	46	41	60	29	29	66	25	26	40	30	33	43	36	42	35	22	43	27	31	32	44	41	33	42	66	24	41	24	28	36	37	27	51	35	31	26	22	49	24	28	51	25	42	25	35	37	54	20	61	32	21	31	41	18	23	29	50	34	27	45	36	24	44	22	29	36	25	43	62	37	57	26	34	21	37	31	47	53	27	27	62	34	56	22	26	24	25	38	35	56	31	21	23	16	21	30	26	26	36	26	18	30	23	23	19	59	36	25	29	9	19	46	20	18	22	17	30	19	31	27	34	15	39	20	29	27	31	12	60	20	13	15	21	28	18	26	50	14	59	29	24	23	47	13	50	34	21	15	25	22	14	29	27	22	33	23	23	9	20	23	20	16	10	52	16	24	37	12	14	25	19	24	31	20	17	12	36	23	38	19	11	10	20	15	14	73	11	24	13	19	15	18	22	25	33	18	9	20	38	9	14	16	23	20	22	8	23	20	15	27	11	15	23	24	17	15	7	25	20	17	23	6	13	15	21	8	10	15	11	20	11	12	11	7	15	5	18	14	8	25	29	9	6	13	14	14	12	12	8	16	31	26	9	15	9	15	16	11	23	14	16	9	19	14	16	13	11	13	14	11	13	14	7	4	7	2	12	12	5	4	5	11	16	4	12	7	10	7	4	19	2	8	7	12	9	11	2	16	135	34	6	3	12	6	3	6	15	10	12	6	6	15	10	2	5	5	10	6	16	4	6	7	9	6	12	3	11	3	6	5	8	5	3	3	1	2	5	4	3	4	1	2	12	4	2	4	1	0	2	3	8	3	2	1	0	3	1	0	2	2	2	0	1	0	0	0	2	0	2	4	0	4	4	0	0	0	0
ne0029	7319	6198	3814	2877	2982	3971	3513	3168	2772	3300	2647	3085	3309	3048	2569	2613	2785	1970	2129	2701	1819	2506	1967	2191	1935	1976	2434	2070	2200	2369	1808	2035	2037	2190	2003	1849	2049	1625	1664	1612	1735	1881	1089	2112	1667	2001	1940	1684	1925	2027	2002	1769	1287	1330	1483	1907	1185	1366	1589	1397	1700	1662	1057	1128	1634	1455	1828	1828	1595	1264	1461	1195	1505	1090	1214	1236	1494	1434	1408	1032	1673	1346	1538	1079	1026	1559	956	1396	1124	1347	1270	1341	1568	973	994	1158	1453	1259	1823	1521	1548	1004	982	1600	1277	1377	1177	1642	1225	1161	1218	1179	1706	1561	1466	917	1589	1218	777	1384	1011	1479	940	1277	1106	1124	1130	1031	1534	1470	1297	1271	844	1046	1004	743	962	856	1353	1090	1098	1259	868	977	758	1423	1251	690	1095	1090	1192	946	1354	942	1184	831	1107	943	1346	948	1065	818	1191	1258	1202	776	1023	946	605	1137	1128	828	1249	1149	1290	772	913	1298	807	689	858	993	1009	752	848	584	993	935	774	779	719	1005	737	1236	921	845	871	1303	821	1117	872	741	751	877	559	962	893	919	1150	868	1284	1045	798	1023	788	924	742	587	950	776	800	850	654	969	904	1001	899	896	721	672	713	868	630	691	915	795	776	720	924	800	1041	731	832	694	497	849	1151	828	760	730	848	681	856	730	1088	1170	682	793	778	547	681	787	735	825	588	839	809	607	660	645	899	736	899	698	824	670	710	807	784	577	463	746	565	377	561	341	770	703	632	862	716	773	550	689	684	500	776	643	744	677	554	383	684	715	747	539	628	773	601	567	518	715	582	660	550	429	717	548	1169	645	862	755	672	541	593	472	697	618	565	649	583	802	772	801	977	631	831	421	714	621	611	772	778	476	675	581	616	592	476	577	752	498	501	672	553	812	618	521	469	389	620	394	511	502	611	514	569	618	649	634	620	494	705	608	593	390	481	518	742	558	452	617	588	701	634	550	522	536	557	618	446	568	514	456	785	632	462	439	281	747	545	398	605	597	666	410	549	491	726	525	533	582	568	574	394	417	583	663	647	589	492	307	475	649	726	583	544	562	433	462	501	526	439	497	472	620	539	460	475	527	594	404	508	388	452	531	495	381	559	531	507	620	511	478	387	390	553	426	316	676	510	401	398	368	321	413	480	438	489	442	261	537	453	548	458	381	458	434	278	377	309	235	619	399	435	280	501	586	463	506	329	383	451	392	366	486	495	417	474	672	340	557	435	329	470	533	310	322	572	551	424	455	560	427	461	338	472	406	414	539	401	362	368	446	420	439	402	474	453	374	455	529	581	415	394	393	418	533	297	484	298	376	352	416	364	203	308	234	408	614	385	318	439	421	458	409	495	366	469	402	476	607	466	408	480	412	388	452	264	389	598	245	306	414	374	309	615	629	491	383	373	373	420	308	459	479	364	396	272	390	366	483	383	332	422	270	561	244	551	378	393	360	370	380	376	364	318	367	271	252	241	441	336	245	331	325	356	461	359	313	228	376	344	395	432	435	309	388	367	253	305	342	329	331	286	309	354	437	374	360	302	373	339	342	314	245	324	337	301	352	376	352	343	316	388	279	328	307	358	243	371	422	347	389	391	380	371	368	367	334	234	170	320	216	288	512	282	251	594	311	325	281	271	297	172	256	281	187	290	219	292	322	383	329	250	285	323	312	376	172	363	360	258	223	259	343	499	331	324	343	253	318	348	388	260	287	365	227	243	235	319	166	351	239	301	193	356	420	325	245	324	251	293	443	292	252	194	334	253	184	238	190	325	364	358	272	121	229	306	286	206	301	192	302	204	288	418	256	195	256	213	311	331	279	305	198	175	432	196	263	199	263	456	182	348	238	323	207	301	302	448	266	302	242	256	289	226	337	199	372	267	264	235	238	194	267	265	387	249	223	302	193	209	236	353	248	334	310	201	298	130	172	250	253	272	368	220	272	260	151	284	410	162	284	319	280	265	248	230	213	221	157	251	235	236	260	236	174	108	273	189	211	174	214	273	149	297	230	267	144	203	210	224	325	163	194	240	255	184	134	237	306	222	175	247	179	146	156	209	120	172	253	157	429	244	205	212	214	180	211	224	306	232	257	180	259	421	191	162	274	158	196	132	279	202	321	259	262	209	233	253	241	245	225	161	153	352	198	144	215	225	244	326	271	210	210	148	271	291	136	207	327	159	247	185	197	231	273	209	123	111	201	231	216	116	181	145	267	125	247	124	284	219	262	240	230	240	218	188	266	250	208	102	188	116	185	106	179	148	168	274	211	222	213	122	204	240	251	199	181	202	209	216	182	150	113	235	161	213	265	285	154	137	162	118	233	171	195	173	150	195	274	128	186	116	234	153	178	265	228	202	268	150	213	205	191	167	133	148	200	190	271	143	125	189	214	89	154	125	246	202	189	163	156	145	210	361	199	212	192	143	131	227	233	187	139	207	64	202	168	131	186	185	174	105	89	230	124	200	267	153	135	249	214	208	143	173	206	217	149	182	237	169	176	152	245	166	224	132	222	205	177	149	125	152	186	222	86	125	189	175	220	135	221	132	216	75	182	219	116	143	182	174	151	228	146	84	166	199	164	158	186	233	219	154	172	126	195	131	207	140	124	110	240	159	93	85	206	182	106	131	148	135	208	94	161	234	136	182	220	172	109	184	180	200	131	252	120	141	176	154	93	124	212	154	121	110	94	68	118	169	111	85	104	81	140	135	224	119	206	226	133	74	130	117	112	50	123	113	149	104	96	102	235	136	129	117	121	79	93	313	92	119	78	136	122	118	130	249	93	195	105	125	239	155	118	164	186	107	214	168	149	120	201	70	99	160	120	76	175	97	125	85	139	161	121	94	44	137	176	199	219	147	185	157	132	120	185	91	126	126	78	134	103	145	92	146	89	108	87	117	68	108	103	102	87	79	128	99	68	140	99	179	157	98	96	63	160	82	75	148	75	60	140	67	140	100	111	200	115	151	162	152	77	116	75	88	139	81	85	62	89	92	139	158	64	123	78	175	103	170	87	92	72	116	113	169	109	90	109	93	103	146	156	54	98	147	152	118	127	88	79	87	56	66	115	58	60	133	72	86	140	116	117	63	106	101	68	140	135	85	118	166	95	85	50	74	62	99	87	63	136	84	86	96	99	80	97	63	81	77	121	156	132	92	120	59	79	79	69	179	84	99	37	96	65	146	128	69	93	109	100	113	71	116	155	149	91	115	115	68	91	87	79	57	69	99	138	112	143	117	66	68	126	62	64	27	120	54	97	95	138	100	60	79	104	42	67	75	182	73	90	96	166	105	82	78	140	52	118	172	89	59	74	89	58	60	78	106	49	68	100	73	85	69	56	52	61	58	62	118	92	55	92	72	111	116	77	36	34	179	68	81	85	74	65	106	65	46	98	53	54	93	77	56	73	109	72	67	55	63	100	101	56	91	74	60	99	37	48	63	49	89	59	63	69	58	46	121	76	44	87	40	41	35	72	42	93	29	97	50	53	76	60	60	86	38	58	57	70	67	82	63	48	63	57	78	56	96	87	77	74	48	71	29	59	63	62	78	56	39	94	75	64	43	56	79	68	59	39	118	61	103	49	58	46	47	55	106	68	42	42	60	40	43	76	67	31	36	44	34	59	66	39	30	31	35	49	41	32	56	91	25	28	43	67	51	43	38	75	68	39	19	61	42	39	48	133	21	162	32	26	30	90	27	103	55	29	43	50	54	37	24	25	41	28	58	63	18	37	52	39	37	68	58	21	143	78	27	19	64	33	28	61	59	35	19	48	40	37	49	37	16	31	37	41	38	36	54	44	37	42	33	39	64	42	25	21	89	58	32	18	26	35	40	58	17	52	22	53	29	21	41	19	28	47	38	32	55	22	31	30	36	23	33	20	35	21	128	35	10	23	31	32	15	44	27	24	20	42	31	90	28	22	10	9	32	18	116	9	18	25	50	15	18	34	38	39	21	38	35	25	14	21	18	38	18	31	24	18	29	29	22	23	21	24	12	28	17	12	13	33	37	24	13	26	20	17	10	13	29	9	9	18	19	8	26	7	14	8	43	6	17	20	12	28	15	19	17	26	41	44	11	9	5	19	12	20	5	11	12	10	18	11	20	12	9	22	36	10	13	19	21	10	8	6	10	17	2	10	7	4	12	24	7	2	11	1	11	3	12	17	2	14	8	3	7	7	2	1	3	4	4	6	0	0	0	8	3	6	3	0	1	4	1	1	0	0
ne0030	1599	1801	850	1036	1244	849	853	724	909	554	855	680	485	478	537	545	448	647	935	569	439	700	585	526	563	641	552	507	726	417	636	580	451	325	451	317	384	680	465	363	422	413	685	559	318	256	317	287	465	368	250	450	354	360	496	326	528	401	330	282	316	504	630	385	339	458	260	510	388	515	248	472	416	275	482	557	381	340	367	346	300	325	192	407	526	240	418	389	409	326	217	412	187	208	456	345	227	296	417	268	356	239	152	165	420	260	262	168	309	358	329	396	167	165	194	370	181	328	426	122	168	148	349	373	358	286	271	225	145	185	334	235	328	171	235	426	384	272	135	339	232	236	288	289	315	253	368	387	365	225	270	298	232	274	284	382	259	255	112	153	285	305	205	222	290	359	274	181	285	136	311	257	249	228	116	213	286	92	288	259	193	152	246	165	205	286	190	297	236	339	238	194	297	258	255	289	268	134	137	209	264	361	224	229	227	237	183	192	156	254	98	230	315	152	198	173	187	327	215	300	446	128	278	192	165	219	243	196	181	201	322	248	375	178	337	154	275	338	225	238	224	243	296	257	289	199	191	206	197	224	300	326	205	303	140	67	258	204	242	344	101	156	130	125	234	117	180	285	209	285	188	185	239	180	201	247	187	212	187	221	168	181	222	210	246	222	154	192	253	168	238	186	355	155	193	190	129	140	101	186	221	199	192	153	173	295	180	164	101	266	277	157	310	241	138	156	177	249	110	120	182	134	181	235	294	147	143	213	145	203	297	117	149	77	209	184	185	118	200	161	194	168	156	68	160	174	191	136	215	120	199	199	223	108	185	153	235	231	242	190	115	217	75	204	172	226	153	91	103	166	144	176	156	230	131	152	134	107	166	190	126	150	195	80	150	174	258	162	130	147	129	178	213	129	72	160	155	137	158	126	135	106	116	141	169	178	163	203	120	180	196	168	186	118	182	91	108	190	117	216	183	162	128	118	82	69	156	127	131	155	76	130	166	152	191	94	126	179	107	142	130	189	167	95	135	131	95	111	122	137	93	66	160	132	154	174	124	181	151	69	132	129	120	218	140	204	183	143	148	195	91	119	129	96	162	107	119	151	155	179	111	87	93	140	133	147	156	122	57	90	123	80	157	190	175	101	124	109	110	106	136	103	112	79	60	128	147	125	110	110	104	87	121	164	102	165	121	159	114	117	154	114	128	121	140	98	135	62	117	88	98	104	136	95	149	169	188	128	176	79	110	210	168	109	150	181	142	147	126	114	107	140	147	114	95	137	112	150	158	99	133	120	131	143	195	183	108	124	127	109	54	59	108	139	95	87	190	52	75	122	142	78	91	99	134	94	108	86	87	101	139	67	53	123	87	120	144	88	97	75	159	128	94	116	105	113	144	121	137	177	75	115	124	110	59	191	130	89	141	129	101	188	98	93	156	74	80	83	131	114	123	88	132	163	145	136	162	120	179	118	48	152	78	96	149	104	134	74	114	113	55	94	123	94	83	102	105	58	114	145	57	102	140	111	69	94	128	42	49	77	74	192	122	42	101	127	88	133	123	122	113	105	92	107	218	84	81	90	45	102	148	67	136	99	50	132	73	61	90	131	85	95	63	75	94	100	68	78	93	97	85	110	78	59	83	92	82	111	66	84	89	90	89	138	106	138	95	97	80	144	114	126	71	91	116	116	137	107	53	143	102	93	57	71	78	97	98	93	101	62	62	81	99	124	95	49	70	92	81	139	95	84	60	95	143	114	170	146	65	51	220	42	41	70	102	101	83	58	96	99	76	77	66	88	72	119	137	66	96	69	115	103	71	100	75	76	90	62	95	83	63	82	136	52	61	53	55	42	56	52	105	46	60	61	102	86	61	82	65	154	99	78	80	98	129	99	55	144	79	50	98	101	77	45	56	55	74	93	75	32	73	114	20	56	74	65	63	85	67	114	67	36	39	91	52	82	55	61	92	61	77	47	65	47	40	59	80	53	62	58	53	72	120	65	31	45	100	68	68	76	43	23	60	59	41	105	72	102	52	56	86	57	96	74	78	54	30	49	86	46	49	60	41	44	96	67	66	51	90	26	118	68	54	47	71	72	91	47	52	84	41	44	38	78	79	89	51	28	81	92	116	73	54	60	96	62	78	46	71	72	93	82	111	84	48	102	88	109	86	32	65	66	135	99	46	68	93	48	70	119	76	84	74	28	95	59	97	40	39	57	54	64	46	61	58	68	44	73	60	57	22	61	38	86	131	46	44	74	42	86	66	83	47	87	59	74	61	61	117	23	70	61	38	89	76	53	67	83	114	67	42	64	56	67	52	64	84	59	79	43	47	60	77	87	87	59	68	46	36	75	54	78	36	26	51	63	47	98	80	32	80	76	35	72	71	58	60	37	43	72	37	61	48	24	46	83	62	111	28	98	55	40	29	49	41	28	63	74	51	83	44	59	43	30	60	36	50	73	63	61	64	94	71	62	63	39	143	48	48	75	50	52	51	43	53	51	77	62	42	29	73	61	44	51	61	46	42	30	78	60	42	46	75	44	71	75	70	38	60	43	105	39	75	51	80	30	53	44	20	43	45	38	36	36	32	49	56	77	45	36	65	41	99	60	28	37	101	50	73	72	37	75	30	69	58	50	61	26	58	45	31	33	67	43	80	89	98	19	64	32	51	49	47	35	33	75	26	93	67	53	83	38	105	30	33	43	54	39	51	55	45	44	17	58	28	46	32	54	33	42	58	29	62	35	66	89	35	56	55	26	47	27	51	46	37	55	42	64	41	45	32	32	25	17	78	55	35	23	54	32	43	23	32	19	75	32	37	80	21	60	21	74	56	36	50	52	33	37	66	38	38	80	46	31	28	51	23	29	58	88	31	38	43	22	50	35	22	39	48	42	30	62	30	65	9	67	40	32	61	53	25	40	32	26	56	54	39	57	19	29	44	41	40	28	22	83	33	14	59	38	27	15	57	27	35	22	26	44	44	59	15	26	59	56	20	55	55	52	24	15	48	23	47	30	54	41	35	34	28	43	44	23	39	60	21	45	55	28	52	58	27	12	35	37	22	64	55	15	27	94	39	8	17	19	23	21	48	35	32	24	30	29	32	32	49	26	37	29	42	37	55	24	19	40	46	36	27	10	20	33	22	23	27	55	18	24	23	25	18	30	17	28	44	16	30	38	42	17	19	27	28	20	91	35	55	22	48	107	30	21	41	34	98	19	36	30	38	25	20	37	19	16	31	99	13	30	25	41	61	6	40	18	54	16	28	25	37	14	20	56	18	40	36	16	14	15	34	29	15	40	85	36	28	34	30	47	33	28	37	54	24	26	47	31	17	54	34	52	30	8	12	24	27	20	11	15	26	27	27	26	15	8	53	26	32	19	50	42	43	22	10	20	42	112	19	38	16	9	27	26	18	31	9	14	24	20	40	38	21	11	21	17	24	32	31	29	19	29	24	16	26	23	22	10	61	18	17	16	16	24	37	16	16	21	52	15	35	39	25	17	22	38	8	40	8	27	23	14	26	30	28	16	26	18	9	15	6	44	31	22	26	9	22	17	12	8	5	18	21	20	41	10	29	38	17	21	29	16	23	9	29	19	20	11	14	21	7	23	39	7	21	8	9	18	36	11	18	25	26	11	18	16	8	96	11	20	6	38	4	13	14	14	14	11	29	17	57	4	22	12	4	26	26	8	10	4	11	13	22	34	87	28	18	22	6	11	14	11	4	10	13	9	7	26	16	17	17	7	25	12	37	28	27	14	10	8	12	13	13	43	4	41	7	34	6	5	5	99	11	18	10	32	32	16	9	5	13	18	4	12	6	7	6	9	44	18	5	3	1	3	5	2	24	17	9	23	10	8	2	14	41	1	2	3	23	19	3	14	10	11	4	12	7	7	31	3	11	1	11	9	7	5	9	5	14	7	5	8	61	3	12	7	15	20	21	17	12	1	14	6	3	11	4	13	6	13	13	24	14	4	3	10	17	5	5	2	18	12	2	8	6	11	29	11	10	16	5	5	21	6	8	3	11	18	2	23	5	6	14	6	17	1	5	1	17	3	6	2	7	7	4	10	2	8	2	5	2	8	0	5	4	3	1	12	4	9	5	2	0	1	0	2	1	1	0	0	2	6	1	1	0	0	0	1	1	0	3	0
ne0031	4184	3383	2243	2248	1856	2562	1907	1867	1705	1984	1793	1876	1878	1838	1331	1785	1669	1341	1316	1506	1179	1558	1178	1469	1222	1144	1266	1338	1159	1315	1043	1199	1268	1396	973	1009	1310	1080	1030	731	989	1093	789	1122	1112	1246	1301	1114	969	1073	1183	1040	911	1021	951	1133	824	780	883	903	1105	988	666	733	980	882	1215	996	946	797	762	755	817	670	709	834	995	846	845	685	1011	648	1012	717	726	980	712	876	854	791	681	672	1034	571	686	687	929	776	741	811	830	681	618	896	810	837	624	1010	640	777	627	768	1036	1003	943	620	943	764	583	880	651	915	510	585	609	772	636	596	899	918	781	717	572	453	662	482	586	559	849	622	689	812	916	544	442	731	725	467	611	580	738	553	737	563	593	534	635	590	855	697	651	549	720	688	627	561	577	542	412	573	566	573	752	666	815	479	610	815	550	435	836	542	584	532	533	362	521	504	494	570	368	588	559	718	582	510	480	814	461	631	454	561	443	597	346	658	505	537	559	660	820	599	422	551	440	591	560	378	518	486	434	450	370	491	495	512	485	488	477	464	392	495	462	372	570	380	416	491	475	526	549	486	564	467	384	560	581	540	468	353	690	383	476	449	568	746	449	473	467	397	382	437	387	453	353	451	424	361	406	296	516	427	615	591	617	378	393	447	430	433	280	413	406	256	402	236	382	412	407	438	437	541	385	459	517	362	489	426	384	414	359	294	386	349	383	336	424	466	343	400	382	367	406	445	315	313	382	302	491	417	481	371	451	331	452	373	381	446	397	364	388	495	426	376	398	370	427	290	401	459	450	435	365	360	520	315	337	341	328	353	424	293	281	343	370	497	334	331	352	283	360	295	328	399	358	396	381	301	415	329	347	352	389	403	388	255	283	293	429	511	352	329	322	470	316	398	355	278	357	382	325	466	372	258	439	390	248	322	220	395	302	266	460	387	354	249	290	308	421	278	341	305	322	405	308	232	336	325	326	357	351	233	283	334	388	246	327	322	297	286	299	313	210	269	368	335	249	277	246	310	328	204	320	251	251	304	314	232	262	347	272	301	330	300	240	271	288	309	177	315	364	366	193	255	202	263	283	297	271	309	311	317	275	299	378	256	285	294	222	238	279	210	331	284	302	184	313	346	276	235	204	245	234	240	253	302	258	260	291	371	232	288	299	262	298	295	203	222	311	339	296	259	295	249	310	268	247	314	283	426	262	294	223	251	250	272	210	250	213	276	251	268	324	248	245	340	226	279	171	208	257	228	307	274	198	163	203	202	220	322	191	185	310	305	251	234	271	252	296	251	310	267	236	301	373	263	216	243	222	234	286	168	178	248	248	264	215	294	265	246	218	253	273	185	249	288	250	209	230	224	247	209	276	162	221	302	253	212	302	222	242	348	210	295	232	234	189	228	220	249	196	233	197	144	186	164	217	257	230	208	140	269	192	164	218	232	184	199	204	188	289	187	200	187	210	168	196	204	230	259	182	151	168	268	173	186	174	230	182	253	201	205	243	226	229	193	215	205	231	132	219	246	236	274	178	219	242	160	222	210	126	186	198	238	232	196	193	181	272	208	195	169	145	198	280	206	265	117	124	165	217	211	187	212	168	209	187	187	222	127	197	233	156	194	177	172	213	216	195	175	159	177	141	185	178	183	150	142	160	119	165	87	173	136	130	174	183	216	200	166	152	148	139	210	198	118	146	199	173	118	135	167	172	163	176	184	90	181	194	139	182	178	142	159	137	179	196	151	121	193	117	200	185	148	207	88	134	195	124	178	176	179	263	167	219	200	181	158	189	212	261	153	139	173	169	198	312	142	148	150	137	147	170	178	105	189	159	176	146	115	206	136	102	138	142	147	167	167	131	168	75	174	157	135	174	212	127	185	171	86	201	212	172	184	184	102	146	119	145	103	149	141	146	180	191	147	159	135	128	177	108	129	195	143	122	151	170	120	156	86	141	111	142	167	102	146	131	142	113	103	175	171	165	97	130	130	101	118	135	65	104	126	127	203	146	92	160	117	148	117	118	158	114	176	134	175	248	108	114	164	113	125	122	151	132	185	148	133	97	156	132	123	117	109	95	125	156	127	68	106	138	136	200	128	125	106	97	138	156	124	105	213	120	168	129	110	162	136	118	98	116	107	122	73	122	104	103	100	91	134	68	139	134	181	127	135	147	140	153	119	151	103	84	90	118	124	110	129	100	140	142	125	117	129	89	75	141	148	126	98	118	120	134	93	109	116	183	137	107	138	97	128	93	108	104	100	118	120	102	81	90	142	71	132	103	134	79	111	188	95	119	139	71	105	137	134	139	103	118	137	110	113	117	108	189	115	109	101	114	119	113	104	113	73	101	91	152	103	92	103	73	76	99	120	135	99	135	75	132	88	102	93	123	110	96	56	104	78	114	104	100	97	80	112	178	84	110	82	118	95	100	105	118	105	122	107	95	132	93	151	84	122	144	77	136	118	139	74	91	101	104	100	90	145	81	99	54	91	132	58	82	84	109	118	127	85	57	79	173	85	76	122	93	83	95	111	102	79	70	138	59	75	62	139	120	96	92	118	108	60	67	101	91	128	43	84	128	81	76	98	84	78	124	70	68	101	114	92	102	83	72	51	98	64	92	85	63	79	81	96	85	70	75	56	104	91	78	105	91	124	122	104	32	97	51	68	36	66	70	74	93	102	80	134	68	64	91	79	62	86	119	81	99	42	117	57	76	63	82	87	95	95	73	115	103	83	98	101	69	106	123	66	48	106	62	58	70	78	31	108	69	90	43	99	86	115	44	34	79	67	87	71	91	98	70	89	72	84	49	84	75	63	49	73	117	64	68	36	59	62	96	54	51	63	60	52	63	74	82	33	59	60	120	74	44	67	49	79	56	41	80	50	28	105	46	147	54	67	132	57	80	81	105	64	80	72	57	71	45	72	48	46	59	66	82	45	71	59	68	72	89	118	85	105	57	126	104	84	62	84	64	52	103	108	34	42	85	84	68	90	53	51	38	20	53	50	47	60	68	40	44	63	58	40	36	95	40	46	60	73	39	82	69	78	38	51	58	47	55	70	87	78	60	34	39	65	64	38	38	38	61	33	80	53	56	60	39	40	39	45	74	57	69	33	83	69	111	87	44	51	61	63	68	50	80	62	74	38	43	54	51	45	39	31	38	59	28	81	58	90	56	54	48	53	124	80	23	41	25	45	43	80	71	46	49	45	36	61	58	82	68	40	63	47	55	38	44	57	41	71	99	46	48	48	49	32	22	54	59	72	48	41	39	58	23	46	48	31	55	125	47	65	38	26	46	40	59	35	80	37	99	55	47	67	46	40	55	21	31	62	34	38	92	35	35	30	30	48	36	29	41	60	37	34	36	64	51	27	38	35	44	30	67	27	32	47	26	29	91	52	32	57	36	23	53	44	39	55	32	63	35	24	32	34	28	33	32	37	35	47	67	53	58	26	33	24	20	28	46	35	49	34	28	46	19	48	37	24	37	25	30	40	62	58	10	24	28	50	73	39	64	31	32	26	31	49	27	28	52	48	32	46	45	35	15	32	23	41	30	24	42	33	30	25	21	14	25	54	26	26	35	54	26	22	39	41	24	21	34	38	24	27	22	31	23	39	15	55	19	85	51	24	65	58	23	47	36	14	24	30	31	23	29	19	28	17	21	25	11	18	27	19	27	37	27	13	18	20	29	28	52	43	19	26	42	11	18	27	27	20	25	18	4	29	49	28	26	30	17	31	17	18	20	25	34	27	16	16	32	38	16	21	22	10	18	31	12	30	26	25	27	7	16	27	12	34	18	9	37	19	25	17	19	10	16	21	21	14	10	25	12	14	16	10	15	26	17	11	6	11	36	25	28	16	11	10	17	12	7	5	22	9	28	31	10	20	24	20	18	23	10	8	13	15	10	27	5	88	12	4	19	21	19	17	10	11	7	17	11	10	13	9	29	13	7	12	4	17	16	8	11	4	12	19	6	2	16	2	17	11	11	5	9	12	4	12	4	9	7	11	7	13	12	11	1	5	3	5	2	14	7	4	4	12	11	3	3	18	1	10	11	11	4	8	3	1	6	6	9	5	3	8	1	8	6	2	2	4	4	4	7	0	4	7	56	2	2	1	1	0	0	0	1	1	3	0	3	14	1	2	2	0	3	0	3	1	1	0
ne0032	3627	3016	1656	1423	1015	2342	1893	1633	1187	1536	1102	1618	1508	1660	1225	1417	1561	747	1241	1315	893	1397	885	873	853	870	911	1191	1006	1027	734	954	984	1249	984	902	1122	724	738	855	842	965	613	793	943	1119	1082	1122	1203	872	1046	775	428	565	766	1068	403	497	778	504	929	605	428	498	811	821	910	594	648	492	605	573	732	566	562	456	652	600	741	533	884	644	731	612	473	737	450	591	603	678	594	611	787	454	428	587	800	451	705	599	681	568	446	936	555	612	572	828	726	653	563	682	816	782	759	554	788	766	356	742	520	847	388	637	609	517	598	374	777	697	517	645	349	378	427	302	436	372	723	520	516	928	442	453	419	606	591	316	544	549	682	350	658	505	512	329	567	376	767	432	456	429	528	538	562	343	440	434	242	441	580	347	605	651	635	401	407	631	386	264	434	413	354	400	304	244	332	529	319	417	381	557	461	506	344	392	396	641	444	429	480	262	284	404	285	617	359	605	556	485	664	482	451	554	493	344	284	227	451	287	282	320	300	560	389	407	466	335	377	295	359	491	409	287	413	328	338	296	425	318	550	283	450	374	242	382	492	352	396	387	311	318	401	278	512	584	302	355	341	329	287	351	354	432	245	403	627	294	241	324	375	344	388	319	429	288	374	404	384	263	231	305	262	202	228	172	350	288	337	522	308	584	183	344	461	222	316	306	396	310	320	154	363	314	427	237	289	290	441	224	190	320	216	271	279	205	419	266	317	262	363	341	350	262	265	271	362	303	335	256	264	575	330	279	291	376	412	238	334	302	269	446	387	293	471	270	367	274	193	219	266	264	267	312	237	448	291	275	168	155	296	225	221	235	306	326	240	268	403	395	195	162	278	312	257	213	273	276	308	274	209	343	263	458	266	264	181	233	308	248	234	251	307	238	266	309	193	201	192	279	318	201	398	378	385	146	245	247	327	214	180	234	246	409	351	225	300	304	283	380	334	122	247	365	363	187	392	260	187	232	177	238	182	239	257	308	214	228	238	244	311	142	227	224	203	236	204	205	175	295	240	233	259	231	146	129	255	218	157	289	312	191	155	250	135	180	140	207	187	218	141	359	227	228	323	212	309	182	109	226	157	132	292	176	247	168	228	233	188	196	127	191	127	165	151	220	162	237	187	336	147	252	312	169	227	212	112	183	374	250	187	208	253	165	210	154	197	211	197	206	180	147	174	194	155	190	250	213	229	210	197	273	253	166	230	188	172	309	120	181	172	192	158	224	124	136	180	91	164	240	188	144	241	166	169	247	238	162	283	183	198	204	210	161	161	200	145	191	109	149	188	155	76	114	178	115	131	247	211	176	164	176	167	142	266	174	131	219	145	250	200	251	172	105	149	128	220	131	233	210	196	175	150	170	157	146	156	112	112	122	129	201	132	87	177	80	147	193	266	125	143	132	132	183	247	197	143	210	181	145	172	129	167	148	128	127	104	176	119	154	159	191	142	122	133	160	110	245	123	141	98	169	210	154	148	175	211	150	136	97	229	178	117	149	144	208	169	148	144	215	62	76	169	126	180	120	107	131	170	119	114	136	139	114	87	214	174	76	128	74	106	142	197	144	111	148	241	141	249	62	146	196	107	115	200	173	184	147	146	142	137	155	142	183	160	134	229	117	154	128	218	66	143	96	71	86	117	177	137	124	160	120	131	144	197	84	105	134	114	106	137	98	149	191	186	115	73	123	188	105	98	121	93	160	109	127	190	145	109	89	150	164	108	117	112	70	98	236	94	130	73	149	192	105	103	114	142	87	137	143	188	188	159	109	138	115	151	209	85	98	144	159	148	83	83	178	174	195	108	90	144	93	76	109	189	161	114	144	124	130	73	98	188	68	92	261	98	111	121	59	256	176	84	127	139	101	143	100	111	96	58	71	103	120	119	112	147	81	59	94	104	91	104	94	82	66	111	80	126	58	78	81	172	132	92	75	118	93	65	64	75	132	158	88	128	77	72	94	80	52	90	88	87	206	74	78	153	108	69	79	106	151	105	105	165	96	194	62	107	152	86	102	70	94	95	149	183	145	86	152	115	142	95	114	103	71	229	118	65	69	65	103	121	130	97	142	46	141	160	50	124	175	70	134	98	72	119	173	84	55	39	81	125	66	89	91	59	129	67	143	42	121	71	94	94	131	86	109	64	171	110	95	32	114	72	76	52	87	79	43	142	78	135	134	68	57	125	110	80	48	77	127	125	124	86	54	102	98	144	162	115	86	70	91	59	98	100	66	56	112	104	132	49	67	48	117	81	133	94	138	53	137	49	129	89	97	83	56	64	82	123	121	62	56	155	96	49	52	71	119	123	91	117	35	105	69	73	86	114	95	77	51	133	127	108	75	103	32	96	88	83	75	80	94	30	30	118	37	135	117	68	90	126	96	77	46	65	82	84	69	106	69	63	71	71	114	134	60	72	84	62	69	68	43	54	99	97	46	86	128	73	125	51	132	43	83	24	95	138	66	62	72	56	71	90	43	25	56	82	75	93	82	111	92	63	73	84	63	67	104	52	99	29	105	139	38	76	62	37	64	53	57	84	107	36	74	80	76	60	101	52	57	107	115	50	46	97	47	62	67	56	40	44	55	69	64	49	49	38	42	75	28	46	35	86	75	57	95	82	84	78	52	44	56	37	38	25	77	58	88	43	63	34	111	47	42	64	63	29	39	68	49	54	66	56	33	28	101	92	75	72	53	35	97	61	80	95	73	38	114	73	89	29	96	31	35	90	39	39	77	53	48	35	67	56	86	39	43	54	51	119	69	90	74	42	50	47	72	34	69	64	57	53	45	51	25	30	26	40	36	66	39	73	39	49	45	46	46	42	42	73	25	79	76	19	56	49	59	42	33	71	24	35	52	26	46	71	67	78	49	80	61	79	42	124	73	40	61	27	32	41	28	40	45	75	29	80	35	38	31	77	60	51	44	67	56	37	54	44	57	55	47	53	80	40	17	67	52	56	41	46	23	26	19	41	27	23	51	67	31	33	67	59	67	58	51	38	28	75	54	51	69	60	54	18	28	31	28	30	48	29	63	49	49	43	27	35	34	51	31	24	46	43	39	55	48	36	27	54	75	107	49	71	35	43	40	61	59	29	23	73	42	37	28	59	36	60	43	41	73	43	23	32	55	27	36	37	49	51	93	45	52	23	40	76	24	30	46	39	38	62	76	57	21	57	45	17	42	45	116	39	33	48	38	74	31	33	68	30	42	91	35	29	31	43	29	40	72	51	26	27	58	30	60	20	23	48	19	38	28	25	18	27	25	52	29	54	40	19	14	38	29	30	71	23	27	48	35	17	22	34	32	84	32	39	31	43	26	24	33	27	57	45	41	36	43	24	53	22	24	29	18	28	22	18	27	29	63	51	40	16	34	24	39	20	59	27	29	18	25	29	16	43	17	16	44	29	25	20	31	39	52	31	23	17	13	44	26	41	52	25	30	34	26	14	55	18	27	35	12	37	43	47	26	7	22	28	46	33	36	54	24	16	27	40	16	26	26	66	46	22	18	25	29	16	45	14	12	29	17	23	46	38	25	15	17	16	19	22	16	5	38	14	20	25	34	17	12	71	41	45	17	11	20	17	15	19	63	13	77	13	19	14	62	8	34	27	13	10	32	21	9	14	31	20	9	35	24	14	20	22	42	29	18	27	5	60	19	8	9	26	16	13	21	38	17	6	28	18	12	3	8	14	9	24	26	34	18	21	10	14	14	12	10	21	18	11	5	40	39	10	15	13	10	24	12	13	69	3	8	10	5	27	8	10	17	9	17	50	7	7	14	9	4	12	10	12	13	52	2	7	22	14	14	11	30	6	8	9	12	21	31	7	11	4	9	5	10	12	4	11	18	33	5	6	4	10	45	4	15	18	14	11	20	12	19	3	14	6	15	5	5	29	7	5	8	2	13	13	2	10	11	10	11	11	1	8	7	4	8	5	5	3	9	12	3	19	4	14	3	12	7	10	8	10	7	4	4	12	10	9	6	8	4	1	3	5	5	1	11	9	9	2	2	7	6	9	7	3	5	20	7	7	2	1	3	6	7	1	0	4	0	0	7	7	2	7	0	7	1	0	5	2	3	2	0	0	3	0	1	1	1	1	2	1	1	2	2	0	5	3	0	0	2	0	2	0	0
ne0033	2972	2420	1472	2019	1877	1397	1476	1225	1426	1021	1362	1150	793	762	802	845	714	990	1333	824	831	996	953	993	1005	856	999	758	1060	665	774	863	642	529	705	564	651	1008	735	490	718	598	898	852	591	459	505	548	638	553	564	706	620	659	844	536	921	798	536	515	513	641	734	555	513	672	412	749	645	746	410	708	597	441	657	899	527	532	602	411	506	571	452	566	770	402	589	595	659	525	385	575	408	314	598	509	399	420	529	453	456	366	337	365	641	421	486	321	485	734	442	587	321	313	379	521	343	601	604	276	307	305	590	445	565	495	388	305	308	273	596	285	496	398	420	559	428	403	265	584	308	383	478	530	477	407	633	583	508	304	434	467	401	263	428	537	409	369	270	309	430	384	321	389	421	507	466	279	451	324	459	414	369	337	216	306	519	188	452	426	442	331	400	364	324	372	275	357	345	482	325	371	476	438	386	499	465	237	304	363	388	385	278	384	321	355	254	329	219	398	203	493	361	225	357	339	371	526	331	533	623	206	440	322	292	419	401	340	317	378	466	408	546	246	451	209	402	555	413	382	442	498	428	410	441	333	302	287	301	342	406	453	345	399	333	154	311	308	340	488	192	319	172	263	386	225	261	367	290	369	351	247	354	285	387	442	330	295	288	316	259	278	342	280	402	295	177	277	381	231	433	310	491	205	347	279	282	213	166	295	376	306	316	240	292	475	314	341	188	442	602	247	438	450	213	316	345	391	227	226	296	174	238	344	364	256	221	295	320	323	426	243	210	403	277	304	324	236	315	277	309	325	277	195	234	248	339	199	288	193	275	338	428	170	249	270	323	304	267	278	248	254	551	312	275	319	291	219	198	282	235	283	206	268	255	298	190	178	281	300	263	244	246	180	199	234	461	274	242	263	207	370	331	189	149	259	230	207	202	175	255	302	258	224	240	259	278	325	247	357	266	265	245	206	249	153	171	312	255	296	250	221	195	159	143	268	223	250	211	219	216	204	260	280	281	167	264	246	162	221	284	233	185	129	165	180	167	118	186	235	204	163	260	203	285	222	199	208	264	139	222	224	236	243	168	287	272	241	204	211	332	224	197	181	267	155	175	224	238	257	203	214	253	220	195	200	233	205	172	150	185	134	208	297	362	178	178	131	189	239	188	213	213	291	188	201	241	171	177	211	167	187	153	175	167	230	213	217	182	213	222	214	261	187	201	169	195	72	177	167	137	204	202	192	285	207	200	148	259	126	133	159	283	164	180	212	204	270	218	162	164	155	246	165	155	193	168	231	263	157	197	227	177	202	232	217	158	199	214	175	79	84	238	207	130	216	159	91	146	260	313	139	147	169	148	151	176	172	164	206	161	139	125	247	153	272	197	117	155	140	165	226	204	147	153	156	238	189	218	193	140	231	244	165	122	210	221	175	302	258	139	236	133	132	191	130	144	98	163	147	167	182	168	179	227	250	193	142	231	182	66	211	153	173	204	237	197	100	240	133	110	119	170	178	132	143	179	149	213	154	118	166	161	169	114	112	146	71	117	172	113	226	154	122	151	119	143	205	148	195	154	118	139	161	220	176	169	123	112	175	183	89	200	112	115	196	123	89	153	197	103	153	135	179	170	142	168	157	135	140	135	173	135	105	188	128	127	156	80	86	141	135	107	242	181	164	117	164	129	225	128	176	88	152	158	140	202	164	117	132	169	118	100	162	93	153	105	168	121	94	148	112	146	108	173	121	118	137	185	175	147	115	109	138	178	143	278	180	188	63	165	77	82	130	150	121	95	266	114	114	186	124	95	140	125	157	139	109	143	104	145	141	90	140	109	105	95	107	139	103	154	124	179	102	115	65	112	97	109	106	163	103	87	82	138	91	95	109	136	185	154	112	156	119	133	105	93	140	135	99	93	123	126	98	114	91	106	132	72	86	122	116	102	85	91	110	142	119	135	169	104	69	70	126	79	93	61	113	230	89	126	110	143	89	55	88	129	65	129	120	91	106	180	142	104	81	144	71	110	124	80	38	84	126	68	195	132	187	93	78	151	81	173	90	155	86	66	96	98	86	88	93	68	72	140	113	89	68	100	64	155	107	115	101	97	161	103	89	130	143	114	107	78	87	107	152	124	54	113	141	205	84	92	87	117	85	79	83	92	110	101	93	133	139	96	156	149	152	139	63	84	135	182	98	71	108	94	106	98	108	146	108	106	90	124	120	127	75	77	89	63	67	79	138	84	108	103	101	130	120	44	80	64	122	176	101	79	114	92	119	87	137	76	125	66	72	91	79	168	96	96	86	79	113	137	88	128	130	151	110	87	106	123	210	74	119	208	94	96	83	62	92	113	108	129	67	72	102	52	96	68	105	77	49	57	71	85	130	108	60	110	79	65	100	81	108	57	84	69	76	50	81	60	77	95	107	93	90	53	115	98	57	86	58	105	66	102	76	63	86	87	96	59	72	101	57	98	115	100	75	99	102	68	133	93	55	70	69	83	85	52	71	83	93	67	117	205	95	81	89	97	104	33	64	68	80	55	62	88	91	44	98	73	64	93	101	92	37	82	57	137	54	85	66	124	103	67	58	55	99	81	70	106	74	75	88	64	138	89	78	64	30	110	74	72	64	115	75	112	136	56	109	34	63	78	90	56	56	50	86	90	46	95	67	113	84	157	49	52	52	62	49	59	49	49	61	47	125	89	99	80	38	155	66	53	51	88	55	76	72	94	54	50	99	71	46	68	73	69	41	83	55	113	106	116	113	45	87	97	60	63	64	74	99	92	66	51	69	84	36	64	68	53	31	68	65	68	52	75	40	81	38	48	68	84	48	44	55	43	108	53	109	68	68	74	60	66	81	88	68	39	111	73	40	48	110	37	33	84	74	47	38	68	53	41	100	44	41	48	72	44	97	74	93	33	61	67	81	63	53	43	70	35	49	88	128	71	79	38	67	43	60	69	70	46	68	40	58	82	68	36	35	86	44	63	38	31	72	67	90	32	37	82	61	53	64	56	69	39	33	57	56	70	19	42	44	83	87	83	86	110	40	125	133	39	77	114	56	42	72	58	35	56	74	35	63	38	26	43	62	54	40	37	34	34	88	106	57	53	60	39	54	50	69	98	41	64	47	75	42	48	57	74	65	34	58	47	23	33	57	45	38	51	55	34	19	26	43	37	66	23	17	44	38	50	102	52	29	28	27	40	44	102	65	74	49	41	179	43	30	47	61	144	40	78	71	59	49	22	50	32	26	43	74	19	42	24	35	53	24	36	30	103	33	53	55	92	33	31	80	58	44	16	41	17	27	76	52	32	63	69	51	35	27	73	65	43	39	61	44	49	26	44	42	45	70	23	108	47	20	12	62	41	40	26	63	44	21	68	29	23	22	65	25	46	48	60	80	41	32	27	54	32	22	47	38	37	12	32	46	24	37	38	22	44	63	62	35	41	23	66	28	57	26	22	34	33	26	45	13	41	48	40	18	79	31	41	11	46	34	65	33	45	53	58	50	50	40	43	31	36	91	53	62	33	25	23	35	29	23	54	28	46	29	20	11	14	72	137	50	74	41	33	44	22	16	21	31	30	28	63	18	34	87	34	50	26	24	28	30	23	17	24	17	12	29	17	61	28	10	55	5	26	36	52	13	22	27	10	12	39	33	10	23	17	27	42	21	11	33	18	23	20	27	29	17	59	11	25	38	30	21	37	13	20	7	7	14	22	66	25	65	33	43	11	6	33	25	31	33	31	33	19	45	29	23	19	11	61	32	42	38	44	15	13	15	13	14	41	36	16	34	22	28	8	14	20	29	22	23	29	26	22	19	15	12	16	5	19	22	7	25	11	4	60	26	35	14	9	15	6	15	41	18	19	19	25	21	16	21	22	9	7	11	32	13	7	35	23	14	6	38	4	12	30	32	15	9	27	15	25	12	11	10	31	9	4	17	28	9	37	11	24	23	37	17	17	24	15	7	13	9	3	9	7	10	25	5	19	25	10	4	71	9	8	15	15	10	5	6	9	15	23	18	4	18	10	4	8	11	24	5	16	11	1	8	10	32	10	10	39	9	14	5	22	1	5	4	6	5	2	16	5	5	16	2	6	5	15	9	3	1	36	6	13	3	1	1	2	3	1	1	0	4	3	5	4	4	2	7	2	0	7	2	1	1	20	1
ne0034	1009	890	575	551	393	573	436	403	400	455	429	454	437	430	291	419	428	287	217	361	327	317	259	264	294	241	371	318	250	304	246	292	289	327	309	272	311	244	248	163	261	227	148	276	209	291	309	247	285	279	268	258	262	148	188	300	170	167	223	273	241	235	187	192	234	221	274	266	218	165	209	193	206	225	211	208	268	211	177	155	237	170	223	142	160	223	139	204	170	181	170	135	217	144	164	181	209	154	193	222	194	143	160	216	201	191	173	230	142	143	174	189	244	226	219	195	220	215	103	207	215	240	122	156	161	231	154	147	212	211	192	164	115	154	165	89	116	109	203	116	184	199	97	124	152	163	159	120	163	144	171	135	153	159	153	118	160	163	195	170	161	117	165	125	153	105	139	204	53	140	133	126	150	140	206	105	148	188	130	92	144	145	143	138	125	89	123	92	117	101	115	122	98	171	135	89	120	189	108	147	109	128	100	132	123	131	110	161	171	112	200	176	111	136	97	203	113	96	103	142	113	126	90	123	108	183	85	64	110	101	85	125	81	90	101	91	122	125	144	108	181	96	122	166	130	133	137	105	89	62	130	101	125	91	146	173	97	114	96	85	67	102	91	83	86	135	89	91	69	70	153	106	123	94	132	91	72	107	102	78	79	83	92	64	115	88	58	122	107	138	132	115	96	95	118	85	115	137	95	99	68	98	102	91	106	53	129	136	84	69	96	84	89	86	95	98	109	118	156	105	98	82	81	78	115	102	93	78	109	119	90	122	92	75	124	94	119	68	103	103	74	133	65	115	131	89	94	57	80	102	112	75	60	82	84	100	79	93	81	55	87	85	54	101	68	60	83	102	109	88	74	77	93	89	95	84	80	39	93	88	69	93	69	102	85	111	70	91	70	80	68	118	79	110	95	88	43	63	57	94	71	36	108	72	74	50	84	58	85	73	74	66	64	87	69	68	92	88	69	69	87	47	76	67	97	57	70	76	58	64	66	80	48	75	67	68	92	46	64	74	70	75	88	54	62	63	72	66	71	66	92	77	88	73	52	69	69	75	34	89	78	59	51	45	37	58	61	82	58	51	81	61	68	81	105	44	80	76	57	52	102	50	86	73	65	44	85	115	44	63	39	46	42	42	71	69	55	66	56	97	63	77	31	34	46	84	55	41	82	91	58	65	83	60	66	81	59	75	51	75	65	74	67	77	51	58	38	37	50	58	56	68	92	69	57	94	52	51	33	54	29	45	79	68	49	67	58	60	52	75	50	48	74	51	48	55	38	49	72	52	75	56	37	64	63	72	52	65	40	62	79	49	50	55	48	57	76	89	78	51	54	42	53	47	54	83	103	66	35	47	75	53	86	51	50	74	91	38	80	45	58	58	55	62	50	52	54	64	65	49	53	26	54	33	53	45	42	68	84	42	58	47	33	37	43	52	27	41	38	43	43	34	59	40	48	41	53	52	38	63	50	34	76	42	41	48	22	42	53	43	51	63	63	44	54	22	55	28	44	36	48	73	39	45	53	51	32	58	65	51	41	51	39	25	48	43	44	33	94	53	47	35	20	33	49	44	77	28	24	34	41	40	46	35	66	46	51	44	62	19	52	46	44	54	37	35	90	56	48	47	43	40	48	55	39	26	30	36	44	30	34	28	55	36	42	38	56	56	40	59	51	29	45	55	72	49	34	54	54	34	29	35	56	38	26	35	50	39	44	32	77	41	34	37	25	46	53	26	39	36	25	31	41	44	55	20	23	58	27	36	26	34	62	39	62	32	37	33	48	61	58	29	33	31	39	45	32	29	39	38	20	26	19	67	29	19	26	45	34	38	56	31	22	27	31	42	49	72	23	32	48	76	39	21	44	38	35	45	72	36	35	46	70	37	44	23	20	17	32	37	27	29	38	82	28	35	34	16	16	32	31	25	21	25	24	47	36	34	30	22	30	16	25	39	27	20	31	24	32	22	47	40	37	23	33	43	25	15	35	31	38	36	42	60	35	25	29	17	21	12	31	30	54	24	16	47	84	40	36	35	23	31	32	44	38	47	23	30	20	32	41	45	28	24	27	29	26	28	12	28	24	44	74	22	28	26	27	31	43	27	26	55	25	32	14	30	21	38	27	18	20	17	29	22	36	34	25	17	32	28	15	38	29	61	28	31	36	23	27	24	53	29	12	17	14	29	29	41	17	16	46	47	25	38	20	27	28	49	29	32	42	21	24	29	36	20	31	18	25	30	28	12	19	27	20	27	27	26	32	36	23	38	12	29	25	49	21	28	38	20	19	40	22	22	16	39	30	21	23	24	34	26	34	21	36	17	19	16	21	25	22	35	34	18	18	32	51	52	29	27	25	16	28	23	23	21	24	27	18	24	23	19	32	44	20	12	34	42	24	33	23	25	6	20	27	20	20	15	26	20	26	50	25	18	24	12	22	27	27	28	26	22	41	17	41	30	39	21	13	16	31	26	17	42	13	13	9	20	21	14	25	15	22	17	23	30	7	25	24	18	17	37	38	31	28	32	19	27	21	42	21	24	6	44	21	15	13	23	17	21	5	22	15	19	32	26	46	14	23	19	26	28	35	20	15	12	21	16	16	18	23	15	25	39	23	23	16	10	18	13	23	20	16	13	21	23	23	26	23	31	42	16	20	17	12	13	21	18	9	14	24	14	11	31	24	22	21	21	13	15	65	11	19	23	17	11	30	10	30	14	27	20	7	30	35	24	22	25	9	30	28	18	20	29	17	20	21	20	15	23	11	20	11	15	10	20	17	13	16	17	21	16	33	22	5	23	31	17	10	26	13	8	14	20	20	13	13	12	16	15	33	12	15	7	12	6	19	18	10	12	13	13	34	15	10	16	15	19	11	11	16	12	9	20	6	22	10	2	47	12	15	39	19	16	25	16	15	15	14	14	16	18	14	21	13	7	22	20	16	12	12	18	19	12	6	8	26	6	11	17	4	8	19	16	10	10	16	14	13	13	4	9	17	3	23	13	9	9	14	10	15	10	23	27	12	12	13	12	16	6	6	32	10	24	17	16	5	12	12	15	16	22	6	5	23	11	6	10	9	6	13	15	22	20	7	17	11	7	19	13	11	35	14	16	27	23	33	32	14	8	23	15	25	13	14	21	8	15	11	8	7	10	17	8	10	6	11	20	8	21	22	6	15	13	10	16	11	5	15	5	18	18	14	11	15	20	4	15	8	14	13	20	15	7	14	11	2	15	6	20	21	8	9	10	16	11	9	10	11	10	8	9	12	17	10	18	5	7	10	11	17	13	4	11	23	4	10	7	6	9	21	8	10	9	5	13	12	13	4	11	6	7	5	21	7	13	19	15	14	9	8	9	5	4	16	14	6	8	7	7	11	12	14	10	15	12	8	5	40	8	14	19	3	8	17	16	8	12	2	20	4	8	8	9	3	4	3	3	9	6	10	8	11	7	15	8	4	6	16	2	9	9	10	6	9	5	14	5	25	4	4	10	7	9	3	5	6	8	16	14	21	12	17	9	9	5	6	6	16	6	8	16	3	10	3	4	7	4	5	4	3	8	10	6	11	6	6	3	11	10	0	4	8	9	4	7	8	11	1	11	5	2	5	9	8	10	5	7	10	14	17	5	11	16	6	10	3	2	2	2	8	5	6	3	2	3	4	4	5	3	5	7	1	2	3	3	3	1	10	9	8	5	4	8	10	2	4	12	7	3	6	4	11	11	3	2	5	13	6	2	3	12	12	3	6	5	0	5	2	11	3	5	9	1	2	5	5	8	5	5	4	5	2	3	8	8	2	1	12	3	5	1	6	7	5	13	3	1	0	2	3	12	5	2	3	0	0	3	1	1	0	6	8	2	1	10	7	5	2	3	6	2	10	9	7	5	10	4	1	4	4	4	4	1	5	3	3	2	2	5	3	5	5	2	6	5	3	1	3	1	0	5	3	6	0	1	8	3	6	3	7	1	2	3	5	2	3	2	2	4	2	0	1	4	1	0	1	9	5	0	2	3	2	0	3	3	2	3	1	7	2	0	1	1	2	2	2	2	3	0	2	7	5	1	3	3	1	0	2	1	5	0	6	4	0	0	0	0	1	0	0	1	0	0	0	2	0	1	0	1	0	0	0	1	0	3	0	1	1	3	0	0	0	1	0	0	0	0
ne0035	3307	2756	1615	2080	2386	1524	1771	1252	1494	1102	1658	1200	847	827	870	1136	897	1189	1607	761	868	1149	1128	1052	998	1037	1116	850	1359	691	912	1001	750	546	803	632	667	1038	854	593	922	620	1134	1036	660	435	609	629	736	627	560	712	698	869	912	487	1047	779	584	582	577	794	856	566	526	791	452	927	762	798	445	939	718	474	845	1062	592	602	646	540	553	644	437	777	1019	412	703	649	778	583	510	496	359	394	686	700	408	614	811	567	516	432	369	371	799	423	607	323	534	755	623	801	314	335	384	631	311	579	687	273	339	341	617	556	690	508	546	449	275	286	575	403	461	392	464	660	557	528	303	579	385	429	597	490	522	462	648	569	596	466	488	555	386	368	477	700	518	496	284	389	495	508	295	348	461	553	518	261	555	347	543	430	393	321	180	322	572	205	553	459	547	420	436	379	381	501	309	409	412	606	403	430	539	437	381	581	567	211	300	403	418	516	340	442	322	415	372	366	267	503	185	491	503	323	378	295	419	537	335	567	557	265	461	384	303	391	428	386	409	417	526	464	608	315	581	237	453	615	387	464	431	480	560	405	487	380	327	372	412	375	457	569	383	525	308	134	400	427	421	562	221	252	238	299	458	267	329	437	328	400	374	242	394	310	380	472	393	394	324	337	296	327	375	305	407	282	242	335	434	360	451	274	534	297	390	357	270	265	181	320	425	387	336	295	357	492	332	283	232	397	545	282	475	633	209	340	381	330	256	271	339	189	300	366	392	255	233	421	307	387	509	265	216	295	356	368	374	240	349	289	348	364	327	191	243	290	383	228	306	192	318	454	460	237	264	328	356	364	348	361	228	290	586	388	322	350	280	234	226	345	310	328	259	319	264	260	226	187	306	388	365	289	295	163	317	243	487	340	269	316	232	407	429	140	200	337	292	323	241	182	226	262	342	268	289	333	335	345	251	420	377	288	303	216	294	188	235	293	275	473	290	264	216	250	161	257	316	302	251	284	210	192	332	331	352	222	261	276	181	241	230	324	224	192	212	216	209	169	169	251	177	184	366	246	327	278	219	221	273	203	236	261	263	309	259	331	307	199	228	306	519	265	266	177	259	202	241	285	272	319	234	259	210	281	253	216	274	299	175	186	204	151	237	343	385	172	191	209	182	210	222	221	247	354	188	270	272	198	205	282	208	174	224	246	155	194	230	253	246	229	207	246	226	209	223	158	269	107	200	248	176	215	231	176	271	239	263	213	317	156	165	186	346	194	273	290	190	343	227	226	200	234	336	157	144	207	167	245	387	209	229	204	292	193	328	359	188	265	197	206	92	106	295	209	148	182	253	107	164	301	294	131	141	180	251	163	192	190	155	194	229	111	120	239	191	295	238	166	178	139	217	230	178	222	163	229	225	215	261	260	145	143	241	185	95	253	257	185	284	253	141	274	141	123	255	153	195	126	171	171	222	161	222	170	246	253	222	186	289	237	86	289	118	179	238	244	241	135	232	192	92	187	174	189	134	141	285	127	234	222	148	229	236	206	117	132	232	90	121	217	161	247	146	171	144	215	182	207	189	177	221	194	177	218	265	214	139	127	74	185	254	98	218	185	122	218	161	82	207	232	140	190	152	210	228	171	184	174	146	127	154	160	146	111	234	227	142	164	121	108	151	151	153	224	186	196	169	167	121	234	165	185	106	153	145	151	175	194	124	168	159	163	124	147	131	156	139	200	160	116	173	122	176	172	223	133	173	120	142	271	188	160	110	190	225	173	306	173	161	106	186	109	102	106	196	205	132	311	174	180	159	168	94	135	135	235	273	119	170	162	190	177	114	182	140	122	112	99	169	129	132	141	166	194	108	102	131	75	114	118	154	107	88	178	143	110	136	144	125	207	122	86	174	165	138	137	105	185	137	83	133	141	120	90	141	107	144	195	91	107	158	136	98	104	143	166	128	117	109	196	113	77	110	153	118	119	113	109	201	93	116	104	170	71	100	120	162	98	132	136	118	108	166	167	140	85	203	81	126	146	78	60	91	137	74	148	136	195	105	79	155	100	153	98	137	151	78	92	176	111	88	84	57	76	168	104	148	76	163	60	164	97	99	105	99	176	130	109	103	162	147	93	88	135	134	164	110	54	158	192	280	120	153	131	137	79	69	73	112	100	144	145	185	153	88	186	248	116	160	73	106	102	152	133	75	157	170	119	104	134	140	133	98	86	124	119	133	119	73	102	86	84	59	128	105	122	90	124	121	127	53	90	98	137	164	111	106	146	82	138	107	135	93	105	109	99	103	85	215	75	126	94	77	120	142	99	146	119	153	103	115	130	109	196	128	105	213	155	87	92	58	111	135	113	181	91	93	67	73	82	77	94	61	71	88	95	96	133	71	82	106	122	57	121	117	118	62	112	80	97	94	99	97	81	76	126	110	118	64	120	84	78	77	90	70	41	87	124	127	126	100	112	62	81	110	83	100	123	134	116	103	83	106	179	90	76	99	115	104	103	60	92	112	94	122	106	133	107	72	112	117	121	59	71	83	80	72	55	110	106	41	93	120	51	144	144	98	70	118	71	140	63	119	98	134	95	87	83	65	92	94	68	96	99	100	96	102	136	78	47	73	50	97	85	79	70	106	97	111	135	69	105	29	61	114	100	91	86	88	110	79	76	88	115	94	129	145	84	142	66	71	66	78	41	50	104	51	130	115	108	110	60	124	53	48	85	91	60	74	84	121	64	49	84	64	63	65	119	40	82	108	46	101	117	75	137	58	78	85	54	126	57	70	162	94	93	93	67	74	59	45	80	62	65	147	78	70	48	110	58	82	49	63	59	140	57	51	86	46	154	49	96	114	60	75	66	72	65	96	52	52	114	92	53	46	62	39	49	98	96	61	52	66	61	46	65	50	80	59	91	31	112	61	116	41	102	80	43	104	54	25	82	63	83	124	129	55	100	61	72	44	77	80	86	48	99	83	53	97	79	37	41	126	51	96	47	41	96	83	99	24	50	67	89	33	103	48	108	48	24	66	75	79	34	64	38	87	90	43	62	112	28	121	157	65	84	104	69	65	100	73	25	85	85	57	68	59	49	73	111	70	49	33	28	53	70	91	68	62	56	58	46	41	40	87	58	76	32	90	91	70	41	65	58	60	67	72	28	17	55	56	62	26	86	45	42	37	70	50	75	36	34	79	35	80	135	39	47	29	23	30	44	78	73	97	40	29	100	39	42	65	89	191	46	54	54	75	44	37	62	18	63	67	88	27	39	28	67	49	43	71	52	99	34	39	72	82	38	39	87	72	72	37	40	30	30	64	62	62	49	94	52	33	34	68	64	70	38	51	81	34	46	63	44	39	103	28	151	85	26	25	60	24	33	20	56	46	24	63	38	36	19	41	30	45	42	73	71	51	51	34	68	36	33	82	59	52	29	18	70	24	50	11	15	49	32	55	76	54	17	46	34	48	49	44	27	46	31	45	30	62	36	31	12	82	24	39	22	19	43	56	38	34	75	68	78	55	64	55	46	60	70	50	70	26	51	28	27	31	38	38	38	59	36	20	16	29	54	108	55	72	30	52	40	24	32	24	21	28	40	89	21	45	66	44	51	40	36	31	28	32	16	24	15	6	42	32	53	53	10	65	29	16	36	91	32	32	27	35	28	40	62	23	34	27	32	46	37	14	37	48	27	26	26	50	8	59	8	38	38	20	19	28	19	30	34	13	14	28	55	27	62	19	47	21	12	60	44	23	38	21	24	23	40	38	20	29	6	33	22	43	37	52	17	24	23	23	29	22	45	21	30	25	35	9	17	14	53	17	39	34	71	37	19	10	31	11	14	23	30	7	20	14	4	87	47	46	19	12	13	9	4	33	28	20	17	31	26	24	18	37	7	7	15	26	18	3	22	30	16	14	19	5	18	21	18	35	12	19	15	21	17	8	17	39	5	8	23	52	5	14	26	27	18	18	58	17	17	12	5	19	10	10	9	13	8	28	11	19	34	33	14	40	15	9	10	28	12	7	7	12	26	28	12	11	48	10	8	4	22	12	13	20	10	1	16	14	10	18	8	72	9	9	5	15	5	3	4	10	7	6	20	9	19	14	10	7	1	4	4	10	4	41	15	9	1	4	4	1	4	4	2	1	4	2	5	5	10	9	1	11	1	8	3	0	0	16	1
ne0036	2070	1766	971	1261	1297	972	1022	832	936	605	903	756	621	576	652	598	557	623	1057	632	658	671	697	429	608	629	645	588	689	514	516	644	428	351	544	413	365	651	460	421	460	368	717	564	426	286	324	428	508	331	312	468	330	522	580	373	460	415	450	261	436	413	489	366	312	517	274	473	501	483	283	558	481	303	486	748	342	421	429	299	310	431	233	349	596	224	466	420	380	381	326	427	236	290	372	402	177	375	470	309	349	246	206	249	413	251	307	200	379	471	368	489	221	209	214	411	192	386	617	154	255	188	302	382	407	326	364	230	172	186	328	244	276	266	309	326	367	282	148	341	209	250	245	293	303	311	356	275	383	315	231	339	301	232	311	437	326	257	163	177	301	272	161	263	317	325	358	239	471	183	285	238	218	262	111	257	361	112	279	251	176	185	224	280	140	438	153	308	216	391	300	314	255	218	182	361	293	143	287	218	289	315	198	261	129	273	187	274	169	332	126	291	314	192	219	188	193	379	232	369	476	127	341	305	158	242	291	216	251	206	364	304	303	232	359	143	241	420	330	240	264	211	286	223	286	274	191	210	195	221	225	250	225	212	215	88	160	226	253	289	174	172	154	249	330	138	235	183	181	263	233	157	196	173	215	288	253	206	214	197	159	185	181	138	215	222	161	157	257	253	356	234	348	198	218	205	142	152	124	235	198	134	204	149	248	244	220	174	241	242	408	192	339	296	162	182	286	172	121	158	155	156	175	216	252	169	127	178	172	229	259	157	157	121	179	240	254	114	195	167	168	267	133	77	167	228	250	167	168	135	179	225	306	156	179	206	170	201	191	218	130	259	158	214	159	230	182	157	187	238	245	247	197	158	147	166	174	151	184	208	182	150	185	116	170	143	199	300	180	177	151	136	185	100	63	202	174	136	143	84	156	85	268	185	199	139	146	185	155	312	202	172	203	132	232	138	114	168	174	227	183	219	139	120	104	138	213	170	149	150	110	98	147	200	209	148	222	188	124	177	135	178	156	105	103	126	137	141	156	161	129	66	152	138	235	141	129	151	170	116	132	194	173	179	141	162	122	87	191	145	106	203	170	108	161	113	132	150	149	118	122	109	125	178	135	141	144	125	88	102	99	97	175	232	254	135	116	113	145	128	97	153	154	142	88	179	133	134	132	146	113	125	122	152	100	129	135	156	95	110	107	146	188	183	111	95	177	91	180	127	109	125	119	98	126	168	141	141	155	151	115	131	286	128	128	186	125	141	111	137	121	136	137	96	122	210	128	143	229	97	131	111	107	116	199	188	132	148	171	123	42	128	109	121	76	108	163	64	115	139	215	83	86	113	161	99	92	122	82	109	141	119	38	209	102	149	134	78	115	94	128	135	126	70	96	168	114	104	123	99	68	145	210	106	73	148	128	81	175	226	79	178	104	87	128	103	76	56	87	120	102	59	103	133	137	191	97	113	240	124	51	254	62	132	118	142	120	82	196	115	77	95	132	130	77	87	133	87	203	97	75	116	154	91	91	87	157	74	52	108	114	166	91	98	113	85	99	153	79	134	102	118	95	100	97	111	108	73	63	123	184	81	129	85	76	102	104	62	111	114	78	142	88	80	149	91	97	108	82	68	93	114	92	66	95	110	112	63	106	91	116	111	97	187	90	143	93	85	68	127	98	132	66	102	115	106	88	134	84	115	101	131	77	100	76	96	83	71	92	64	58	60	111	128	102	72	106	88	64	172	99	84	62	113	121	100	174	126	75	85	93	81	64	99	122	78	71	91	79	113	96	126	72	102	76	160	99	94	97	101	119	179	81	108	51	101	75	60	100	104	75	106	125	116	92	56	72	62	57	62	51	50	67	98	78	78	81	91	62	77	103	39	66	76	83	59	57	112	73	60	56	93	70	106	92	68	94	94	53	31	97	85	55	65	40	37	54	73	94	120	114	93	61	82	69	53	80	76	179	39	68	68	96	44	88	91	85	59	72	76	60	56	102	91	46	73	114	56	86	133	74	43	54	48	57	99	98	167	52	61	114	83	89	47	87	77	42	60	102	95	53	58	46	38	107	54	88	61	102	20	113	38	59	54	52	59	60	73	83	80	58	56	72	73	75	82	65	43	112	95	111	97	74	55	96	97	58	75	67	44	131	97	94	78	48	144	95	75	100	53	72	60	93	93	37	92	145	72	55	50	92	70	89	54	52	49	106	70	53	27	58	67	66	76	57	68	52	59	84	85	35	28	32	76	88	55	63	56	34	77	49	89	32	138	64	65	63	69	97	47	112	78	77	74	72	65	126	70	108	57	65	80	39	109	52	79	139	91	54	52	58	46	89	58	76	50	47	45	40	54	53	62	42	49	56	54	62	44	52	50	49	97	18	70	78	46	53	35	56	46	68	95	47	39	38	61	51	96	39	58	56	37	32	51	27	15	44	89	110	42	70	88	28	45	81	43	63	58	71	71	58	82	96	92	51	38	67	52	71	81	31	61	71	83	50	59	62	77	35	63	73	71	36	41	61	57	50	26	54	47	22	58	49	24	86	88	66	17	86	24	76	39	116	51	32	54	41	41	43	60	49	40	52	64	53	78	55	75	53	32	45	35	63	50	56	84	70	38	69	111	36	54	21	65	59	74	53	36	47	57	54	37	26	33	70	88	33	24	48	37	74	48	50	24	36	62	25	68	80	39	64	38	127	41	42	47	78	33	32	67	68	38	31	64	40	70	40	45	35	37	52	44	54	45	84	71	37	39	33	28	40	21	46	56	58	69	72	66	36	36	39	46	39	28	57	56	41	27	58	37	32	42	28	19	55	23	25	29	49	33	25	65	61	31	72	33	15	55	79	32	40	44	37	32	41	21	29	37	49	53	32	43	38	46	23	44	38	46	46	29	17	72	34	82	21	43	35	35	32	44	19	49	44	37	38	42	44	77	35	43	45	43	50	28	34	49	35	24	47	41	31	18	41	29	37	41	47	55	34	34	12	25	26	65	20	32	45	75	35	17	36	35	31	22	33	34	52	43	37	63	76	20	60	91	29	35	52	105	90	41	50	13	39	41	27	31	23	9	45	44	52	21	25	21	30	61	38	69	46	32	40	26	32	17	37	31	50	20	36	43	39	29	53	48	22	31	39	40	15	34	28	21	23	42	39	13	21	60	19	39	50	24	38	15	47	79	106	26	30	17	21	25	68	54	43	20	35	78	18	45	33	38	101	24	31	35	32	24	24	39	14	28	55	106	9	14	16	24	19	80	32	30	53	16	55	50	29	18	19	35	26	52	23	14	12	36	43	28	23	36	32	26	22	32	63	24	40	17	17	34	41	30	20	30	20	68	16	98	36	11	17	29	22	36	15	34	66	25	25	20	22	7	55	28	16	33	47	17	37	38	29	62	40	44	26	27	16	10	15	35	19	34	6	18	53	31	27	113	20	22	32	25	33	17	15	31	12	18	36	30	26	37	30	15	41	18	9	14	17	23	48	19	20	47	28	12	30	31	34	31	15	34	14	34	23	39	13	29	38	15	16	14	33	38	15	19	13	61	61	27	40	18	14	19	9	9	8	17	25	9	25	21	25	22	9	21	32	13	21	11	28	17	12	16	6	27	8	28	40	7	18	8	13	36	44	13	9	6	17	17	17	30	18	28	17	12	14	21	3	14	22	12	7	5	34	10	38	3	42	31	17	22	31	8	14	10	13	22	24	22	10	14	5	31	8	10	20	20	9	14	15	14	2	24	14	20	14	7	17	25	38	18	26	6	15	16	6	24	3	37	14	19	16	32	9	14	19	68	15	19	22	83	21	13	11	15	13	8	12	21	2	7	25	5	43	21	9	8	13	10	3	1	33	6	9	18	25	4	12	13	27	3	2	4	13	10	2	15	10	5	6	10	2	13	13	8	14	9	6	7	15	9	12	8	22	0	3	22	69	1	12	6	20	13	15	69	6	15	6	3	7	8	7	11	11	97	17	19	25	9	10	10	8	3	2	10	8	7	1	7	11	35	9	7	27	8	23	9	1	16	11	6	8	8	1	3	5	13	16	1	12	2	3	2	4	2	1	2	18	2	0	30	0	9	6	3	1	0	2	7	15	1	36	3	15	3	4	2	25	2	0	0	1	2	1	4	0	1	0	4	4	0	13	1	0	0	1	0
ne0037	292	541	236	277	548	144	125	116	225	97	303	141	104	75	114	104	57	290	132	96	180	101	206	81	185	153	189	132	146	129	232	128	68	83	120	138	41	224	186	120	93	76	462	98	79	28	64	25	57	88	44	76	109	98	105	95	213	203	88	133	66	86	231	164	84	62	44	85	77	166	54	175	108	79	159	194	87	116	52	130	43	87	33	92	149	64	147	69	93	53	61	71	23	72	164	117	46	45	72	37	53	51	93	34	75	49	66	29	156	48	63	64	22	28	38	50	34	53	188	12	72	19	189	36	79	77	61	88	17	34	63	50	146	115	108	142	333	106	17	96	45	21	73	100	103	24	70	144	64	51	58	127	30	29	54	159	27	92	12	35	73	90	53	37	69	96	67	57	162	51	37	92	40	25	14	76	60	21	108	127	75	43	86	47	92	200	77	40	89	81	101	30	123	44	136	39	70	9	43	29	57	206	110	61	127	29	67	30	47	60	15	90	204	9	59	63	70	119	36	120	103	59	105	14	45	59	52	47	78	80	113	29	143	139	67	30	54	95	61	59	36	86	76	76	92	42	22	44	68	58	62	61	61	90	39	4	55	42	81	131	64	52	48	21	87	25	12	73	82	111	59	37	36	55	57	64	69	30	80	106	146	34	152	117	60	196	54	43	129	23	61	18	120	46	32	79	24	42	24	47	78	62	101	25	16	55	107	73	20	109	89	42	88	58	88	71	23	139	13	35	40	44	43	100	43	39	25	61	67	77	72	14	10	22	25	15	49	57	23	31	59	14	16	29	16	74	28	29	79	82	32	92	67	32	55	20	51	67	115	107	44	69	26	76	36	52	45	47	25	12	52	81	34	42	49	114	38	23	30	49	43	28	25	6	60	47	77	48	18	63	53	41	47	80	61	36	84	60	82	43	61	21	21	32	44	45	73	49	8	57	43	71	75	11	107	25	44	43	35	22	47	126	34	13	26	30	10	34	46	39	8	44	95	40	32	13	74	72	44	28	33	56	60	25	30	27	21	27	27	14	29	34	32	32	52	53	42	54	63	31	21	74	50	29	31	30	41	46	70	55	30	9	18	19	22	14	27	37	44	74	50	22	13	89	13	83	15	12	9	35	45	33	43	97	62	29	34	27	29	24	121	20	27	27	9	40	55	74	14	12	20	18	30	67	26	57	24	51	28	23	54	53	70	15	31	16	54	15	28	20	27	34	27	67	32	35	97	7	92	40	25	26	63	32	58	146	48	49	47	11	35	43	23	33	23	47	16	42	35	17	31	26	40	39	38	25	61	15	52	66	27	20	98	38	17	18	10	11	28	9	35	25	32	46	16	13	17	30	34	15	38	23	11	69	7	30	20	23	8	23	12	48	56	29	29	30	71	24	50	21	33	23	47	77	44	57	22	20	36	31	60	48	24	38	11	23	18	2	63	35	24	21	58	24	96	51	34	12	130	57	9	78	53	11	77	51	11	15	47	23	33	28	33	39	14	11	32	14	40	23	6	16	49	48	23	12	18	29	17	28	19	65	9	9	19	15	48	61	10	37	25	30	31	80	30	17	33	69	20	52	50	20	28	21	55	63	13	21	13	42	23	17	18	14	13	5	17	23	9	14	29	29	46	10	29	28	13	24	7	9	14	82	17	49	65	40	6	19	13	40	27	30	9	12	36	48	70	14	21	166	39	60	21	8	10	13	57	45	17	29	27	20	28	31	56	16	28	27	65	48	17	14	4	19	40	58	102	12	89	11	44	9	3	29	13	17	10	18	14	23	13	8	11	17	32	21	43	13	35	23	29	9	28	35	31	15	12	19	11	58	16	18	60	11	14	15	15	12	17	7	53	20	0	16	11	1	16	16	21	33	3	12	24	13	21	12	1	35	25	14	34	33	20	24	16	34	23	26	57	36	16	62	3	15	14	25	11	32	34	45	30	13	2	11	52	29	5	23	35	30	28	12	6	28	10	22	31	19	31	36	30	35	24	6	3	44	8	11	32	20	14	1	21	9	5	29	16	31	49	15	15	45	36	30	27	19	4	8	15	6	34	16	10	5	36	29	2	16	55	26	54	13	15	16	34	3	18	10	11	37	4	12	12	5	15	30	8	14	10	49	53	21	14	6	29	15	22	10	30	25	56	4	16	12	4	27	15	5	18	5	20	38	54	35	21	25	17	14	35	33	7	25	22	8	63	11	11	26	14	34	29	10	11	19	18	43	8	15	10	9	12	6	9	23	52	5	5	9	13	16	9	15	35	22	34	21	6	10	22	8	49	6	48	12	19	31	35	19	18	16	12	4	15	20	3	19	42	31	21	13	7	16	7	33	26	5	1	19	3	13	8	29	8	3	39	8	6	27	6	10	4	9	17	3	44	16	10	13	7	6	15	7	3	8	9	35	9	27	12	38	15	16	11	2	18	2	2	39	10	13	10	12	14	4	28	23	11	32	24	31	50	4	86	7	10	14	18	11	1	4	9	11	30	26	7	26	61	9	24	5	20	5	4	2	22	30	4	14	12	4	24	10	32	6	4	39	16	10	25	11	51	8	13	3	19	2	11	6	15	5	4	31	10	9	10	5	28	23	20	7	52	10	16	6	11	34	7	40	38	8	6	22	8	20	32	6	14	1	17	3	5	7	34	25	16	43	22	4	10	23	6	4	16	10	20	12	1	20	12	12	3	1	13	31	3	27	24	8	6	12	3	7	5	13	9	7	4	3	24	7	8	4	28	4	21	20	4	8	41	9	17	6	32	4	12	4	10	34	8	6	6	21	4	5	9	21	11	2	28	11	13	22	8	4	18	17	26	12	13	20	20	26	6	18	14	16	41	10	77	33	1	67	5	4	31	41	25	5	22	6	4	10	37	2	18	14	7	18	6	2	4	6	0	20	11	17	29	6	15	10	27	48	11	18	12	15	6	29	7	5	4	4	14	6	3	10	5	14	20	3	2	0	21	1	23	24	6	7	5	16	4	16	28	56	24	11	25	34	18	5	26	1	10	1	57	8	14	10	11	5	13	8	5	12	10	24	26	33	30	6	8	1	6	9	2	13	17	15	5	12	22	0	3	9	16	5	45	40	8	7	2	1	6	34	13	5	1	12	18	6	6	13	5	22	12	5	6	2	15	23	7	3	11	5	7	8	15	10	7	1	2	23	31	12	5	19	46	5	4	2	4	1	1	43	2	3	18	8	8	1	14	4	11	10	6	6	9	1	4	4	4	17	18	4	3	4	2	3	1	22	8	7	10	14	38	12	7	13	1	15	19	11	6	18	13	3	2	7	4	20	6	13	8	2	41	17	7	9	10	9	17	5	21	6	4	2	1	7	17	10	3	6	1	18	6	3	11	5	9	8	11	15	5	8	5	25	11	0	4	14	3	7	22	14	0	3	21	0	33	7	2	6	0	10	14	3	8	8	0	7	3	1	9	6	15	13	11	8	9	3	7	5	8	2	11	3	8	6	10	8	5	0	11	4	19	4	7	10	2	14	0	7	12	4	0	26	5	0	0	10	2	0	24	1	8	2	4	3	8	11	5	0	4	5	6	41	5	0	3	6	4	0	14	2	7	5	5	24	0	0	2	18	36	6	2	14	4	0	38	0	16	9	8	3	10	0	1	6	1	2	8	13	1	5	1	0	3	7	7	9	0	8	0	4	1	5	7	1	6	7	2	4	3	0	2	6	1	5	25	34	6	13	19	17	2	1	0	0	1	4	4	2	2	7	0	4	16	4	0	2	0	3	4	1	4	2	8	0	0	3	3	4	4	11	3	2	2	1	0	1	3	7	9	2	1	1	1	0	8	6	6	21	0	3	8	0	24	1	5	0	0	0	4	1	1	2	2	0	5	1	4	2	2	0	4	1	1	4	0	0	7	4	1	2	0	0	5	2	8	1	1	1	2	4	4	0	6	1	2	1	2	0	4	1	2	8	0	3	4	1	6	0	1	3	1	15	2	0	1	1	4	10	1	2	1	0	5	1	1	0	0	6	2	3	0	6	3	1	18	2	0	2	1	0	2	1	4	0	1	5	2	0	3	5	1	0	2	0	2	3	0	0	0	1	1	0	0	0	2	1	1	0	0	0	2	3	1	5	0	0	1	0	0	0	0	1	0	0	0	0	0	0	0	0	1	0	0	0
ne0038	2353	1931	1410	1795	1638	1257	1147	1076	1005	872	1001	1116	830	824	664	731	643	1023	623	634	624	732	714	588	817	562	695	565	574	431	726	529	581	640	383	531	546	757	644	458	546	551	1087	457	598	479	554	465	277	538	608	503	424	647	898	492	703	679	443	349	503	451	606	481	523	544	558	407	554	624	359	460	445	374	519	608	405	496	436	481	435	412	529	489	580	474	655	423	338	352	337	232	486	388	478	475	437	289	384	280	324	394	478	418	456	364	338	426	387	395	360	351	387	461	468	297	445	284	1787	415	294	384	391	283	354	401	385	248	384	394	362	253	458	343	355	240	463	314	354	448	309	277	283	422	258	293	370	316	368	259	316	413	314	268	259	489	194	393	383	279	318	279	348	256	251	370	272	259	1523	269	245	387	271	219	375	375	256	359	407	336	295	208	240	323	220	741	201	195	304	507	282	202	238	308	315	301	371	331	251	339	318	453	267	279	262	316	410	261	172	256	354	372	242	210	141	249	383	279	158	319	298	145	311	211	164	280	231	190	292	323	283	284	406	362	286	139	263	292	277	378	329	300	338	234	262	228	271	260	312	222	304	444	218	268	169	305	201	178	249	341	230	184	295	209	233	176	247	274	270	219	258	199	260	310	269	258	221	196	236	356	381	177	219	265	216	368	167	211	224	164	224	201	260	210	209	338	245	194	161	224	267	220	284	199	201	231	249	176	211	368	311	141	231	292	222	258	219	193	79	168	195	155	281	235	327	211	197	236	134	239	286	181	211	172	183	260	147	136	173	188	179	212	111	149	189	197	202	145	175	307	215	191	188	146	174	233	231	395	377	259	167	220	257	279	180	220	218	150	167	183	258	250	176	255	231	299	194	149	166	206	245	173	185	157	125	191	282	156	174	239	154	194	199	148	123	207	205	216	364	85	152	162	157	180	197	210	226	169	252	176	223	303	207	182	138	184	188	141	129	162	151	355	123	108	131	175	149	131	115	202	170	179	236	156	176	164	139	171	179	184	159	134	240	187	122	183	141	168	80	199	151	90	145	198	200	181	131	222	326	104	160	489	289	121	213	170	194	130	179	158	159	132	189	129	144	216	158	139	175	163	189	78	123	212	140	177	94	160	149	81	189	151	236	174	191	172	92	176	133	95	98	101	152	206	138	173	238	168	138	78	119	81	158	200	145	135	138	227	134	163	160	232	200	63	128	140	214	157	82	236	145	78	134	132	86	146	198	84	167	114	155	146	192	147	233	431	115	117	147	119	142	201	97	152	83	81	123	217	77	127	138	89	124	240	148	108	218	139	267	177	34	126	182	151	147	176	89	41	142	127	130	158	145	192	138	123	96	110	110	86	178	91	122	164	84	111	75	175	82	129	56	205	173	106	124	88	84	97	155	130	107	76	122	194	140	121	160	135	145	108	128	155	145	62	73	84	137	77	127	119	136	115	144	65	117	133	77	85	397	198	70	116	103	191	168	202	89	90	107	127	84	193	107	166	133	64	150	157	87	89	78	87	188	112	91	136	105	66	79	141	83	182	83	177	83	88	159	109	49	89	134	121	106	143	111	158	133	169	107	151	103	85	91	125	163	161	84	55	63	110	97	102	104	66	93	76	79	57	95	65	123	87	43	83	131	121	56	111	75	44	79	163	92	96	138	103	131	79	130	167	76	134	47	90	91	85	120	109	96	150	124	147	57	83	101	96	141	179	113	146	121	111	140	67	123	83	109	49	84	376	120	130	71	90	163	151	143	69	140	198	135	116	59	105	78	112	102	83	64	92	57	114	50	76	138	136	133	55	124	69	66	89	127	90	70	81	80	61	95	148	79	120	226	93	67	74	83	56	75	88	107	71	94	86	56	39	76	65	76	110	108	63	136	92	102	41	98	46	121	41	77	187	93	103	81	88	86	94	72	95	64	85	112	64	55	69	64	59	91	85	76	83	51	72	94	113	45	59	133	70	41	62	135	124	65	122	141	87	159	102	74	65	40	61	49	125	77	79	63	62	47	54	81	59	53	65	95	71	66	80	46	116	88	64	67	75	36	29	82	89	63	81	102	86	64	92	58	43	235	98	64	63	82	32	97	42	113	74	57	104	48	43	50	76	122	93	73	20	67	72	101	56	107	66	77	256	41	42	43	82	241	28	60	47	49	78	88	33	79	21	50	116	93	38	160	57	248	46	54	81	88	60	66	50	98	73	111	83	44	27	90	40	29	57	77	80	55	46	38	12	33	76	34	87	164	56	59	55	48	51	68	82	115	134	197	52	30	39	89	36	157	60	107	52	101	105	52	77	205	84	53	48	72	81	32	81	81	62	56	42	52	68	30	60	129	50	11	83	40	31	59	70	46	17	72	56	69	101	26	44	40	37	56	17	201	27	31	45	82	40	389	63	26	33	60	60	70	26	53	69	77	48	45	63	94	22	22	111	12	73	73	43	29	41	71	68	54	70	68	62	60	47	108	74	123	59	91	58	59	67	69	55	84	80	32	82	136	67	63	107	91	48	25	34	83	81	36	48	67	49	52	13	71	55	35	89	92	63	39	77	51	56	62	66	87	46	45	43	59	26	33	118	64	37	63	47	50	61	76	20	27	16	90	30	80	28	38	50	95	67	63	51	73	65	70	100	59	27	71	38	50	48	26	72	64	61	82	47	62	44	143	48	51	39	45	76	33	93	29	54	34	52	34	36	41	120	45	34	13	20	26	52	40	40	24	37	30	37	39	22	66	29	28	40	74	90	17	47	38	49	20	33	39	28	61	44	96	76	46	30	17	66	34	84	31	86	57	27	73	33	31	35	39	38	66	35	29	11	57	64	55	61	35	47	133	80	33	40	82	55	26	69	39	16	99	34	97	42	56	86	26	45	57	19	39	24	43	21	20	35	23	43	28	42	39	34	65	18	51	58	108	42	45	32	54	69	59	148	30	66	25	18	52	18	20	29	82	22	66	33	30	19	60	55	51	95	25	43	26	73	10	18	17	225	84	52	40	60	31	17	39	39	50	17	65	45	39	36	18	23	91	13	17	42	33	56	48	210	145	60	35	16	19	42	34	42	23	42	22	65	57	31	44	26	28	152	40	62	33	39	17	15	25	42	26	29	27	14	47	35	40	23	52	56	48	28	11	38	32	30	14	30	22	10	40	28	42	47	36	33	31	54	43	23	11	59	93	21	21	69	19	5	29	34	79	17	36	23	31	10	24	18	79	54	25	18	22	16	20	48	26	19	7	25	39	12	8	20	18	20	55	21	25	28	23	38	27	28	8	84	23	27	43	18	12	27	22	30	20	85	27	21	53	28	40	24	25	24	17	60	20	31	21	35	12	34	21	20	46	18	17	14	14	50	10	10	137	11	52	15	13	9	11	38	48	42	46	21	12	17	8	30	22	54	16	32	30	24	25	33	23	14	9	36	30	25	24	25	9	28	15	15	49	39	26	31	38	13	14	6	13	46	20	12	101	2	17	18	11	46	19	13	66	56	4	4	65	17	13	40	8	20	19	19	20	45	20	9	1	42	6	22	50	15	26	3	16	30	29	34	40	32	23	23	17	8	28	3	11	19	26	5	66	62	9	15	23	17	8	8	23	15	50	20	7	2	17	3	36	3	43	26	25	48	48	13	8	15	23	4	22	38	8	42	13	7	6	10	5	17	18	14	15	7	15	14	35	4	134	27	22	31	14	15	4	29	75	8	22	19	46	12	2	39	12	19	13	17	9	4	18	9	3	36	4	12	36	9	4	12	14	44	17	58	5	3	38	6	4	12	13	15	13	20	19	21	19	36	23	17	11	7	15	11	10	2	42	7	18	64	6	4	10	10	60	4	9	11	0	4	3	8	25	7	2	9	10	15	39	33	6	1	1	7	12	6	8	4	12	15	4	7	2	8	6	7	4	13	8	6	17	7	7	1	5	9	8	6	3	4	18	3	51	11	15	1	1	7	5	3	4	4	8	8	8	1	12	43	2	9	4	57	3	2	11	8	3	8	5	10	3	8	1	1	19	3	30	4	3	1	9	6	5	3	0	3	12	28	1	5	6	0	11	1	21	2	4	4	8	3	1	8	2	4	2	8	2	2	1	6	10	0	0	0	2	2	6	1	72	1	0	7	2	0	5	0	0	9	0	7	4	0	1	0	1	0	1	0
ne0039	3626	3656	2603	1618	2259	1996	1751	1613	1367	1835	1354	1326	1298	1400	1304	1071	1189	1546	1182	1164	1113	1109	1056	881	1385	1012	1091	1150	954	1282	975	897	980	844	1135	1143	885	1061	988	924	945	1014	1053	807	879	783	686	1006	934	923	730	849	616	744	691	867	792	888	692	533	693	683	776	782	774	737	746	707	838	797	943	794	876	706	650	920	612	857	648	897	740	641	612	662	747	653	868	706	734	620	697	673	563	587	538	658	516	429	606	468	653	693	543	643	671	628	558	474	685	532	576	470	464	487	473	596	524	602	628	532	529	491	633	532	540	475	556	302	514	515	484	424	469	566	575	595	647	549	433	478	459	580	577	515	503	541	438	647	450	432	508	697	547	476	429	506	590	541	397	447	458	541	419	631	556	615	636	621	420	321	553	605	433	513	375	592	555	416	557	700	207	509	298	534	328	377	396	501	687	531	488	464	492	449	462	517	469	361	599	410	582	479	447	448	420	477	552	422	453	417	352	441	418	319	425	496	477	622	486	479	535	271	514	376	566	419	532	555	550	689	431	362	418	484	480	384	412	432	525	464	304	407	488	452	336	507	395	406	462	401	332	329	451	391	310	303	330	426	532	400	397	497	438	401	396	354	322	434	532	566	421	427	359	329	412	349	397	339	506	403	458	495	383	460	274	380	513	416	376	369	401	426	459	421	245	382	333	380	415	389	409	322	504	352	323	352	455	444	371	358	353	392	425	341	441	315	307	406	220	397	327	399	375	306	291	323	320	423	338	254	304	299	431	161	376	278	379	293	381	338	396	278	376	210	343	393	289	342	262	300	290	362	433	329	318	366	360	355	329	614	438	314	238	297	341	278	347	416	245	244	276	377	299	297	294	333	496	341	331	303	132	424	314	282	375	302	350	347	299	311	277	292	297	382	189	282	321	291	298	170	392	203	244	347	305	529	362	254	286	424	286	249	341	247	216	371	377	311	259	265	325	409	215	394	285	229	276	283	379	335	302	274	360	302	258	328	310	245	314	261	294	244	314	284	306	221	166	259	354	238	253	121	209	208	321	285	326	312	321	212	193	219	216	272	291	257	303	166	268	227	101	197	267	182	182	263	242	188	150	304	236	178	313	302	207	354	229	211	283	291	206	406	234	380	320	359	281	244	202	211	287	233	280	233	311	274	278	370	275	179	259	232	235	194	281	358	233	284	198	203	217	258	231	334	288	328	341	255	281	272	321	296	252	325	162	298	350	199	266	256	301	162	246	266	202	176	193	216	235	161	202	217	272	248	248	280	233	236	197	221	261	196	271	132	194	222	188	232	667	224	82	242	392	246	208	234	185	69	197	191	250	214	121	212	233	154	205	280	191	238	179	216	213	220	154	160	196	209	77	256	240	211	178	112	178	174	146	154	175	107	179	228	247	193	236	242	168	175	116	196	158	235	228	228	170	219	209	233	172	198	285	270	203	222	190	231	156	178	222	209	199	205	209	205	145	140	227	159	196	186	267	322	263	252	166	166	227	199	206	166	168	157	201	167	193	265	158	125	189	212	95	228	207	175	169	154	176	202	122	155	144	158	270	196	151	203	188	94	138	173	235	200	137	194	179	173	186	193	206	208	149	221	181	279	177	154	137	105	216	197	194	181	212	237	181	144	180	164	132	160	176	187	147	199	216	154	192	182	170	174	203	143	145	195	131	102	144	132	170	207	217	166	148	131	184	206	101	207	143	135	50	154	141	157	180	151	97	193	259	186	210	234	168	182	147	137	177	150	1131	273	143	115	93	161	135	162	155	167	121	121	208	181	168	274	164	121	250	166	126	143	106	153	151	211	114	144	166	146	167	161	138	120	138	117	174	136	136	166	149	126	189	103	135	98	128	134	168	95	134	195	190	102	53	269	104	150	136	177	130	242	90	107	110	49	120	175	203	206	117	112	132	176	152	101	183	54	110	132	146	223	172	226	131	128	103	179	153	152	144	141	173	141	168	138	114	132	147	131	165	129	125	163	73	92	142	84	125	112	97	166	116	148	154	195	159	146	94	136	263	115	181	100	146	116	164	133	124	149	99	160	69	101	157	154	126	156	110	135	292	105	124	100	97	112	93	85	114	121	146	92	139	102	133	77	192	86	160	174	90	165	103	125	99	111	87	80	151	101	119	124	94	123	144	83	171	126	177	112	162	101	111	90	153	222	133	138	82	99	118	226	77	70	76	122	88	92	95	80	169	31	97	158	87	115	81	100	81	129	105	143	117	71	138	97	156	114	79	108	128	113	150	94	113	126	114	108	71	95	87	81	135	81	109	103	138	87	127	112	75	56	96	90	103	114	44	150	90	91	138	64	126	81	103	92	118	104	86	105	144	67	92	75	103	52	114	85	123	130	91	58	62	112	132	54	111	73	128	107	133	124	81	71	90	103	55	79	125	58	127	119	81	124	86	117	142	108	98	74	98	76	97	98	74	94	137	69	69	108	58	101	55	75	111	62	94	82	91	140	76	56	77	105	120	104	76	65	76	63	34	57	114	45	79	118	83	82	70	89	62	64	101	110	141	57	94	168	114	83	184	82	155	41	126	76	119	120	71	98	98	128	85	86	57	67	73	75	69	59	135	126	79	60	45	77	78	85	120	137	64	88	63	111	136	87	61	46	108	70	59	108	105	50	57	95	125	174	102	58	124	50	68	66	64	70	73	92	54	77	62	56	61	97	85	116	61	51	46	112	63	155	62	60	54	42	115	56	110	80	76	63	107	105	90	91	96	110	93	55	84	145	77	96	65	42	76	146	67	106	73	87	74	47	101	52	31	69	121	28	105	70	99	53	79	62	57	93	59	63	68	36	83	52	123	95	172	69	67	104	64	219	46	72	103	94	70	79	66	73	78	42	81	99	109	73	50	61	86	158	52	68	73	66	62	102	69	88	58	68	65	53	77	92	68	101	65	24	68	131	46	91	72	49	48	32	62	42	68	94	78	33	44	79	37	87	107	47	43	75	48	56	74	29	57	220	64	52	84	34	46	46	70	65	63	79	87	92	67	58	54	84	43	70	44	65	31	56	60	278	51	44	23	70	37	63	48	43	49	58	47	102	111	31	136	68	85	27	40	30	74	94	34	57	57	89	30	33	68	77	36	25	54	74	79	55	85	47	44	55	45	84	79	65	64	62	63	68	34	25	72	52	60	53	78	44	26	57	71	48	40	45	36	63	42	55	58	20	91	53	52	66	33	44	57	32	76	56	24	60	31	39	28	50	54	35	47	20	44	27	39	50	38	41	48	67	58	34	60	52	14	23	34	33	34	46	34	36	33	35	12	53	26	61	50	29	64	38	36	67	30	55	49	39	58	44	51	51	51	35	47	70	46	54	40	99	57	157	49	31	37	30	46	103	43	54	32	39	71	26	29	31	20	39	56	49	19	31	57	20	34	37	33	35	45	13	57	64	49	46	16	89	15	91	40	33	55	40	58	39	46	42	47	26	35	33	20	50	30	44	71	149	59	25	29	25	34	10	54	60	15	23	18	41	20	57	58	28	25	65	28	27	38	114	46	36	30	41	13	44	8	22	44	53	28	68	15	25	14	43	37	32	27	31	38	19	53	41	30	24	28	27	27	33	59	24	28	33	29	23	46	16	54	26	17	22	57	9	22	32	32	81	28	38	20	19	41	63	42	17	36	22	11	16	31	8	12	18	34	34	15	23	31	18	42	12	17	22	36	24	27	19	5	6	28	17	8	23	14	12	29	13	13	21	12	20	18	16	11	15	22	14	8	13	13	44	16	26	8	25	12	13	25	33	18	14	22	9	16	55	19	27	16	10	13	24	29	40	22	6	14	14	6	22	4	30	20	14	19	10	102	7	12	12	50	20	13	7	10	11	23	8	17	13	12	13	4	10	16	19	71	8	13	16	36	13	8	9	9	15	6	15	13	6	22	7	12	11	21	4	20	14	1	10	19	25	5	25	5	7	5	6	10	10	36	5	7	14	16	4	4	4	3	16	2	55	16	11	2	5	2	9	7	15	11	10	9	10	30	13	7	4	6	4	3	11	7	6	6	2	2	9	0	3	4	15	6	4	5	4	18	6	13	4	3	9	2	4	2	2	9	6	1	1	27	6	7	3	11	6	2	1	6	0	4	6	0	3	0	2	4	2	1	0	0	1	2	0	0	0
ne0040	1179	1550	762	737	543	868	607	750	469	541	442	643	625	550	638	551	559	383	523	603	443	432	508	379	369	347	471	440	431	730	394	307	409	407	428	487	338	334	283	411	357	397	221	255	336	475	395	359	379	343	425	371	236	201	252	579	178	391	313	277	372	249	305	266	355	257	303	210	267	217	280	251	375	260	220	262	252	222	245	195	278	240	341	234	227	303	151	312	179	321	290	281	283	188	218	190	302	180	196	197	241	251	318	314	218	273	240	272	244	189	194	185	281	254	304	241	331	208	143	300	202	296	269	236	192	190	185	183	311	266	234	202	182	244	225	224	172	155	248	153	188	197	118	139	207	214	185	185	176	186	247	130	225	168	209	213	189	136	218	174	159	182	254	265	236	170	131	261	108	268	172	184	194	333	254	137	222	241	141	147	122	243	199	188	183	136	189	243	115	151	146	201	85	222	110	216	134	245	198	139	175	148	139	158	172	119	137	186	250	136	224	175	141	151	181	293	110	439	192	160	221	164	224	138	311	184	211	260	167	135	167	145	148	149	109	229	171	143	168	111	176	202	106	178	102	180	226	119	151	178	161	55	123	111	191	209	125	170	131	151	170	149	101	184	140	115	158	169	311	107	144	98	140	144	163	134	147	120	175	116	164	98	96	161	123	119	208	123	161	105	152	148	189	124	147	111	160	101	144	125	120	78	161	122	127	106	97	220	126	94	124	154	140	119	176	83	128	129	118	144	129	192	110	202	119	202	146	73	95	74	94	100	114	145	80	97	138	183	124	110	114	126	217	135	124	140	119	136	138	155	125	146	157	103	99	98	94	85	124	92	102	107	119	138	105	116	90	146	169	100	104	48	139	86	81	105	130	179	85	127	88	153	126	87	243	98	61	120	139	70	128	122	76	85	118	125	83	117	60	126	162	153	110	127	120	61	69	98	97	144	63	86	75	99	143	117	74	110	117	110	128	250	100	169	183	104	92	82	115	90	125	117	71	116	73	104	91	82	130	91	120	129	80	88	82	106	87	81	77	62	90	109	74	95	98	79	99	112	85	97	82	70	79	103	71	92	57	61	77	62	105	106	87	79	145	83	71	63	62	75	68	56	111	64	69	92	64	86	170	211	59	59	80	103	85	101	63	83	73	82	57	96	89	86	168	94	67	71	112	80	55	154	60	47	118	126	94	59	112	80	95	84	120	110	117	91	75	66	131	66	44	211	57	59	89	91	63	117	133	105	71	78	86	42	71	74	98	79	129	82	66	96	53	79	124	131	92	47	88	92	70	140	47	52	56	65	76	80	49	40	90	55	54	37	72	104	72	88	86	77	96	79	79	84	115	56	59	151	118	79	67	96	89	92	66	61	63	84	44	74	64	74	122	42	98	139	67	67	59	52	40	94	76	56	114	72	49	65	77	91	47	75	73	137	68	81	76	88	103	44	55	50	36	51	56	103	42	56	42	67	52	46	111	70	62	54	110	59	88	42	82	43	68	53	56	72	34	90	117	38	51	93	50	47	110	43	89	72	74	62	209	64	58	88	66	32	51	79	32	58	62	68	84	48	33	49	84	37	71	29	31	49	54	62	41	83	74	102	61	88	41	42	37	75	32	49	57	83	72	97	70	90	86	54	52	74	83	68	76	37	57	82	55	74	99	48	58	85	68	35	87	32	85	56	80	66	86	46	47	59	77	48	59	60	34	30	46	59	54	43	48	69	22	40	34	35	61	54	53	34	34	42	80	61	21	57	22	52	58	50	42	69	38	57	51	56	54	55	49	14	100	45	98	42	81	30	50	74	30	34	65	64	55	31	44	70	46	73	54	75	26	35	24	34	76	47	29	89	46	51	73	38	64	23	21	72	21	55	52	33	86	64	32	17	42	67	46	55	50	62	20	48	79	83	57	46	41	55	41	29	54	50	73	39	78	16	18	37	83	105	52	43	49	56	50	35	77	62	56	27	38	31	48	84	46	36	57	34	67	219	34	76	73	47	70	56	44	21	44	39	39	43	42	56	62	91	40	70	33	45	36	185	51	31	57	23	39	47	41	26	60	48	58	77	36	27	67	65	18	60	35	30	53	75	33	29	39	50	39	54	66	49	20	33	51	30	33	135	29	81	30	34	29	43	52	34	49	48	62	53	27	17	14	28	42	43	47	56	35	42	45	37	41	34	22	39	23	44	45	27	49	48	50	45	28	73	56	32	22	43	37	44	94	48	40	34	37	26	47	27	51	40	35	33	43	53	22	27	28	35	25	49	33	30	38	49	68	20	32	31	29	29	43	54	37	30	6	33	34	34	26	34	4	29	47	36	38	29	17	32	63	19	32	30	22	49	16	34	30	19	19	25	52	24	36	44	19	37	43	56	24	35	43	40	30	58	28	33	33	66	22	15	35	43	38	33	24	40	24	31	62	10	17	22	49	40	40	18	28	21	31	41	32	21	20	41	32	37	27	53	48	43	19	37	21	43	17	15	33	30	55	35	15	27	16	30	32	24	31	19	17	31	42	33	32	16	21	41	29	43	28	34	36	53	20	42	31	16	26	27	59	46	17	43	31	22	21	26	30	50	25	53	26	24	25	20	32	21	26	43	42	49	20	42	29	14	184	34	37	30	20	28	20	23	52	34	25	20	28	12	27	18	47	24	18	21	15	17	19	14	21	24	12	48	41	22	25	46	30	17	23	31	40	22	30	16	180	29	28	26	7	30	66	45	52	26	43	7	13	24	12	32	23	27	28	29	27	19	40	48	42	8	30	10	27	26	23	27	54	36	49	27	28	5	4	16	23	21	21	16	21	40	39	11	7	14	23	8	37	16	34	20	24	27	15	38	25	24	17	27	22	12	21	25	32	34	39	16	32	14	19	30	24	24	28	6	32	29	39	17	80	19	15	36	32	30	35	42	25	26	30	28	25	26	35	39	22	18	15	20	51	17	42	28	26	24	19	34	11	12	32	25	21	27	29	16	24	23	9	14	71	19	42	14	34	20	28	24	56	36	12	26	13	33	18	30	22	14	17	31	15	29	31	15	32	19	9	16	13	13	12	30	19	37	50	7	13	12	20	5	16	26	26	32	30	8	31	4	23	19	8	15	16	10	42	20	14	22	5	13	22	29	21	18	29	8	22	20	23	19	30	34	37	18	27	13	29	17	21	17	22	40	9	37	40	10	23	19	11	9	24	32	15	34	11	6	19	8	23	34	16	34	13	15	23	175	18	38	25	4	40	12	10	19	30	24	38	10	23	9	12	20	8	15	23	5	21	29	7	9	8	23	9	12	19	18	24	17	26	19	7	6	6	6	8	25	9	13	44	8	13	7	2	17	17	10	28	8	12	20	25	16	22	15	32	12	11	33	18	11	12	21	16	22	12	15	15	9	29	50	19	11	13	5	13	17	14	3	8	15	23	21	4	23	7	17	28	8	20	11	9	30	16	15	18	30	20	28	11	17	6	16	8	37	5	8	15	16	28	12	12	21	9	13	14	5	4	9	7	5	4	3	6	13	13	2	10	10	7	14	4	0	12	7	15	19	12	11	15	9	7	14	13	7	12	10	10	15	12	15	7	4	15	6	10	12	10	15	6	18	6	13	10	8	10	19	12	24	8	26	19	8	2	12	6	5	19	3	4	10	6	12	10	7	14	15	13	9	12	15	14	9	4	12	6	7	3	7	3	6	5	4	12	14	16	18	5	13	7	9	3	2	26	3	2	2	3	3	17	8	4	14	8	11	6	16	3	6	31	5	4	2	162	5	2	28	4	4	5	1	5	4	13	11	11	11	14	0	8	3	6	4	7	2	8	2	2	16	5	3	4	8	8	6	2	5	8	12	2	5	5	2	2	15	7	6	6	4	4	5	2	12	8	1	3	3	2	4	3	9	7	6	10	4	10	2	1	7	5	14	2	6	2	4	15	3	9	5	5	3	6	4	2	1	6	3	2	1	0	5	2	10	1	2	3	4	1	11	6	12	3	0	3	0	4	3	2	1	2	2	1	0	1	4	2	3	0	0	5	0	2	1	0	4	0	5	3	3	1	4	0	5	8	2	0	10	1	0	2	8	5	4	2	1	2	1	2	0	2	1	1	3	0	2	2	1	1	0	0	0	2	0	0	1	1	2	1	0	1	1	0	0	0	0	0	0	0	0
ne0041	1121	1626	811	650	608	794	578	719	450	537	457	595	506	486	496	471	464	476	486	488	358	362	395	415	427	320	465	376	381	514	367	316	355	356	431	353	305	404	363	388	267	313	230	264	283	333	327	322	226	256	367	285	294	228	311	297	253	384	311	290	320	231	372	270	287	276	307	235	295	266	252	242	286	220	257	298	253	226	307	264	231	275	366	301	230	292	226	248	192	306	215	249	252	224	176	158	256	210	173	147	242	218	288	235	242	221	337	246	181	251	214	203	240	235	278	182	287	162	195	270	174	232	333	217	207	181	195	198	233	248	227	167	254	209	201	329	161	164	223	162	157	145	214	174	184	215	180	261	186	220	194	157	201	180	134	176	166	163	200	169	163	241	190	228	195	152	160	264	121	226	173	170	156	238	211	181	187	204	172	219	182	135	207	190	219	159	207	146	189	210	139	151	179	169	138	162	186	202	185	160	170	142	166	119	315	113	165	131	163	175	190	201	121	139	112	305	187	215	139	131	204	168	169	166	245	187	178	222	181	159	153	171	160	163	147	189	152	130	131	165	194	150	106	195	159	165	158	83	148	143	177	113	127	107	137	177	129	136	146	163	155	145	129	118	151	106	90	166	181	140	151	128	124	155	184	146	152	111	171	90	174	97	88	296	117	231	164	137	110	113	110	110	136	131	180	179	156	115	125	118	131	136	134	94	114	88	118	221	106	121	135	112	127	123	143	83	119	147	95	102	162	140	155	179	96	163	120	123	116	86	125	94	124	158	92	116	123	157	80	117	101	130	146	113	95	122	112	114	142	153	120	137	114	75	77	106	152	107	95	173	101	87	89	142	96	83	86	119	112	109	133	94	139	88	119	127	102	129	75	135	89	117	143	88	154	103	100	113	140	107	117	175	85	116	107	97	120	126	152	79	163	195	121	101	114	67	133	125	95	114	105	88	66	95	110	113	86	116	132	109	100	128	69	107	93	185	91	112	147	94	113	142	63	127	70	71	91	70	97	90	123	125	83	121	131	124	100	106	106	76	124	100	68	113	102	90	85	118	74	56	60	75	87	98	77	83	93	84	107	75	241	79	117	72	90	111	59	74	85	101	109	81	69	98	65	81	78	90	119	125	68	69	129	92	80	111	86	102	74	61	75	94	77	117	91	99	176	76	96	86	68	133	100	50	136	150	92	97	79	76	104	92	84	64	82	97	84	70	119	83	70	118	59	89	90	94	75	97	163	139	74	65	72	65	58	110	93	86	130	70	62	152	75	52	150	108	61	73	119	88	99	84	64	38	68	60	79	90	52	72	65	75	43	46	86	105	87	72	57	93	74	83	82	77	77	60	69	89	80	73	60	76	121	76	74	112	53	100	42	68	74	85	70	68	96	81	50	95	84	115	60	76	71	77	80	79	49	74	65	69	72	54	114	113	103	61	90	64	115	71	82	29	51	67	83	69	36	59	42	74	59	52	125	52	81	61	65	45	70	55	116	41	76	51	70	54	69	69	87	48	48	77	56	50	75	44	66	36	103	67	70	91	53	77	115	24	78	98	37	46	51	49	61	51	80	39	50	101	71	57	49	54	53	69	71	95	35	98	52	74	46	52	57	69	85	55	67	73	42	60	85	51	66	36	57	103	72	95	47	43	53	55	61	65	92	37	70	93	74	45	74	70	52	47	55	83	93	41	78	66	78	64	56	69	45	36	53	54	80	72	59	81	70	61	55	40	55	51	81	47	59	39	76	63	49	63	26	59	46	45	80	50	45	62	36	38	40	37	43	42	51	46	78	37	64	37	49	65	58	49	51	65	59	37	47	39	31	40	75	52	31	54	38	56	51	36	35	71	20	56	115	53	31	31	46	40	41	66	53	72	31	66	34	20	29	34	38	27	37	42	33	58	65	42	50	49	55	44	56	39	33	72	54	48	73	26	66	29	57	67	39	44	56	66	67	44	55	99	40	46	59	46	28	72	43	40	104	51	50	46	39	78	68	29	29	31	58	45	68	58	47	54	42	56	75	84	40	42	41	48	36	44	54	32	35	33	35	32	59	21	46	38	46	48	58	41	41	32	18	52	33	28	45	57	31	47	60	62	30	64	21	35	32	33	39	62	50	55	57	60	29	44	45	44	64	37	52	66	35	45	22	22	23	28	30	33	41	59	43	42	32	43	62	46	37	40	50	60	57	20	42	48	49	49	20	52	48	38	48	26	60	23	69	65	45	36	25	42	63	51	47	42	58	41	31	57	21	47	54	22	31	30	65	17	47	38	70	15	23	26	34	16	71	61	61	33	21	57	37	40	24	46	21	25	18	48	27	56	42	11	44	33	31	34	33	29	26	44	13	21	28	26	74	26	19	20	28	72	27	57	26	25	27	34	41	70	36	37	37	55	33	14	24	49	24	23	23	28	29	42	75	18	31	27	81	23	15	11	30	24	31	43	67	27	26	53	43	28	30	40	27	22	27	28	49	41	27	18	28	20	48	41	26	32	21	31	27	48	18	20	27	23	49	26	46	47	16	55	25	35	58	30	51	32	16	42	25	24	16	53	30	34	23	29	55	26	24	10	33	24	26	38	24	19	29	24	33	41	48	42	28	76	31	52	23	23	24	40	40	15	17	28	67	44	25	33	24	22	32	22	17	31	48	27	27	39	53	26	25	27	29	35	79	31	65	16	28	57	61	17	17	37	46	33	21	17	48	19	10	22	22	61	44	17	50	39	30	11	25	35	20	16	45	22	51	30	31	24	32	31	49	20	35	38	39	25	39	37	20	38	19	22	12	29	10	24	22	20	59	19	43	58	38	22	9	15	30	9	44	26	41	18	19	50	16	65	36	24	11	30	31	26	34	14	37	33	34	28	31	24	15	41	21	22	22	7	36	18	26	18	74	14	12	42	17	17	23	58	31	31	27	27	26	15	20	36	14	17	14	18	31	18	28	49	24	53	22	22	19	17	21	20	14	29	25	16	29	18	16	14	59	19	68	8	18	34	55	37	34	48	25	39	10	19	18	34	26	6	10	19	19	64	23	21	24	21	5	7	11	12	36	7	27	50	25	14	21	11	4	12	9	20	19	29	13	8	16	9	27	17	8	48	22	34	53	24	17	36	18	33	17	20	18	29	21	14	40	37	26	17	28	17	27	41	19	28	32	14	31	10	12	25	25	28	18	15	34	32	40	11	19	17	19	27	10	4	33	8	25	17	16	25	6	17	21	18	17	24	41	14	38	17	25	16	7	33	76	14	19	6	24	20	28	16	28	19	16	40	10	12	8	12	14	20	10	26	18	20	64	28	26	30	5	9	21	34	9	12	26	11	36	24	9	12	34	12	18	5	41	24	25	11	11	17	23	19	25	31	23	39	25	45	4	11	11	16	9	3	15	30	22	16	27	4	17	31	31	10	9	14	15	25	10	10	10	13	53	14	17	20	18	17	16	11	26	29	26	35	14	24	8	7	19	25	12	4	13	22	22	5	13	10	13	8	27	11	16	6	5	6	9	14	6	8	5	4	12	17	4	10	4	6	9	18	19	12	14	6	18	10	8	5	17	14	20	11	10	5	8	47	4	10	20	4	17	3	10	14	7	6	7	16	14	8	5	23	10	8	7	15	16	15	13	8	17	3	3	11	2	11	6	11	20	38	14	8	10	5	35	7	6	11	4	9	6	15	4	6	8	4	19	5	9	9	7	14	6	16	4	14	6	4	11	6	9	12	7	13	10	6	4	8	2	7	7	14	13	14	14	1	18	8	8	7	7	24	13	3	4	9	9	4	8	14	25	8	17	2	4	5	8	10	7	3	7	6	7	7	4	4	14	9	2	15	3	4	4	23	2	9	4	5	6	9	13	5	5	3	3	0	6	20	7	6	9	2	6	4	8	7	9	5	6	5	5	3	7	3	11	6	5	10	7	2	6	6	3	12	9	30	4	2	2	3	4	7	2	3	2	9	5	7	2	3	4	2	5	4	17	3	3	5	1	4	6	3	1	9	0	3	1	4	0	2	0	2	2	1	0	2	3	2	1	1	2	4	3	2	3	13	4	7	4	3	1	3	2	0	3	17	0	1	0	1	0	2	3	0	0	1	0	0	0	0	5	1	1	0	0	1	2	0	0	2	9	2	0	0	0	1	1	0	0	0	1	0	0	0
ne0042	821	1262	598	496	568	471	518	464	484	390	461	446	279	296	312	313	238	417	229	333	424	251	378	263	366	347	416	263	205	352	300	186	311	234	226	279	248	319	262	348	193	210	178	168	193	203	196	159	124	258	223	264	242	137	164	223	334	416	199	265	210	243	384	356	280	161	197	180	206	270	155	240	216	279	292	292	259	172	156	203	163	214	202	156	287	198	186	198	159	176	177	184	141	295	180	155	182	181	105	133	189	167	210	151	155	230	202	169	142	107	182	146	142	133	179	126	203	101	208	159	250	140	334	108	169	187	138	236	188	158	256	86	268	185	153	329	134	153	138	130	219	92	119	173	175	129	143	284	100	104	128	195	82	117	121	191	106	153	129	122	178	179	151	144	128	124	130	254	122	156	100	179	123	123	139	107	196	130	214	200	119	110	226	206	164	175	154	96	137	108	224	108	92	199	170	124	136	117	186	108	105	215	132	116	288	96	121	147	88	111	130	207	98	74	64	161	171	194	94	161	224	147	115	84	147	178	157	131	113	118	140	107	131	144	94	122	141	125	154	170	151	187	68	134	251	179	95	75	90	97	157	128	111	119	110	109	92	115	119	126	126	138	79	79	149	86	45	149	157	153	151	112	62	135	91	132	134	76	100	111	163	81	152	253	147	189	127	130	115	52	180	82	112	63	61	124	116	179	80	90	124	143	116	70	54	99	130	159	136	102	189	99	113	141	167	154	70	117	90	81	114	102	113	197	100	99	86	98	88	117	70	63	63	71	65	72	79	138	75	149	76	73	97	79	72	68	56	72	193	166	99	95	73	55	62	39	140	108	102	148	82	74	64	136	91	102	79	100	45	52	156	152	165	57	123	141	147	103	77	115	49	83	98	47	104	80	92	65	99	91	112	54	48	101	93	92	84	73	111	78	99	80	53	58	68	80	115	98	39	90	83	67	60	61	58	152	64	121	70	31	60	138	52	86	86	92	34	71	125	79	78	128	71	88	63	37	117	60	65	80	122	123	55	51	91	118	118	145	60	42	99	81	54	86	81	103	64	107	84	43	70	35	78	82	101	57	101	67	68	57	44	51	61	44	40	90	48	82	106	105	126	102	44	114	29	66	37	45	84	76	75	62	121	73	107	98	60	60	66	51	115	57	53	61	65	114	160	34	50	47	51	101	60	75	98	150	74	93	62	79	111	89	90	33	55	66	70	39	63	16	36	62	67	77	54	131	83	37	151	90	61	98	75	64	87	103	88	119	94	48	71	78	28	66	59	38	58	61	43	71	71	78	68	73	68	35	81	45	63	90	64	115	90	70	61	87	51	52	61	62	80	62	87	72	38	71	41	76	65	61	53	80	78	97	50	55	50	79	30	78	55	72	98	52	94	79	55	75	89	70	80	70	80	115	65	70	40	60	64	52	69	61	75	65	54	58	72	27	84	40	44	49	41	37	76	50	26	29	52	62	33	33	86	45	117	75	69	24	87	22	74	55	104	46	68	45	36	53	62	103	17	33	52	54	87	26	27	52	68	55	82	98	30	50	73	25	95	75	16	22	73	31	60	65	90	28	45	63	92	90	58	24	43	80	86	72	16	40	45	51	44	40	48	40	44	32	106	59	16	44	65	47	31	25	65	75	65	79	23	38	37	38	32	77	106	38	61	54	60	25	57	75	28	63	59	100	118	25	43	51	76	69	66	31	22	27	45	66	38	85	96	72	69	18	62	31	40	53	56	54	22	28	26	32	57	84	44	46	31	23	107	41	28	38	43	33	18	49	19	53	30	43	52	30	58	31	24	60	47	42	31	24	25	38	51	35	34	60	33	57	33	56	50	22	63	14	58	47	10	27	110	70	14	20	32	23	43	34	47	77	14	70	39	23	10	36	18	19	49	19	49	44	44	37	41	44	47	33	72	24	56	42	40	38	60	63	27	14	42	57	37	24	15	38	71	33	24	71	39	47	42	54	23	69	22	31	67	21	49	47	31	82	34	46	52	54	23	25	37	23	24	33	31	22	33	47	28	53	33	30	36	61	41	38	58	32	21	33	38	17	35	11	51	25	55	54	16	18	11	54	17	29	53	40	27	26	69	56	16	36	23	26	26	13	23	68	47	29	41	44	15	32	42	30	34	19	73	21	32	61	25	16	64	19	48	33	21	43	41	19	23	32	94	41	14	46	37	53	39	19	25	38	39	30	35	45	49	32	46	22	57	31	39	28	45	25	29	54	45	14	39	27	23	18	39	34	23	36	33	17	30	12	70	34	72	42	28	24	33	23	52	39	74	28	57	52	43	59	35	18	6	50	47	33	22	36	44	52	49	11	41	28	22	69	19	15	12	39	34	40	27	24	28	23	22	30	37	96	29	26	51	18	36	16	44	96	17	19	28	27	7	9	19	49	30	35	31	30	23	29	31	26	36	12	35	2	10	14	22	8	32	18	59	52	27	35	24	14	23	19	47	21	54	20	48	15	34	13	16	29	47	19	32	23	12	37	44	55	38	36	38	30	45	18	57	42	5	39	32	24	78	22	66	32	5	26	10	23	29	47	15	17	24	29	73	12	21	11	52	11	10	53	14	29	38	22	16	39	53	19	18	30	27	35	25	13	28	28	29	27	22	27	59	27	10	16	12	11	26	13	10	43	79	58	25	32	68	7	12	15	27	16	30	28	47	39	27	31	64	24	10	18	24	33	14	30	51	20	5	16	7	14	25	14	26	18	16	2	33	5	7	12	20	17	62	24	25	31	53	19	23	23	34	25	12	8	38	36	23	22	17	27	6	20	16	29	19	3	53	14	30	25	36	25	20	17	21	83	35	10	20	7	10	34	11	40	13	22	16	32	13	13	28	4	40	23	35	19	19	13	18	43	23	6	31	25	19	11	19	21	37	6	14	36	13	5	17	42	43	40	30	23	16	19	19	40	14	18	13	13	16	9	45	18	20	8	29	24	12	36	14	33	24	26	24	28	8	42	8	32	31	26	41	13	24	26	31	50	23	42	23	8	11	18	16	11	14	5	13	27	16	41	14	31	34	10	14	13	17	8	13	0	17	33	11	12	16	13	5	11	15	23	9	13	9	7	28	11	28	2	5	30	0	41	32	10	20	7	21	29	12	14	10	46	31	29	20	19	26	19	12	23	15	24	9	16	10	6	16	19	13	18	34	34	6	28	43	13	20	8	14	0	18	12	8	18	24	16	9	8	12	27	22	27	23	20	7	12	35	7	10	7	35	15	20	6	41	14	25	5	21	10	24	22	19	11	25	35	1	14	17	4	12	35	19	27	14	37	17	42	15	18	16	4	30	29	2	5	28	12	29	8	6	14	35	4	5	21	41	25	7	5	1	11	8	8	19	9	22	54	22	13	10	11	16	9	28	19	23	15	18	13	17	4	12	17	36	13	20	16	6	24	5	13	16	10	23	5	17	7	26	22	17	15	27	30	27	14	3	14	5	8	15	8	11	3	16	26	13	8	18	8	12	9	28	7	14	9	1	6	3	8	17	1	3	16	6	8	5	8	8	72	3	5	31	3	4	15	33	7	17	2	21	5	26	13	28	4	11	25	4	1	14	6	6	1	7	7	3	4	11	6	15	16	11	21	30	3	13	5	14	18	24	2	12	3	8	11	2	6	18	12	22	10	2	11	2	10	23	8	15	12	0	23	3	33	14	4	10	3	14	12	8	24	4	15	9	7	6	6	8	6	23	7	8	12	1	13	1	2	7	5	6	12	6	13	16	27	5	0	13	26	19	8	1	14	16	2	4	5	9	13	3	6	7	14	19	2	3	3	13	1	18	4	16	6	0	20	2	1	15	7	0	4	8	3	10	6	3	0	4	2	7	22	13	1	11	0	4	1	11	13	6	13	7	0	3	5	4	12	5	7	9	4	20	1	4	1	9	0	3	7	1	3	20	7	20	3	10	20	5	1	5	1	4	12	2	4	2	2	2	13	4	5	1	5	4	13	0	14	1	18	2	2	2	7	1	7	0	1	0	4	1	0	0	3	1	0	4	0	5	4	5	1	2	3	4	4	0	2	1	3	1	0	1	13	0	1	1	4	0	0	0	0	5	8	3	0	0	2	1	1	0	1	1	1	0	0	1	2	1	2	0	1	2	0	2	0	1	1	0	0	0	1	0	0	0	0
ne0043	419	564	311	355	358	229	306	231	238	179	205	190	170	149	239	206	129	193	182	152	176	151	212	187	174	145	173	134	126	207	165	129	147	112	141	143	111	178	146	140	97	118	120	106	179	100	82	79	78	97	109	150	128	159	162	120	162	162	108	103	110	103	142	138	136	84	79	98	100	104	92	143	112	125	115	184	108	94	88	84	83	95	142	92	127	100	126	109	95	90	153	72	82	96	54	87	88	100	56	53	87	117	189	66	100	110	57	65	70	119	58	80	60	57	82	90	84	61	135	69	100	65	138	51	83	99	62	97	79	63	123	54	104	72	86	143	68	68	60	78	91	46	69	85	87	63	74	147	54	67	57	70	39	67	67	79	49	68	52	122	62	82	72	117	57	66	54	118	82	141	53	86	57	109	80	57	99	56	77	90	107	58	89	91	76	106	74	46	75	80	89	40	43	93	79	131	46	52	92	45	59	114	70	38	118	46	51	66	47	51	57	74	46	38	24	98	75	120	37	97	122	87	69	45	69	83	58	94	56	56	91	52	92	77	43	76	82	66	86	55	53	78	48	95	111	86	47	34	52	49	62	51	41	101	38	47	54	72	54	89	105	85	42	36	107	26	14	93	78	68	59	56	34	71	37	49	54	25	51	48	57	28	45	116	65	102	40	67	49	31	89	62	73	43	48	61	133	76	34	41	51	64	58	35	31	69	83	91	51	58	95	58	66	80	76	78	39	82	33	46	56	54	52	93	40	145	35	38	43	92	32	22	35	44	37	31	59	66	46	74	42	48	45	60	30	31	31	49	58	54	57	44	48	20	22	19	74	41	50	69	90	43	87	69	48	55	44	52	30	26	69	74	72	33	43	95	64	44	36	51	87	35	42	25	58	34	58	45	32	31	63	59	51	57	26	33	37	45	57	28	51	60	37	32	18	43	62	34	28	55	31	52	24	31	58	70	34	17	43	18	37	62	33	38	42	28	27	31	63	40	91	46	59	47	33	14	37	32	43	33	50	64	12	25	38	45	40	67	40	31	46	33	30	48	42	54	21	43	38	8	30	14	45	33	42	41	56	46	31	26	70	18	26	20	61	31	18	45	39	31	56	51	28	61	24	39	22	56	93	46	39	30	72	48	55	39	19	26	24	18	41	32	26	84	87	34	52	26	19	27	24	43	17	25	32	56	35	45	31	25	51	42	44	40	16	42	32	26	33	8	20	57	18	45	44	71	23	29	87	54	17	28	48	40	51	31	42	34	58	18	26	39	29	24	47	28	16	32	17	35	30	30	18	43	50	38	42	23	43	40	22	52	30	45	37	101	27	10	26	20	41	33	35	24	20	24	24	41	34	22	21	22	47	57	37	50	18	34	12	35	18	27	44	26	37	47	32	32	40	59	32	40	32	56	29	38	31	23	19	35	43	40	27	39	33	20	38	14	31	20	15	16	29	43	38	35	20	19	26	25	18	27	59	15	65	31	40	11	41	18	36	22	50	25	29	25	27	80	27	50	14	30	23	29	39	7	21	41	41	20	39	62	17	76	27	15	29	24	19	36	47	16	28	15	58	16	25	27	27	37	23	23	16	33	57	37	7	41	13	30	21	31	22	24	29	19	21	29	12	17	25	22	48	16	12	26	21	35	20	19	19	21	14	42	45	20	16	35	25	30	25	34	20	16	9	34	33	16	21	32	26	29	21	10	9	16	26	25	21	26	43	27	27	32	25	19	14	42	47	23	23	11	18	25	37	36	35	6	14	6	36	42	9	28	14	10	19	17	18	24	11	18	31	16	34	17	23	19	28	19	14	16	10	38	31	9	22	18	14	36	14	52	24	26	18	4	15	23	8	16	57	36	12	13	21	25	17	12	42	46	27	19	26	12	12	11	9	14	44	6	13	37	7	23	22	17	16	25	42	13	19	28	75	24	24	18	23	15	23	20	24	7	10	13	37	30	14	31	28	23	32	18	14	18	11	20	23	19	23	33	13	39	42	3	14	26	20	14	18	11	5	13	11	22	9	45	15	30	17	19	12	19	27	25	31	8	3	11	15	6	26	17	20	18	21	21	24	19	46	24	18	17	17	25	14	12	19	34	21	29	13	5	19	3	17	39	13	27	18	20	16	8	13	21	26	22	32	8	12	28	49	5	21	16	9	15	21	17	25	8	6	28	28	19	23	24	37	18	20	25	8	19	20	10	19	20	18	26	26	30	21	9	25	14	10	20	11	14	20	16	18	15	8	23	26	39	11	9	11	8	6	13	30	23	23	13	24	16	22	11	14	8	46	11	25	19	15	17	18	24	4	8	18	25	5	18	28	23	12	19	11	5	17	40	16	6	8	27	1	14	21	11	8	10	12	18	8	46	9	19	17	9	29	14	36	27	6	18	13	15	10	10	6	16	13	26	9	22	13	21	16	12	9	6	24	6	12	18	17	3	10	9	37	19	15	13	12	12	15	8	12	6	19	13	16	4	10	4	11	11	20	15	16	12	3	21	15	22	13	19	9	19	15	13	33	16	5	14	18	12	29	14	19	21	2	16	17	15	7	13	10	16	7	13	35	4	14	4	29	7	9	20	10	13	12	8	7	14	18	8	6	17	20	29	14	25	9	18	26	21	9	20	10	20	11	8	4	3	5	3	7	14	18	8	16	17	43	3	6	12	26	12	8	3	10	11	13	18	22	8	7	15	12	21	8	26	20	8	9	10	3	9	14	24	14	8	9	1	26	0	4	5	22	8	15	6	14	21	21	6	26	7	9	8	7	11	16	20	22	12	8	8	1	10	5	31	8	2	23	5	15	25	11	9	6	17	14	31	8	11	8	20	3	16	5	19	17	9	13	17	2	13	6	1	29	11	11	9	18	10	6	8	18	10	16	7	13	10	5	16	16	4	7	22	7	5	12	21	20	28	14	11	10	8	15	17	9	21	7	9	8	6	16	7	8	11	10	20	4	8	13	9	8	11	14	25	7	12	4	15	9	16	27	11	9	17	15	20	19	17	11	6	21	9	11	3	7	5	15	10	9	18	6	15	14	8	27	27	28	11	6	4	3	11	5	17	6	7	9	6	10	6	8	5	9	23	12	16	11	3	3	18	3	19	26	13	6	9	12	28	9	11	4	12	8	10	10	4	10	2	7	8	12	9	2	12	8	6	11	6	2	6	9	16	7	20	20	4	10	4	6	1	8	11	5	20	20	6	9	5	4	16	3	7	8	8	10	4	14	4	3	11	10	18	3	9	21	8	5	17	13	2	7	7	6	7	5	16	6	13	4	9	12	7	11	9	4	9	16	10	7	3	8	0	14	11	1	4	17	13	10	2	1	2	17	2	7	4	16	11	10	2	4	10	4	6	6	5	14	13	7	25	3	7	9	8	8	1	4	7	6	3	8	45	9	2	11	6	12	9	9	10	5	3	7	5	12	0	9	1	10	8	21	13	10	13	9	14	8	3	1	4	7	1	5	6	12	1	8	3	6	6	1	3	11	9	7	1	6	6	1	4	4	3	0	4	12	7	1	5	4	12	3	8	8	1	5	5	8	14	3	3	3	2	7	11	5	3	13	12	3	0	5	4	11	2	4	4	1	0	2	4	5	5	3	9	8	3	3	0	2	2	17	5	6	4	2	5	2	7	4	4	3	1	7	2	2	4	13	2	2	6	1	14	1	3	3	0	7	5	3	7	7	6	1	4	6	7	6	4	2	10	6	4	3	1	1	16	3	4	1	4	6	7	1	2	7	1	3	1	6	5	7	2	9	3	3	2	1	4	2	2	2	3	6	4	7	2	1	3	4	0	4	4	4	0	7	5	4	2	1	2	1	3	1	3	2	3	3	0	2	1	2	4	8	1	7	3	3	2	13	15	7	5	3	1	3	4	5	2	4	2	6	2	7	0	5	3	8	0	4	5	2	5	2	2	1	2	3	10	1	3	1	1	1	8	15	3	2	1	1	7	1	1	6	1	0	3	3	3	0	2	0	1	0	0	1	4	0	0	1	2	0	3	2	1	0	1	0	0	6	1	1	3	0	1	4	2	5	1	3	1	1	6	0	2	0	0	0	3	0	0	0	0	0	0	3	0	0	0	2	0	0	0	1	0	0	0	2	0	0	0	0	0	6	0	0	0	0	0	0	0	0	0	5	4	1	0
ne0044	869	796	491	581	421	459	443	426	409	381	332	349	437	350	372	312	274	313	186	337	375	223	262	229	257	308	319	264	170	340	284	217	276	254	252	273	256	305	237	217	179	225	183	179	129	273	209	200	157	234	224	263	199	256	132	219	164	275	180	215	222	189	218	185	293	138	188	152	205	168	153	195	227	195	179	298	147	172	134	141	179	159	179	142	226	204	103	237	124	146	111	155	190	180	104	142	193	161	94	116	171	106	191	180	163	205	143	163	145	85	128	101	169	155	200	135	199	124	152	174	161	167	183	100	136	176	96	127	185	157	224	73	183	137	118	195	110	96	155	132	148	116	107	124	238	142	112	205	100	107	137	104	123	127	107	124	116	116	172	122	113	147	135	158	112	130	116	142	152	120	103	141	114	194	172	122	172	152	148	132	259	82	173	108	120	157	127	117	138	115	117	82	50	191	153	88	117	143	120	123	136	174	105	70	125	92	109	148	96	91	154	122	91	52	105	202	110	175	110	115	155	120	121	81	131	131	133	100	98	108	108	88	94	113	72	154	130	104	121	104	116	91	64	136	140	136	131	58	104	62	100	62	73	99	69	138	70	123	99	89	88	142	74	75	129	95	63	156	95	117	79	137	80	121	72	108	92	76	126	60	98	60	59	159	136	176	43	86	151	62	147	129	126	50	91	113	84	100	71	89	88	84	141	60	57	78	152	165	90	77	113	92	102	112	149	81	75	211	72	97	91	87	98	189	106	103	104	59	44	125	72	89	77	61	64	50	76	164	63	133	53	61	66	164	76	90	52	71	82	88	89	68	86	54	49	72	72	67	92	51	120	96	45	113	99	118	53	86	102	51	112	71	96	56	76	132	84	81	47	82	182	118	76	57	128	93	62	70	74	59	168	59	75	148	90	71	69	82	73	80	93	100	64	76	71	77	94	47	77	104	64	61	41	59	124	79	88	68	75	28	48	118	90	40	70	96	53	78	80	47	47	54	36	62	46	24	99	57	70	75	77	132	49	49	66	90	111	87	92	67	64	75	42	74	75	64	47	94	55	37	38	25	83	54	42	47	61	49	61	43	91	67	52	41	118	41	34	43	44	50	113	61	99	66	43	44	49	36	50	81	95	61	105	111	82	99	59	44	43	36	38	60	32	45	39	82	70	17	46	53	52	52	42	38	79	103	52	117	64	41	91	60	73	58	54	52	55	27	48	22	40	104	30	93	87	109	28	37	92	87	31	53	64	44	58	35	84	45	79	39	51	72	33	38	55	50	31	58	24	73	43	58	27	43	63	31	57	38	41	66	50	52	43	51	71	90	33	48	38	23	64	48	61	43	34	81	82	74	29	66	44	62	56	81	63	70	42	53	23	58	32	52	44	34	58	78	66	59	50	34	88	38	56	62	46	78	39	47	46	52	57	59	59	53	34	56	63	22	48	50	25	23	38	81	55	62	31	38	30	31	34	23	89	33	72	50	51	21	74	31	59	39	73	32	56	63	40	28	79	30	31	50	38	26	59	23	33	41	52	47	70	36	37	29	50	28	47	47	28	45	48	24	50	17	95	35	62	77	69	44	45	43	26	54	59	31	19	72	28	54	38	39	53	22	33	27	52	43	33	29	40	34	72	69	27	38	41	59	23	59	39	41	22	76	64	33	60	57	54	40	64	44	25	55	24	53	48	20	38	83	52	37	42	26	25	27	21	40	20	57	91	49	36	24	52	40	30	37	76	41	10	23	48	45	62	49	24	28	18	11	41	33	23	31	20	30	16	34	28	22	20	26	33	19	39	22	11	39	24	26	29	39	21	26	86	28	21	32	29	57	25	31	21	42	38	6	34	37	21	15	70	87	31	10	26	74	18	25	38	44	63	29	76	6	29	32	37	23	68	18	52	33	22	51	47	21	29	26	31	31	22	46	28	36	40	21	41	17	25	42	17	25	30	22	39	29	16	46	42	70	40	41	31	25	22	23	39	38	51	68	26	64	50	19	23	53	16	34	26	20	23	20	44	27	23	61	23	50	21	36	26	22	34	28	42	22	39	21	19	16	38	50	25	30	37	38	14	32	12	24	21	26	32	18	21	19	35	58	18	38	14	13	26	4	14	44	20	45	41	32	22	22	36	35	32	24	25	19	37	38	37	9	17	31	32	15	36	32	31	42	19	34	37	17	35	43	47	26	38	21	14	24	33	16	26	30	31	19	27	65	40	20	21	19	23	24	19	23	21	34	17	7	13	34	33	30	14	29	27	16	13	15	54	24	37	26	37	20	21	36	19	25	58	18	46	20	15	34	22	26	4	15	23	29	8	36	33	33	27	9	23	18	20	28	17	17	20	32	16	19	18	27	15	34	18	19	13	46	20	23	49	11	25	6	44	37	15	27	23	21	4	11	7	39	21	14	10	11	33	37	33	25	22	14	21	16	57	9	17	5	11	25	41	32	16	14	22	18	19	16	29	20	19	20	38	15	14	10	9	32	28	23	28	20	24	31	18	40	21	21	14	21	27	27	53	19	5	48	27	9	33	16	34	27	8	18	21	18	13	25	17	18	21	20	37	6	14	5	33	10	4	32	25	19	6	6	10	26	19	16	28	35	24	43	20	17	8	12	27	13	21	11	31	22	11	16	13	7	6	23	24	20	32	23	13	23	38	26	6	9	20	22	17	10	52	13	25	22	27	9	10	17	19	22	21	29	52	12	4	20	4	14	28	19	35	17	17	3	28	7	11	10	25	16	26	18	18	24	29	23	15	26	24	10	10	10	18	21	30	11	16	14	11	19	14	26	26	6	33	15	24	32	17	22	7	23	37	6	25	17	41	23	10	30	8	34	21	3	12	26	16	11	13	5	38	41	12	9	25	9	13	23	13	17	65	9	14	8	18	13	17	20	9	43	26	13	12	19	34	29	12	36	13	31	15	18	12	6	4	11	19	8	14	5	17	10	18	31	10	20	6	24	7	21	24	31	4	32	4	17	10	61	19	13	12	15	27	35	21	24	14	6	10	7	28	3	27	13	30	10	18	38	8	28	11	10	5	12	31	7	5	8	3	13	9	10	16	13	10	7	9	16	6	21	7	12	13	20	43	1	6	27	4	21	27	12	21	23	17	35	15	10	3	21	24	27	9	9	14	16	17	33	24	27	6	13	17	5	15	8	12	9	8	9	6	25	22	6	16	5	19	12	13	33	4	12	14	7	8	6	9	13	5	15	16	13	7	9	17	2	9	15	17	14	7	6	37	9	9	16	25	10	12	14	28	14	17	30	4	11	18	12	12	19	17	18	12	9	3	16	11	12	11	3	11	13	4	22	15	7	10	5	0	7	18	3	5	5	37	23	8	9	4	8	10	8	8	9	12	25	6	24	8	11	14	20	24	3	10	12	13	6	15	6	9	4	22	12	14	9	6	10	8	7	21	9	14	5	11	5	11	11	26	1	21	22	7	15	10	5	2	5	11	11	9	8	7	4	21	5	30	6	3	6	13	4	4	4	4	3	2	13	10	6	7	8	5	17	6	5	8	0	4	8	13	3	8	5	11	16	10	6	11	8	26	14	8	5	8	22	6	7	7	1	7	5	15	14	5	3	3	9	10	11	4	13	11	0	3	3	8	1	24	13	10	11	5	6	4	5	7	21	12	2	4	7	2	4	15	4	7	5	2	5	3	15	6	2	6	9	6	6	3	14	5	4	10	4	10	5	9	4	13	9	0	1	2	5	13	11	4	4	3	2	2	1	2	12	1	0	5	18	8	10	8	3	0	2	6	4	6	1	1	6	8	3	9	0	5	7	5	4	7	2	7	4	6	4	8	7	33	7	2	8	2	0	6	7	1	2	0	5	2	10	6	4	5	3	1	1	5	10	7	21	2	2	6	6	6	7	1	9	3	5	5	3	5	2	4	3	3	8	1	1	3	3	4	5	3	11	0	2	1	1	0	1	1	2	2	2	2	4	7	1	7	5	2	2	3	6	4	1	1	2	5	0	1	2	0	0	0	1	0	2	2	3	0	1	9	0	4	6	0	2	1	3	5	1	2	3	2	0	4	2	0	2	0	0	1	3	0	0	0	1	2	0	3	0	1	0	0	0	0	3	1	6	1	1	2	0	1	0	2	1	0	0	0	0	1	0	0	1	0	0	0	0	0	0
ne0045	489	676	351	478	277	364	361	319	245	264	186	262	297	247	360	277	234	218	221	256	235	199	287	154	211	189	204	196	149	342	210	170	199	175	178	236	160	178	141	194	143	198	174	128	102	195	141	132	122	154	186	191	118	159	71	184	105	190	133	109	156	125	166	102	198	99	114	98	121	147	112	133	169	182	124	189	136	138	101	101	131	79	131	135	130	147	78	162	94	121	101	107	136	128	76	97	139	84	97	107	167	93	110	113	119	152	106	109	125	53	76	56	111	101	142	143	130	99	96	128	106	107	186	62	80	128	66	80	126	105	154	60	142	114	129	317	86	84	107	102	105	81	53	102	118	107	80	131	65	108	98	72	99	69	57	82	78	66	106	80	97	119	107	170	87	77	63	139	93	131	73	89	78	218	109	69	118	99	81	106	141	92	74	97	78	99	82	82	72	66	91	49	41	115	83	84	82	91	96	94	77	113	70	74	153	77	74	98	89	69	100	80	65	59	111	135	77	139	82	83	139	57	71	51	128	82	104	146	70	90	91	56	75	75	49	122	95	78	83	71	43	94	58	100	55	100	124	47	87	96	87	52	53	68	63	88	89	96	53	76	63	105	53	55	86	49	36	91	79	67	63	82	54	72	51	61	54	64	80	33	84	38	48	151	95	84	85	62	59	40	96	92	88	57	64	75	76	76	46	65	71	78	75	74	38	67	58	124	50	58	57	72	64	94	87	42	46	75	46	95	68	87	58	133	30	88	48	56	46	43	33	52	38	50	46	32	55	106	71	104	34	34	115	90	53	46	36	70	78	64	60	46	59	52	40	62	77	64	55	51	63	47	38	57	66	46	52	66	65	31	72	34	84	25	57	64	65	67	58	60	99	69	64	41	99	46	50	63	50	42	75	45	41	51	56	35	54	71	49	49	62	70	76	42	43	62	59	41	72	52	52	48	33	47	77	60	50	31	65	19	55	78	38	55	81	47	45	47	78	44	41	53	27	54	30	20	65	31	54	42	59	106	32	36	74	74	34	48	43	24	49	58	32	39	51	44	32	58	38	16	34	13	64	35	51	30	42	46	45	32	37	30	41	30	74	63	15	14	40	43	52	59	62	58	28	33	41	46	64	77	29	43	78	60	43	42	25	32	28	27	35	33	38	35	62	47	52	23	39	50	38	63	24	27	62	85	35	38	65	36	53	30	45	138	37	45	47	42	58	21	46	96	20	59	44	81	32	47	98	41	25	52	30	43	42	29	42	43	77	19	53	60	24	32	63	45	21	35	15	31	21	74	12	24	27	29	48	30	34	34	40	39	19	26	41	41	26	40	32	35	38	31	36	37	33	23	55	73	55	25	36	46	31	64	24	40	17	57	28	22	18	27	52	33	49	62	32	27	29	28	42	51	32	51	34	30	27	29	28	39	26	67	36	50	32	44	53	18	30	25	19	22	31	42	40	42	18	24	13	15	23	23	60	20	51	27	62	8	50	26	42	17	53	31	34	24	22	15	47	31	11	35	24	28	62	15	33	40	31	28	40	54	27	24	38	6	30	35	11	32	45	26	47	11	51	19	29	42	45	18	28	43	25	31	40	21	25	68	15	33	17	27	33	29	36	30	28	32	19	32	22	25	53	35	25	46	31	34	49	32	42	38	22	31	41	26	43	47	37	26	30	32	44	33	22	27	23	21	30	53	45	24	29	18	14	22	24	28	26	44	57	39	22	13	17	29	25	27	40	22	23	16	39	38	19	30	52	11	24	17	32	21	14	32	24	16	13	30	19	27	14	20	54	15	31	12	16	31	13	20	29	32	21	9	35	12	16	23	29	26	19	21	9	46	33	13	21	27	17	34	53	50	20	16	7	46	12	17	44	36	41	16	35	12	11	23	36	15	27	20	18	18	11	32	25	12	15	19	31	24	18	29	16	36	16	23	28	17	15	32	16	12	10	14	32	25	18	25	24	20	22	19	20	27	14	6	42	18	13	40	10	42	41	11	26	40	32	19	17	8	16	16	20	38	19	41	14	30	14	31	20	18	20	15	33	17	17	20	12	10	36	15	18	29	28	21	8	26	8	22	27	13	8	15	19	29	13	45	20	20	25	3	13	5	14	42	21	62	23	14	14	11	22	36	19	29	28	25	24	26	20	8	10	25	21	7	32	23	25	20	12	9	29	14	16	29	53	25	27	14	4	28	14	16	12	25	28	13	16	31	29	8	11	19	20	11	15	10	16	27	19	20	21	30	20	42	9	19	7	18	17	11	32	33	12	23	39	24	21	31	11	10	47	11	49	18	7	13	9	14	6	8	7	15	5	29	19	32	17	16	20	14	36	20	10	15	9	24	4	22	17	10	15	18	6	12	19	31	21	26	28	5	10	8	23	58	8	21	25	16	2	3	14	20	12	7	8	13	14	30	26	17	13	10	15	13	12	4	12	6	19	21	12	22	8	11	6	17	7	32	14	10	6	15	15	17	17	4	8	18	29	20	15	12	3	12	8	11	15	24	12	27	24	20	27	12	5	25	15	18	21	22	34	9	9	16	19	15	20	23	13	14	6	11	31	5	7	2	15	18	5	26	7	12	12	19	4	7	8	15	18	35	18	6	21	37	7	18	16	16	17	9	2	16	9	15	10	4	11	3	19	9	24	18	8	13	31	4	3	12	10	14	13	10	32	16	11	15	25	17	6	11	16	17	6	19	8	21	8	19	8	10	40	28	22	11	8	2	7	3	4	15	8	13	19	12	11	12	24	12	32	16	16	6	17	9	7	18	39	15	8	15	1	3	4	14	15	3	12	11	24	19	14	6	1	5	14	4	13	11	18	19	2	31	4	40	5	8	12	17	5	3	8	6	29	17	20	6	18	2	10	26	18	14	19	7	6	10	12	9	24	15	5	27	9	11	9	14	29	22	14	19	10	8	11	22	7	4	9	9	18	5	14	5	17	5	6	28	2	17	6	18	6	21	17	16	13	16	2	11	28	19	33	7	9	6	19	20	8	42	4	10	5	8	11	16	13	4	9	22	10	13	11	9	11	7	0	8	10	10	7	14	1	16	7	4	3	13	13	1	4	27	9	13	9	6	13	4	14	0	4	16	2	14	19	7	4	12	8	11	11	4	7	15	9	8	6	4	25	6	18	12	10	11	6	12	18	1	16	7	12	8	12	4	4	5	15	4	6	4	7	2	4	21	8	17	14	3	15	6	5	12	2	14	8	5	8	5	23	3	6	8	10	11	9	8	18	13	19	41	4	6	2	10	12	8	10	19	4	0	4	1	7	12	6	9	9	18	6	10	11	9	11	5	11	10	3	3	25	7	6	2	3	12	11	2	3	3	18	21	7	4	8	3	7	5	4	10	10	6	4	13	6	6	5	11	7	8	5	2	26	2	13	2	9	8	27	0	4	4	5	6	6	16	5	7	18	3	23	8	5	4	2	7	5	15	17	15	6	7	3	5	5	3	3	0	3	4	9	1	11	5	4	3	9	4	5	8	3	4	0	10	3	13	1	5	3	9	1	2	0	0	1	5	7	5	2	3	7	4	2	0	4	6	3	11	14	2	9	11	4	6	9	2	18	0	4	7	3	2	3	11	5	2	2	8	9	0	5	1	0	0	2	5	11	2	1	5	4	6	1	4	2	0	5	14	4	0	14	4	4	3	5	12	4	3	11	2	0	1	3	0	6	8	5	13	4	5	12	2	2	2	9	4	4	4	6	1	11	2	0	5	1	0	3	4	5	1	6	4	2	4	2	4	6	4	0	1	9	2	7	4	0	3	11	5	7	5	4	1	0	1	4	7	1	5	3	4	12	0	2	4	0	4	0	2	2	8	1	1	0	1	2	2	3	0	0	1	0	0	1	16	4	1	2	1	2	0	2	2	1	2	0	3	2	2	3	4	2	5	0	1	2	0	4	2	5	2	7	4	1	2	0	2	1	1	1	2	0	1	2	4	2	1	1	4	1	4	6	4	3	0	2	1	5	1	5	0	0	1	0	1	0	2	0	3	0	3	1	1	1	0	0	0	0	1	0	0	1	4	0	0	1	3	0	4	0	0	0	3	0	1	0	0	2	1	1	0	1	2	1	0	0	0	0	1	0	0	1	0	0	0	0	1	0	0	2	0	0	0	0	0	0	0	0	0	0	0
ne0046	488	622	337	417	282	325	328	300	259	257	218	255	223	193	237	195	188	201	205	201	199	140	178	231	189	210	218	176	182	179	157	130	191	158	132	150	151	148	156	107	131	133	131	134	179	140	155	127	110	112	151	150	129	114	172	134	146	169	122	113	137	140	130	94	154	108	121	113	117	124	106	117	120	106	129	157	126	110	90	105	100	86	194	108	172	137	101	128	87	112	189	77	124	80	64	100	116	107	88	89	121	160	166	102	136	123	134	108	81	133	89	74	103	92	126	121	115	62	92	117	92	114	146	69	86	133	87	78	106	96	124	57	129	109	88	189	74	80	98	99	73	63	82	95	68	83	85	162	57	87	82	79	74	101	73	84	85	58	99	139	84	91	72	101	70	93	76	67	85	162	50	101	55	99	96	67	106	84	81	82	112	67	75	76	55	98	59	80	77	60	79	49	36	92	91	163	110	90	58	62	85	102	69	65	125	65	73	90	38	63	86	81	58	55	34	95	66	99	73	89	94	52	85	60	62	63	65	84	56	69	61	76	64	92	43	114	66	69	57	76	50	79	92	94	67	110	70	40	65	53	82	63	45	80	60	80	77	93	62	62	143	87	48	41	80	45	39	68	68	58	72	73	50	83	50	98	65	46	61	51	74	37	54	130	89	102	47	63	62	36	92	68	80	51	83	55	133	63	56	66	61	56	75	45	45	79	74	83	35	45	65	65	62	80	89	45	55	73	54	74	48	54	71	104	42	138	63	47	47	80	38	49	40	64	55	37	51	77	55	84	25	50	74	62	54	38	41	46	52	65	70	56	56	34	43	50	62	47	53	37	39	64	113	60	53	57	44	62	42	38	55	44	77	31	61	89	53	50	39	68	66	49	64	42	51	70	48	56	59	41	61	103	69	55	36	57	36	63	54	49	47	51	56	43	39	41	60	43	46	55	50	36	40	43	64	45	50	31	42	26	45	77	51	46	40	51	47	39	70	30	115	33	41	28	23	24	55	35	40	49	44	89	19	30	43	64	45	35	33	35	54	38	26	52	40	49	27	49	40	15	34	29	38	46	40	41	39	42	36	30	93	25	31	36	71	31	17	32	29	43	68	45	35	47	32	32	40	51	112	33	50	33	74	40	45	53	25	28	28	26	38	32	34	104	103	40	44	14	37	34	32	43	36	18	46	63	50	43	43	25	63	34	42	32	35	50	45	28	27	16	46	34	28	45	26	75	22	23	66	35	17	50	25	29	34	25	25	36	43	19	49	46	38	33	29	25	25	45	17	49	22	63	20	29	33	28	47	36	27	31	30	23	26	41	50	106	43	26	40	20	42	33	43	29	24	36	27	33	25	36	20	19	22	53	27	69	25	33	20	24	33	33	60	25	49	41	39	42	34	57	40	51	25	43	24	28	31	36	27	37	35	45	30	20	52	37	25	15	37	26	16	43	31	51	38	35	25	21	23	24	22	24	38	13	40	40	42	13	44	24	30	26	53	26	40	24	36	91	28	33	18	35	33	26	44	19	29	38	29	30	73	48	13	107	22	15	34	29	37	28	28	22	29	21	51	11	26	43	26	22	29	34	28	28	40	36	16	26	12	34	18	23	21	33	30	39	42	31	30	19	32	25	35	26	16	25	23	51	30	28	22	27	25	39	31	32	24	45	42	24	24	24	31	31	22	29	35	25	23	17	27	23	21	7	19	19	22	28	12	39	53	49	17	23	25	17	27	28	38	17	20	16	26	32	26	29	28	28	17	13	29	25	20	25	30	21	31	27	29	22	19	22	39	23	33	19	15	21	20	24	23	31	27	19	47	14	24	17	27	28	15	21	16	21	21	7	20	15	18	14	39	48	25	14	24	31	24	18	22	23	28	11	37	15	13	26	26	11	22	26	16	22	13	38	16	16	18	21	27	10	24	22	90	28	32	26	28	14	10	27	16	7	14	19	46	13	20	23	21	33	23	15	18	19	14	19	30	18	20	24	15	45	42	19	32	35	30	20	29	9	14	15	20	33	19	38	20	27	18	13	17	22	27	21	17	13	17	15	13	12	34	14	22	21	11	13	18	25	15	27	15	10	19	19	10	18	17	30	10	22	15	13	21	9	20	29	9	17	18	21	31	8	26	27	25	10	26	19	25	22	28	16	19	24	12	2	30	18	14	19	14	24	27	22	19	33	33	30	23	8	10	18	13	18	26	12	28	15	26	38	23	9	6	18	16	19	13	6	18	19	15	14	9	32	25	23	10	16	15	14	13	23	23	13	13	15	35	15	14	28	30	11	41	12	29	17	4	15	11	25	3	13	10	6	12	15	20	32	13	7	23	17	18	14	15	12	19	15	12	9	18	7	12	21	7	12	6	26	9	11	22	12	5	28	20	49	19	30	14	21	8	4	8	15	16	13	5	18	10	27	24	11	9	13	28	2	13	8	14	7	10	19	16	14	7	16	14	23	11	12	11	7	11	13	11	10	14	16	3	17	17	14	14	10	11	22	7	17	16	16	7	15	14	14	18	20	3	14	17	14	10	19	20	8	6	32	5	14	14	25	12	6	8	7	25	8	10	4	23	13	5	18	9	12	11	9	9	16	12	10	12	33	11	11	7	9	25	7	22	11	11	9	8	23	20	14	10	4	10	11	14	10	17	25	3	14	23	9	6	6	15	8	14	6	13	20	8	19	21	7	16	9	13	16	6	15	28	6	6	12	4	40	19	15	16	10	13	0	13	6	8	8	12	24	11	28	4	11	17	6	20	8	11	10	6	8	7	18	13	13	11	11	6	11	1	12	9	0	13	7	18	8	9	6	6	7	14	9	7	18	12	20	3	16	5	24	4	4	8	15	8	7	18	8	27	6	14	9	14	6	10	25	5	13	32	7	2	7	10	15	11	12	5	27	9	10	15	8	16	14	10	14	7	10	5	17	11	5	5	6	17	9	13	16	7	6	7	19	8	9	5	11	2	9	17	26	6	11	6	16	12	33	24	8	7	22	12	20	9	33	6	8	9	12	3	7	8	3	4	9	12	9	3	9	11	16	7	6	16	7	9	1	4	15	9	6	15	7	11	9	7	15	10	4	6	8	10	4	6	9	4	13	5	14	17	7	8	5	11	13	12	2	10	7	12	16	6	7	10	5	13	9	7	13	3	13	15	4	9	11	4	11	6	4	8	7	16	7	7	6	6	1	4	13	8	3	9	7	3	6	4	12	0	5	7	9	1	5	25	3	4	8	11	8	3	23	11	8	14	7	8	8	6	8	6	7	6	16	7	2	6	3	8	10	8	10	6	13	17	10	15	3	5	3	14	18	4	8	29	6	15	3	2	13	9	4	6	5	12	18	3	1	4	2	6	12	4	4	8	4	7	7	6	3	6	4	6	6	6	1	17	5	8	3	15	3	19	4	5	2	3	6	3	10	6	1	20	1	15	2	13	7	7	7	4	14	9	8	11	7	0	2	6	3	6	0	7	9	11	3	5	8	2	2	7	12	4	3	6	7	0	10	6	7	3	6	3	4	4	3	18	4	4	6	12	2	2	0	4	3	9	5	8	1	8	6	6	1	4	17	3	2	6	9	3	0	4	3	8	1	3	9	13	4	3	8	11	1	4	0	0	2	9	3	7	3	1	6	1	4	1	3	7	1	4	5	1	6	18	2	6	3	4	6	3	5	5	2	2	15	1	4	6	9	3	6	9	7	5	5	5	10	9	4	1	3	1	21	5	7	2	7	2	0	5	1	6	11	3	1	0	3	2	1	4	0	6	1	6	5	4	4	1	4	9	4	6	1	6	2	6	0	2	3	3	6	5	9	5	4	18	0	1	6	0	2	3	7	0	0	0	1	3	0	2	1	4	4	0	0	1	8	3	7	2	2	2	4	6	2	0	3	2	3	4	2	1	8	5	0	3	3	0	5	4	2	2	6	4	3	0	1	1	0	0	3	5	2	13	2	0	6	3	0	5	3	0	4	11	5	2	2	0	2	4	0	1	0	0	1	0	4	0	2	0	1	0	0	2	0	3	1	1	0	0	1	0	0	37	0	0	1	1	1	0	4	3	1	0	1	0	2	0	5	0	0	2	0	1	0	0	0	0	2	1	0	1	0	0	1	0	0	0	0	6	0	0	3	2	0	0	0	1	0	0	0	1	0
ne0047	506	712	317	393	332	314	364	290	237	272	216	249	244	219	262	203	197	184	224	207	219	183	180	205	170	226	246	193	136	248	209	120	199	168	170	182	138	167	149	148	106	164	121	129	201	151	131	117	124	146	139	174	134	190	160	144	146	186	140	122	143	122	177	121	173	103	133	125	125	118	112	134	139	101	139	189	101	117	83	95	113	89	201	125	139	114	78	129	90	112	160	103	129	102	64	87	113	118	89	87	145	166	209	118	103	135	96	112	94	129	115	78	97	104	142	98	115	73	119	108	110	118	128	65	92	115	52	81	107	94	156	54	146	92	113	141	61	62	99	87	82	62	80	94	104	90	80	136	60	92	107	73	71	71	79	77	62	77	98	168	66	102	111	111	77	80	57	106	103	186	76	60	76	129	95	61	123	95	84	52	172	83	95	56	81	96	93	64	82	70	70	78	70	123	86	161	72	91	69	87	87	124	84	58	139	56	76	105	49	58	92	83	61	35	93	102	96	121	86	92	116	59	82	67	102	90	78	119	61	40	71	48	83	83	39	123	86	90	78	77	91	65	52	97	72	111	77	50	55	49	70	67	56	68	75	81	42	95	68	83	130	103	33	70	79	43	54	98	66	67	69	58	39	60	59	64	60	43	58	55	88	43	37	113	112	73	43	57	71	42	94	58	80	47	76	63	145	63	55	40	61	59	81	43	42	65	79	107	47	42	75	80	63	89	79	49	46	114	61	73	62	76	42	117	45	146	63	62	40	59	45	39	43	55	52	33	46	181	39	83	42	48	101	84	39	49	38	50	76	71	59	58	56	36	44	48	57	48	56	45	43	43	116	87	88	50	39	67	51	36	73	65	75	33	50	88	51	44	39	55	120	52	43	32	61	28	52	46	36	46	107	70	52	62	69	48	33	45	44	46	51	79	42	50	46	38	59	51	57	46	43	36	20	35	55	45	56	53	63	29	46	61	63	52	43	40	18	49	79	32	115	55	47	32	31	19	58	37	45	34	45	82	26	26	60	53	63	35	47	44	53	56	31	37	47	55	26	50	25	16	29	29	47	33	40	36	44	75	40	50	93	42	42	33	68	45	18	48	28	47	41	55	42	52	32	35	22	65	126	40	75	29	70	61	38	41	28	48	30	35	23	42	19	102	109	36	59	12	48	30	24	47	26	26	36	77	32	53	31	29	51	54	55	19	31	35	28	25	35	18	34	49	22	48	59	76	24	31	47	52	27	53	29	31	40	37	52	30	87	25	50	48	36	21	58	43	27	34	20	34	37	75	24	33	23	24	22	26	23	42	33	25	40	30	24	124	35	25	45	27	42	32	37	31	34	36	41	45	29	39	25	28	50	51	35	35	36	47	12	33	23	33	43	43	30	38	45	34	41	74	49	47	31	40	38	28	37	21	53	40	32	56	43	28	52	29	37	16	27	14	25	23	27	34	35	35	28	22	22	35	18	23	69	26	61	38	47	15	48	25	36	18	56	28	32	15	24	89	40	40	16	37	40	17	58	17	26	33	37	27	53	45	20	93	35	12	42	29	17	36	26	26	44	18	77	23	64	50	32	32	27	34	30	39	31	23	13	57	17	33	26	16	20	30	41	45	48	31	19	35	53	38	33	24	26	42	28	36	30	29	27	22	22	41	40	23	34	47	28	26	24	28	26	43	22	48	47	20	22	28	32	31	34	12	15	23	12	37	22	51	31	29	30	18	36	33	34	25	49	22	16	16	18	27	21	41	24	44	27	10	58	24	12	22	19	17	21	29	19	29	11	31	36	27	19	25	12	26	20	22	19	25	22	34	57	7	23	24	26	34	16	23	11	29	24	12	21	40	15	13	54	17	25	9	28	27	25	13	39	29	25	19	17	13	11	21	17	19	19	12	26	15	23	42	26	25	20	27	35	35	22	17	88	26	26	18	30	7	22	32	19	12	15	23	54	22	10	32	21	51	35	17	15	31	11	25	28	10	34	22	12	35	44	14	30	38	24	11	21	9	7	24	19	46	23	38	36	24	13	17	14	17	15	25	43	6	16	23	17	9	42	20	12	14	23	27	21	23	7	38	22	14	18	19	11	31	28	38	12	24	18	13	10	6	20	27	22	28	26	34	21	6	21	22	17	32	42	13	19	27	14	12	14	17	21	7	22	17	25	22	9	28	48	7	11	33	17	35	23	10	27	33	21	24	18	28	26	17	22	46	25	25	12	16	17	13	10	10	16	30	25	9	13	32	22	19	7	15	17	17	16	15	34	21	14	13	19	14	26	25	18	11	34	17	28	21	4	25	21	9	5	18	18	16	12	18	19	24	13	8	23	18	28	26	12	13	11	30	13	15	10	13	12	18	9	13	8	37	23	21	23	13	25	23	17	31	13	73	12	16	18	7	7	37	12	20	16	18	17	24	23	7	13	6	13	8	8	12	17	4	20	15	31	21	17	21	16	9	8	17	15	14	7	10	32	11	14	6	12	15	18	27	16	21	10	13	18	21	13	16	6	15	37	13	16	16	4	19	13	16	21	16	17	24	8	18	11	11	16	25	20	10	8	23	31	8	8	7	31	18	5	26	21	9	11	11	8	15	15	9	17	21	13	16	12	9	10	5	12	9	11	9	11	16	7	11	10	5	4	13	15	7	36	12	5	13	31	14	9	10	18	12	14	5	15	14	12	13	23	14	5	11	13	13	9	13	16	6	7	7	2	14	18	15	16	8	15	1	11	11	6	11	12	16	25	9	13	13	23	7	15	9	10	4	10	20	17	13	29	8	12	6	6	9	7	9	22	3	11	8	23	15	16	8	8	8	12	12	14	33	13	15	4	21	12	23	20	5	14	14	13	8	11	7	27	27	24	3	18	14	8	25	12	9	40	15	8	9	11	8	23	8	9	21	23	10	7	13	21	24	17	19	11	16	8	16	6	8	5	8	13	14	8	18	3	4	24	19	2	10	6	13	7	9	15	22	1	18	7	11	16	43	28	10	16	11	17	22	17	37	11	6	4	6	6	5	8	3	7	21	14	10	8	7	7	7	7	11	8	8	15	7	8	6	14	6	11	13	9	8	11	22	9	7	9	5	21	7	11	0	3	13	5	11	27	10	7	11	11	16	8	16	14	15	19	10	7	14	17	14	14	13	8	10	4	4	9	7	16	8	13	6	8	11	8	10	11	6	9	3	4	5	11	15	3	6	17	6	8	14	3	8	6	16	7	11	9	11	23	2	6	13	5	7	2	7	20	13	6	3	7	5	7	10	12	8	11	20	8	6	7	6	13	10	12	20	2	10	14	20	15	6	12	2	11	12	3	8	23	7	8	1	1	7	9	6	6	3	18	13	5	4	9	5	4	15	7	14	12	8	5	18	13	8	14	8	6	10	5	10	23	7	13	4	21	4	14	8	1	3	3	7	2	4	2	5	7	4	24	4	15	16	15	4	27	19	8	8	9	4	3	2	5	5	6	1	8	4	13	3	9	10	2	2	11	2	10	3	2	15	0	10	3	7	4	4	9	12	3	3	12	4	9	5	3	4	2	3	8	7	8	5	8	1	9	7	9	1	8	14	4	2	7	8	14	2	4	7	5	1	1	5	5	8	3	11	10	5	6	1	1	3	10	4	5	8	5	4	1	6	4	7	5	1	2	7	2	3	7	2	4	7	0	4	6	0	3	2	3	2	3	2	1	5	5	4	4	6	1	5	2	7	11	4	1	4	4	20	14	5	1	7	3	3	3	4	4	0	3	0	4	2	7	5	1	3	9	1	14	5	4	3	1	5	9	2	3	0	4	0	6	1	5	4	12	3	2	3	6	1	6	14	2	9	3	0	2	6	1	2	3	0	1	2	4	5	4	2	6	0	6	16	6	6	3	0	0	5	5	1	3	5	0	2	4	0	4	5	2	1	3	4	0	4	1	6	3	4	2	4	1	2	1	1	1	1	4	4	4	5	2	2	4	0	3	6	0	4	4	1	5	1	3	3	1	0	1	1	1	0	0	2	5	2	3	3	0	5	1	2	1	4	2	0	0	0	1	1	0	2	1	5	2	2	0	1	2	0	0	2	0	0	0	0	2	0	2	0	2	1	1	0	1	2	1	1	0	0	1	0	0	0	1	0	0	0	0	2	0	0	0	0	0	0	0	0	0	0
ne0048	1636	2338	1189	1270	1104	1024	1180	951	915	979	770	824	787	741	922	633	562	808	596	734	684	560	543	595	638	706	722	722	443	843	700	412	607	588	619	690	496	690	543	508	451	546	422	393	437	434	434	360	391	554	472	602	402	441	360	473	543	678	435	344	455	465	628	426	656	314	353	420	462	480	320	458	389	501	433	627	447	428	291	359	418	313	480	391	515	438	350	488	349	334	447	340	427	356	236	256	372	431	209	232	494	409	501	349	379	468	273	337	358	272	319	245	313	286	432	246	391	284	361	334	358	323	466	176	287	443	244	232	374	300	546	160	435	350	381	679	251	262	312	391	297	236	188	349	372	347	282	484	217	266	333	362	297	246	272	280	256	224	290	462	272	358	316	425	240	288	256	385	378	417	205	336	270	462	323	234	393	288	329	329	605	281	315	245	200	321	283	224	283	231	251	257	143	401	290	371	267	274	267	312	291	403	243	220	480	207	288	363	161	218	283	244	191	100	178	350	333	434	286	366	435	204	297	193	322	238	327	413	225	301	253	196	308	321	120	379	325	249	258	310	224	218	254	324	336	384	293	122	252	179	257	224	143	259	242	246	212	341	209	243	334	348	146	214	333	138	138	314	298	284	238	258	143	274	155	228	198	122	267	132	269	128	165	514	299	441	224	229	234	119	345	206	298	190	246	300	332	210	168	190	263	192	298	156	114	198	307	320	160	181	293	230	241	246	277	190	151	314	137	249	227	234	216	371	142	371	220	195	169	278	117	169	110	138	164	107	212	268	217	330	124	133	326	307	162	144	128	199	235	214	208	218	222	129	122	174	312	145	233	212	235	197	242	271	216	135	204	247	179	100	289	215	309	63	236	286	204	193	193	213	254	245	205	152	205	178	182	181	140	174	261	226	166	178	173	168	162	206	199	126	259	221	147	155	109	145	218	150	196	220	196	157	85	148	158	173	225	153	155	78	119	298	176	168	135	190	109	145	196	144	263	174	126	172	102	37	213	92	131	179	200	349	92	122	231	214	212	143	139	92	235	146	98	152	160	205	71	195	127	54	74	56	195	150	131	104	164	147	155	98	198	155	79	102	190	122	56	104	163	124	224	210	171	199	88	131	99	143	306	142	147	149	281	258	181	200	84	98	91	111	121	193	83	215	242	154	227	78	120	119	90	192	100	84	160	211	141	197	149	108	196	172	161	78	124	165	137	127	175	53	152	195	90	189	251	269	70	117	241	187	71	166	135	97	166	81	194	116	194	106	163	166	82	99	185	177	49	143	51	156	121	221	92	84	97	80	135	59	176	133	88	104	107	116	147	260	101	87	119	125	150	115	120	90	96	124	107	135	119	116	101	104	124	203	140	179	80	149	62	94	54	95	180	68	139	131	148	113	169	179	131	147	123	176	119	100	131	108	97	137	114	188	125	146	144	142	138	57	117	78	58	42	104	144	129	137	62	38	87	104	75	65	176	78	165	152	203	28	181	67	167	65	200	163	145	105	115	180	148	132	54	172	119	68	179	48	105	135	123	84	167	159	67	181	117	22	146	132	39	127	125	72	144	72	155	62	144	160	125	114	133	147	112	134	146	104	37	168	68	136	117	70	94	101	153	101	105	103	78	96	99	138	162	132	125	128	83	149	45	102	72	107	86	153	124	100	111	147	126	136	105	145	106	138	60	128	103	97	72	117	109	100	87	36	51	71	69	95	56	165	181	137	99	45	87	89	82	75	142	116	45	53	113	77	80	144	69	109	82	47	129	85	49	102	36	54	71	93	85	84	59	54	152	66	101	58	39	80	89	62	87	89	50	96	123	30	60	85	115	104	70	79	60	50	80	19	70	95	58	65	211	146	61	31	90	53	59	44	136	104	45	55	121	23	38	67	87	86	86	34	99	102	42	121	65	118	77	87	139	81	65	82	167	106	124	62	190	27	63	121	92	28	34	57	189	74	50	122	89	101	134	56	51	93	37	63	114	63	101	100	86	151	135	34	113	145	100	73	73	31	35	47	54	97	59	145	68	112	49	55	78	83	123	83	138	42	42	79	58	16	122	44	85	46	99	74	47	85	29	88	64	57	62	73	46	122	67	100	43	93	71	35	38	17	65	114	86	79	95	97	91	26	70	105	94	83	149	66	73	101	84	17	41	93	54	24	70	90	103	51	32	87	111	45	78	116	129	120	116	80	55	84	81	57	67	64	85	51	106	102	76	47	63	69	77	73	26	63	63	85	60	35	75	128	84	84	31	74	43	60	40	38	119	74	51	52	118	38	56	76	65	31	171	50	122	66	35	71	82	46	10	40	44	78	39	63	84	110	62	47	71	55	88	99	39	23	30	77	30	45	40	65	56	46	39	44	63	133	96	51	80	26	70	32	86	163	39	79	47	43	23	22	40	77	36	59	34	48	98	87	72	51	34	29	58	31	46	31	68	19	45	68	71	61	57	58	56	87	43	68	44	30	57	58	101	48	48	13	41	65	51	68	64	67	34	79	48	74	30	60	51	78	86	71	71	72	23	70	43	58	73	53	101	61	9	74	33	58	64	79	77	45	36	63	105	18	22	17	83	52	13	73	55	33	41	32	29	58	60	39	66	81	70	40	40	15	33	56	101	49	48	22	52	68	60	43	25	13	16	13	68	27	87	69	22	59	127	68	25	33	76	70	66	23	66	42	45	53	94	36	14	40	47	40	19	67	52	30	48	38	13	32	105	52	57	32	40	4	72	21	16	45	59	41	53	51	40	87	94	27	60	38	64	40	33	18	55	42	98	39	46	48	5	59	16	39	80	5	66	49	87	61	59	34	29	47	46	34	37	61	58	97	19	85	35	96	53	21	34	50	34	56	34	19	106	37	36	13	79	21	24	69	53	40	78	21	30	41	35	39	76	43	34	86	77	32	52	60	81	83	35	62	32	43	35	69	42	32	12	30	58	11	32	50	31	21	36	82	22	27	25	58	38	52	88	65	28	37	28	50	66	75	92	49	27	60	55	73	29	130	26	34	26	32	56	28	60	9	39	67	41	65	16	32	36	30	19	46	42	27	40	8	23	44	35	27	30	56	17	19	32	64	38	25	41	31	42	10	66	13	11	75	14	33	84	27	22	49	43	53	22	31	18	35	54	28	32	38	61	21	49	31	30	54	8	39	38	18	36	26	31	14	55	32	28	32	43	15	43	12	14	11	36	56	13	21	48	16	26	17	15	43	9	39	49	24	30	29	67	11	15	44	44	46	10	29	45	20	40	6	27	13	20	40	42	49	35	70	9	29	16	12	25	44	18	37	16	46	36	25	145	21	29	9	46	35	8	26	92	21	47	13	4	25	41	10	29	27	77	58	17	13	14	32	21	45	24	22	41	54	16	69	27	31	27	24	25	62	9	15	59	13	49	19	48	8	65	44	37	27	15	36	14	27	21	20	41	14	74	14	59	36	24	29	46	58	24	47	27	23	11	9	23	13	16	1	41	17	31	7	42	14	15	13	45	35	8	6	10	27	1	37	15	44	8	16	26	43	6	7	38	12	10	15	38	14	15	19	38	21	19	7	17	17	29	27	24	10	20	65	16	6	37	19	46	7	25	15	4	7	4	31	28	25	9	39	21	8	21	7	14	7	31	17	25	25	17	3	8	21	21	29	13	9	10	22	15	16	45	21	9	15	17	29	12	20	31	8	27	19	12	12	18	9	19	10	14	17	18	11	15	17	26	24	9	16	22	44	35	3	3	15	25	16	2	6	18	16	11	3	18	32	17	11	11	13	13	4	30	8	16	8	4	11	49	8	12	4	8	7	15	10	13	11	19	9	16	7	41	5	23	11	4	34	4	3	8	20	4	3	1	3	6	5	7	6	15	3	5	4	11	28	12	21	6	0	8	18	19	16	13	7	10	4	14	10	11	14	16	1	12	8	3	4	7	9	32	5	10	21	6	4	4	3	6	7	3	1	4	14	2	9	3	2	10	16	1	3	15	11	6	16	36	10	4	5	5	4	3	0	0	9	2	8	3	5	3	4	5	4	11	4	7	3	2	9	7	12	15	7	3	4	2	3	3	2	1	0	7	9	2	3	19	1	0	3	2	0	2	1	0	0	0	5	2	2	0	2	0	0	0	0	0	2	3	0	4	2	9	1	0	3	1	0	1	0	4	1
ne0049	647	657	344	261	229	253	338	195	256	321	196	215	170	217	247	186	194	198	195	160	216	168	310	115	145	148	198	174	189	182	216	120	132	155	187	138	147	121	135	171	122	153	118	88	132	126	123	133	144	113	111	119	88	139	75	140	121	237	88	88	111	95	123	163	139	97	104	98	84	152	190	92	89	116	120	142	117	96	91	136	121	86	123	151	114	113	141	128	128	90	122	87	91	140	82	105	80	56	92	51	83	120	119	86	61	89	67	89	100	63	98	73	90	85	93	77	87	84	108	81	118	82	187	93	120	144	95	58	85	85	82	81	95	124	148	119	50	82	83	65	112	79	50	70	90	86	57	99	55	64	70	83	82	78	90	51	90	54	69	76	84	108	82	59	113	103	114	114	58	70	124	80	69	91	73	65	63	73	67	86	96	93	64	101	55	99	48	83	61	65	161	46	75	65	59	67	68	73	104	59	49	66	53	85	74	74	62	47	66	51	68	68	56	63	85	93	75	93	91	82	69	40	73	52	95	72	110	75	56	79	79	42	56	75	45	85	62	103	65	62	70	170	134	70	92	67	48	48	71	79	40	64	105	25	55	61	50	75	72	64	80	73	80	45	66	55	46	37	82	62	53	34	59	40	44	43	87	67	77	63	79	85	52	74	47	86	71	52	60	44	48	97	68	46	37	88	54	84	63	43	93	61	38	26	36	97	56	82	69	60	47	95	71	34	57	81	52	52	48	63	50	57	44	38	37	52	40	62	53	25	48	53	41	28	55	38	61	71	69	47	49	32	73	86	56	35	37	59	42	48	30	92	54	23	58	41	56	64	53	47	43	58	33	52	62	34	38	39	66	35	54	33	39	36	46	54	68	60	71	67	50	43	41	49	62	86	47	54	25	39	54	51	46	32	34	28	46	60	60	42	67	46	50	14	44	36	59	84	38	37	61	43	39	50	33	78	35	62	31	26	34	56	48	46	44	31	75	44	71	42	51	58	29	37	31	38	46	22	81	32	45	55	35	42	61	49	40	72	35	37	40	32	38	22	41	47	86	48	58	57	39	28	38	52	39	43	39	54	45	57	48	12	45	57	32	48	32	50	37	42	58	52	20	42	39	30	40	27	49	29	36	30	58	43	29	28	41	54	35	45	36	51	32	36	48	28	59	57	47	15	37	41	30	18	34	67	21	23	38	18	26	46	56	52	43	20	32	36	72	41	35	40	32	34	37	31	21	40	76	29	36	35	27	39	48	10	37	72	96	24	31	29	25	27	48	46	30	47	17	30	31	42	40	18	28	34	40	21	33	30	26	69	29	44	28	54	16	26	24	16	34	23	24	24	21	17	32	28	36	17	30	33	25	55	23	19	14	26	26	19	26	34	46	19	22	12	26	21	23	35	24	18	42	65	41	25	19	14	26	32	25	40	43	44	12	30	61	18	25	37	16	18	40	18	29	35	19	29	20	32	28	23	28	26	25	23	31	21	31	35	37	24	27	33	15	34	12	34	35	8	19	17	37	32	28	25	24	35	24	22	13	20	26	31	14	10	28	41	25	35	24	18	20	26	24	30	27	28	19	13	37	31	46	16	48	23	32	30	23	30	17	25	26	24	18	18	18	29	28	27	22	33	31	14	51	25	23	32	22	21	36	37	21	34	70	34	29	30	23	17	34	28	41	21	10	8	43	16	19	43	70	18	16	18	17	40	24	17	34	41	38	16	35	32	15	17	24	29	18	11	63	15	30	17	10	53	9	36	23	41	19	9	25	35	10	24	13	23	10	16	13	45	18	21	21	26	18	20	27	14	26	16	12	28	21	18	17	14	14	35	22	19	15	24	22	29	15	24	29	16	23	44	25	8	17	22	25	29	15	15	18	9	36	10	11	30	26	33	25	21	2	20	14	33	23	18	14	15	17	12	17	23	25	17	25	22	11	14	18	18	25	28	19	14	23	35	18	21	25	23	22	9	20	21	12	27	15	24	16	24	21	21	19	15	17	29	10	18	19	15	17	18	16	28	11	34	16	22	21	26	27	28	17	17	21	11	11	33	13	14	35	17	25	5	43	20	7	6	6	24	16	21	5	5	13	12	13	45	17	22	34	5	14	10	12	27	22	30	14	12	24	11	18	21	18	28	15	13	19	14	12	17	16	15	16	15	20	16	16	6	9	26	36	22	24	33	19	28	35	6	18	17	27	32	17	16	10	20	22	17	26	11	26	15	23	12	13	18	14	14	16	13	12	9	22	14	11	10	11	31	18	3	28	10	10	7	15	8	4	12	12	9	37	10	23	22	16	14	11	7	11	15	18	17	9	17	6	16	29	17	21	23	5	12	13	12	11	14	16	11	16	9	12	6	17	6	23	18	14	9	11	23	18	15	28	12	16	17	19	10	2	9	22	42	11	1	13	7	4	32	23	12	15	25	8	16	17	4	23	2	8	13	21	21	15	20	7	24	17	45	8	8	16	19	15	6	11	8	9	11	12	16	13	18	5	12	19	9	10	4	17	13	9	20	13	18	10	7	5	2	7	15	14	16	10	23	10	13	2	22	20	11	11	10	8	24	5	20	15	21	10	14	19	8	17	3	8	5	2	20	15	11	3	10	5	11	13	19	15	13	17	16	4	19	14	18	5	10	10	15	9	8	13	14	11	13	9	13	5	21	2	9	9	12	11	10	25	4	25	11	6	8	6	17	11	31	6	2	7	16	0	5	8	8	19	6	3	10	23	8	7	13	5	6	12	5	8	19	7	11	35	17	6	9	8	10	6	16	14	8	16	29	12	4	1	7	12	9	16	14	13	13	8	9	11	22	7	1	5	4	9	6	9	23	6	18	13	15	6	12	7	5	2	21	31	6	11	7	4	9	11	12	4	3	15	5	3	8	9	12	10	12	5	22	8	15	13	11	13	11	14	15	4	18	4	15	5	5	7	14	12	6	15	16	14	7	4	4	4	10	10	35	3	17	4	25	12	8	16	9	19	10	3	8	13	10	20	5	2	16	8	4	7	12	10	12	10	8	31	12	4	6	10	6	6	10	2	4	7	3	12	4	6	6	6	6	3	6	9	3	4	11	10	7	12	8	4	9	5	2	3	9	5	9	7	8	1	7	6	10	11	5	4	4	3	2	2	6	13	3	3	4	10	9	9	6	21	4	6	7	30	5	6	2	2	7	10	5	3	11	4	4	6	10	5	3	7	4	15	2	8	10	6	10	8	3	13	11	9	4	3	13	5	1	15	12	12	11	22	3	10	4	5	4	7	3	12	12	4	7	1	2	5	3	7	5	3	7	1	11	2	3	7	14	12	4	0	4	9	4	3	11	0	8	8	3	8	5	1	7	7	6	11	8	7	16	3	10	5	3	7	25	2	5	13	2	3	4	3	1	9	6	14	4	2	5	3	1	6	7	8	2	5	7	2	7	5	7	9	15	6	4	5	14	13	3	5	7	4	2	6	5	3	1	5	20	8	2	6	7	3	5	1	4	11	11	0	3	2	13	1	3	1	6	2	7	4	8	10	9	0	6	3	6	7	12	2	10	3	0	1	1	3	6	5	3	3	3	5	8	2	2	8	0	6	5	5	5	0	1	2	1	3	2	2	2	3	0	1	2	1	2	0	1	2	1	3	2	1	3	5	5	3	2	3	2	9	5	7	8	3	2	2	2	0	2	0	2	7	1	1	1	4	3	2	5	3	1	3	0	1	2	1	1	1	5	14	1	3	1	4	6	3	1	0	3	1	1	3	5	2	3	1	1	1	1	2	4	4	0	7	1	3	0	7	2	5	0	1	1	3	2	2	3	0	17	3	5	1	3	0	1	0	5	1	0	1	4	0	1	0	1	2	0	0	2	0	1	3	0	1	18	7	1	0	1	1	2	0	1	0	1	6	0	1	3	0	9	2	1	2	2	2	1	5	0	3	0	1	2	1	1	3	5	1	6	1	7	0	0	1	2	1	0	1	5	4	4	0	4	0	1	0	0	1	0	4	0	7	1	5	0	4	3	0	1	2	1	0	0	0	1	1	1	3	2	0	0	0	1	0	1	8	1	0	2	1	1	3	0	5	0	3	0	0	2	0	0	0	4	1	0	0	15	0	1	0	1	0	0	0	0	0	0	1	0	0	0	0	0	0	0	0	2	0	0	0	0
ne0050	341	426	241	364	300	229	242	189	176	200	187	179	128	143	141	115	124	169	179	132	151	124	110	221	134	155	133	122	109	146	136	128	128	94	122	135	91	135	111	90	113	88	102	91	137	103	90	72	66	109	103	104	101	131	103	83	107	152	100	109	88	107	116	80	117	71	69	80	86	103	71	91	59	105	102	133	88	63	55	86	61	58	155	99	110	84	59	85	74	63	113	63	98	76	72	49	83	86	46	66	77	114	98	71	97	95	65	61	72	79	56	53	67	64	90	83	78	53	80	73	87	69	90	44	57	87	49	89	76	62	106	43	129	70	64	148	43	72	59	76	63	34	57	81	86	52	66	116	43	57	62	58	43	61	67	49	62	51	61	105	70	53	64	54	48	55	47	64	95	120	38	75	50	63	71	40	84	55	55	74	130	59	74	58	67	60	61	56	52	62	56	47	55	72	58	108	65	59	37	45	54	100	67	61	121	25	45	60	24	44	52	49	43	31	37	68	69	56	55	58	86	51	49	39	51	65	57	79	49	62	45	50	75	51	31	69	70	46	49	53	53	54	62	90	53	67	36	35	63	38	71	59	37	60	47	50	56	92	53	69	71	90	30	35	55	43	24	65	46	38	53	48	44	50	38	58	35	45	46	40	42	27	27	118	97	58	17	34	58	19	66	43	48	36	92	43	79	48	31	42	40	47	49	23	26	56	46	47	31	48	58	58	42	66	55	50	34	62	41	64	29	31	47	78	33	89	38	23	41	49	33	19	24	48	31	23	34	53	49	60	34	30	70	70	25	17	28	25	61	34	38	34	35	34	27	21	40	30	61	43	47	37	66	68	29	47	42	50	45	25	33	54	44	19	39	66	38	33	27	44	55	40	41	21	40	34	44	34	35	27	52	82	42	32	53	38	29	55	28	36	38	105	19	36	23	28	29	32	32	47	32	31	22	16	36	40	40	39	26	20	16	46	40	23	23	80	17	33	59	34	68	32	28	27	38	13	45	18	25	34	38	62	17	24	44	40	36	32	21	22	30	45	28	48	38	43	19	25	24	11	21	17	31	28	36	41	31	57	18	34	95	19	29	35	58	30	14	36	25	36	50	57	26	28	24	15	24	39	70	18	52	26	40	41	41	35	21	28	24	25	20	20	20	50	71	31	36	9	22	35	22	34	17	22	27	47	24	29	41	33	61	44	34	16	32	41	17	18	28	8	15	19	25	29	48	48	21	22	38	25	16	38	25	15	42	30	44	25	39	26	34	28	30	17	18	26	21	27	21	41	29	50	21	23	22	16	28	14	13	29	25	20	28	23	26	68	30	21	28	28	32	27	30	18	20	31	16	16	20	24	18	21	28	41	35	45	16	34	14	12	10	29	41	29	35	13	36	34	30	74	34	27	20	30	13	26	38	28	32	23	29	36	15	18	37	41	23	9	21	17	23	7	9	21	26	23	17	14	6	19	10	14	29	26	43	30	34	5	39	15	16	16	40	16	28	14	24	48	16	21	11	26	25	19	35	9	20	23	27	18	31	40	11	45	30	16	23	23	17	18	19	11	23	15	42	10	43	37	30	31	22	16	16	34	28	27	11	27	10	22	11	11	21	37	26	13	26	19	18	22	35	13	20	22	19	23	24	41	18	15	19	14	15	21	22	20	17	16	27	25	21	25	21	33	17	30	34	15	17	18	18	16	18	12	10	19	16	19	15	29	34	26	23	11	14	21	18	18	32	18	10	9	7	22	21	39	26	31	10	4	37	16	6	19	9	8	15	38	17	22	13	14	29	13	22	15	11	22	23	20	18	19	10	23	23	7	15	11	17	29	12	10	17	11	20	6	20	19	15	8	37	29	15	6	28	15	20	11	30	17	25	5	30	13	9	20	13	7	9	15	21	18	8	45	11	16	18	15	27	23	20	12	44	26	31	22	23	9	17	14	15	6	10	20	31	8	13	21	17	32	14	9	17	14	7	10	20	8	19	22	11	16	37	9	23	29	18	6	17	3	6	15	10	24	13	29	14	20	13	17	12	17	22	8	20	11	7	28	21	6	27	9	19	20	15	15	23	23	14	13	24	12	11	8	12	26	26	23	11	14	22	17	15	9	13	20	16	5	21	11	12	5	10	27	16	23	21	13	12	17	14	6	15	18	13	8	22	12	21	8	5	17	29	9	7	21	17	35	18	8	19	21	20	19	19	9	11	9	23	31	13	11	8	13	12	13	13	10	18	38	7	12	16	17	13	9	6	16	15	16	9	9	24	26	16	9	18	9	21	9	11	12	29	13	14	13	8	15	18	11	4	9	17	15	8	14	15	17	9	7	10	15	11	11	10	10	12	16	11	17	15	22	8	8	5	13	8	23	10	9	17	4	11	9	16	28	9	16	6	6	14	7	4	33	12	11	10	8	11	10	14	13	17	3	12	3	6	5	12	5	7	13	23	17	12	8	8	18	15	9	10	11	9	12	12	2	18	8	7	6	15	8	9	12	5	14	15	24	11	9	6	18	26	12	11	12	3	8	16	22	10	8	19	9	3	10	10	12	21	17	6	12	7	17	14	4	8	1	8	16	7	11	14	9	6	9	11	18	17	4	10	10	20	14	8	17	9	8	11	8	5	13	13	11	7	10	5	7	3	7	13	5	28	16	8	13	14	9	12	6	18	13	7	4	8	7	18	18	18	14	4	8	14	11	6	22	14	11	10	8	7	10	15	17	6	8	9	2	15	6	4	6	6	19	16	11	2	10	14	5	14	13	13	6	5	10	18	13	16	4	12	12	4	9	11	7	10	5	17	6	11	8	14	7	3	5	12	7	5	24	7	9	2	6	6	9	10	2	11	10	5	12	12	4	20	5	2	6	14	9	7	16	10	11	25	15	5	7	6	13	16	11	6	17	5	11	8	8	15	11	2	16	7	3	7	26	4	10	2	1	8	6	9	16	5	10	10	13	11	13	6	9	4	8	14	14	8	18	15	7	4	20	25	8	6	11	11	24	2	23	3	8	3	5	1	3	7	5	6	10	5	7	2	16	4	7	8	5	4	8	13	4	7	13	8	4	8	8	9	8	4	11	1	3	6	3	18	10	6	2	0	14	2	11	17	5	9	7	9	28	7	8	2	10	15	9	4	4	5	2	2	10	4	7	0	2	5	4	4	5	13	3	3	1	2	11	13	5	10	2	5	6	8	15	5	10	9	3	7	10	7	5	2	8	6	11	6	5	11	5	2	3	7	7	1	18	18	7	3	12	14	1	10	7	12	8	4	19	8	11	9	4	4	7	6	7	2	11	29	11	16	7	4	1	5	11	3	2	20	4	6	3	6	5	7	3	3	1	17	7	6	3	0	6	1	18	3	5	7	8	2	10	6	10	7	5	9	7	2	4	13	6	7	16	17	1	8	3	7	5	6	14	5	4	4	1	7	2	15	1	15	17	9	1	15	11	3	5	7	1	2	3	2	3	8	0	5	5	7	3	5	3	3	1	7	5	7	4	5	3	1	12	2	3	0	6	7	7	7	5	4	0	3	2	6	0	1	3	10	2	8	1	6	3	3	10	6	3	8	10	4	1	6	19	9	1	3	3	1	1	1	4	5	3	3	8	1	3	3	1	3	2	8	3	3	7	3	7	1	4	2	2	3	5	2	6	0	4	12	5	2	10	5	2	2	4	2	2	5	5	3	4	3	0	5	1	4	2	1	8	0	6	10	5	1	2	2	8	6	1	3	2	3	5	3	4	2	3	4	1	2	6	11	7	2	2	3	0	14	1	6	3	0	1	11	2	8	2	1	7	9	1	6	2	10	3	0	2	5	4	1	3	2	5	1	1	3	0	4	3	0	1	3	4	0	3	8	3	1	1	4	3	3	4	9	0	2	4	2	1	7	1	1	2	1	1	1	8	3	2	2	3	0	0	1	0	3	4	1	1	2	0	1	0	2	7	6	2	1	8	3	2	0	1	2	3	1	2	5	1	2	1	0	1	3	2	1	0	0	0	0	1	1	4	7	1	0	0	1	0	3	1	2	1	0	1	1	2	2	2	0	1	2	5	0	0	0	0	1	2	0	0	0	2	0	2	0	0	2	0	0	0	0	1	0	0	0	0	0	0	0	0	0	0	1	0	0	1	0	0	0	1	0	0	0	0	0	1
ne0052	1156	1343	868	907	835	681	610	609	563	608	492	512	448	490	494	490	482	494	469	420	411	341	401	468	401	418	425	429	342	412	428	359	388	367	373	394	352	400	386	252	357	293	309	286	373	331	347	296	267	304	339	344	317	335	277	265	333	349	284	294	307	277	334	288	343	212	247	222	318	318	243	316	221	211	323	312	201	264	228	203	205	226	350	289	302	279	209	256	209	222	290	171	304	202	146	239	253	231	159	242	278	255	295	289	249	270	199	224	236	219	202	191	219	212	291	306	257	196	251	241	206	243	269	176	190	243	172	233	240	222	293	119	236	228	216	348	166	187	230	247	144	178	151	235	286	180	176	268	157	155	173	210	146	228	152	161	184	141	215	238	209	186	160	208	186	196	173	186	215	333	133	228	126	256	220	181	258	193	214	200	432	170	240	157	204	198	244	162	225	186	184	128	195	212	223	240	176	191	151	172	193	267	207	172	232	148	163	204	84	160	201	163	106	106	206	201	208	196	183	212	197	167	132	118	185	163	161	181	177	177	169	166	192	163	127	190	235	163	135	217	110	139	96	174	175	210	114	75	169	107	147	169	115	149	107	175	177	201	141	200	175	217	118	112	166	120	82	137	156	121	160	157	108	159	103	146	150	131	155	125	121	109	113	225	154	173	89	136	157	87	212	160	141	105	137	147	214	132	113	145	135	121	173	120	97	185	189	175	108	137	185	144	124	174	129	100	124	182	136	148	136	104	149	173	102	202	149	117	129	150	102	116	75	164	111	89	122	167	123	208	67	96	153	206	102	96	91	125	153	121	139	112	127	88	84	103	130	83	134	102	161	94	148	143	85	95	158	127	102	90	140	106	160	59	144	133	106	112	111	148	127	146	115	101	127	88	132	121	115	97	153	117	115	136	189	116	76	144	78	138	140	129	112	113	96	118	129	86	109	138	96	77	86	90	135	98	140	77	108	96	100	117	99	90	58	104	68	119	173	107	154	77	95	135	91	27	141	65	88	129	110	169	71	75	122	132	104	81	78	70	125	191	106	117	90	102	68	90	76	48	83	72	105	95	116	75	106	103	75	116	108	70	71	82	127	89	57	78	92	67	149	125	127	108	68	44	98	90	162	65	90	96	138	139	110	118	77	85	65	63	78	85	84	141	144	118	106	44	64	97	59	82	63	65	113	118	101	133	119	72	141	104	85	122	86	106	98	62	83	69	73	86	69	120	121	154	72	53	146	86	55	109	90	52	109	65	142	54	104	68	91	77	76	62	93	88	50	80	37	115	64	111	37	66	55	60	91	54	74	89	91	68	82	86	106	167	67	92	71	58	93	71	68	60	63	65	119	57	77	82	46	64	79	109	67	83	63	99	44	66	55	50	77	88	104	63	83	80	90	127	85	86	69	74	76	73	82	81	50	84	42	102	89	92	85	98	61	37	78	62	45	40	77	85	99	78	75	61	65	58	57	92	103	50	90	83	71	57	92	47	91	54	126	83	80	61	84	110	78	89	32	80	46	37	105	41	40	67	60	65	76	79	35	114	64	51	71	64	36	57	81	47	78	36	173	49	71	57	69	45	69	67	43	70	62	65	43	89	61	84	64	41	73	87	72	47	53	64	62	53	86	60	116	93	58	60	53	99	63	82	65	57	44	89	67	69	81	66	89	84	43	62	79	63	29	97	43	55	64	74	74	46	61	29	32	55	54	62	45	80	106	83	52	42	73	65	49	74	53	100	54	30	52	65	51	80	60	40	67	36	91	51	29	48	46	35	40	54	43	59	30	35	58	40	47	41	50	48	47	50	32	55	35	61	71	26	52	41	57	55	43	41	36	38	43	9	55	69	35	39	119	86	43	31	64	69	27	36	77	72	61	28	77	35	27	39	41	35	50	51	48	43	23	59	39	48	65	50	56	73	59	78	107	65	80	28	80	36	41	49	30	45	50	34	65	48	30	53	53	38	64	32	32	33	24	54	61	47	55	41	54	60	67	27	66	81	56	49	62	27	39	28	28	46	33	77	33	70	14	37	41	36	69	44	59	34	42	51	50	16	60	52	62	36	44	37	70	53	45	40	59	41	27	36	44	58	53	71	37	34	34	32	44	12	40	72	43	19	48	37	60	23	57	55	49	43	56	23	39	56	53	20	23	71	39	19	41	54	37	26	17	46	44	30	45	51	129	64	52	29	31	44	38	46	55	34	43	29	55	67	45	27	20	58	26	40	24	30	42	60	31	36	49	72	80	39	30	48	25	28	29	35	63	72	40	27	60	44	24	36	44	26	86	24	43	30	33	42	71	31	10	26	37	45	44	32	53	47	42	39	34	40	54	46	43	30	31	48	24	34	14	34	35	27	16	35	29	73	30	28	51	20	39	57	49	64	19	46	27	37	21	22	22	45	29	41	16	16	28	50	49	26	27	21	33	20	31	19	52	7	28	32	41	24	32	25	35	51	26	30	23	27	33	49	72	11	64	19	27	45	40	33	42	28	21	39	32	60	23	43	25	72	41	38	33	49	16	32	33	36	48	39	57	17	14	21	33	45	46	47	25	18	20	40	58	6	30	23	38	24	30	41	23	36	35	40	22	37	37	21	49	39	35	27	40	42	14	26	47	23	27	14	34	53	40	28	20	12	11	27	53	40	51	53	18	19	76	36	22	27	54	52	24	14	33	30	26	48	53	13	15	25	31	15	11	42	43	34	24	29	18	30	44	32	28	18	30	3	32	16	16	23	30	29	21	20	30	38	34	14	43	32	53	31	18	12	56	27	38	26	26	22	18	21	21	21	33	10	32	25	30	29	27	28	22	24	32	21	22	19	26	55	24	30	22	43	37	16	29	16	18	22	26	20	47	19	22	14	39	25	18	37	16	22	32	82	18	22	16	25	25	28	20	46	23	12	21	28	32	44	20	45	28	27	19	38	15	26	7	21	13	17	20	35	22	26	19	43	20	30	15	25	27	30	35	37	10	32	11	32	22	29	44	20	20	47	31	33	17	55	24	20	22	26	26	8	26	23	17	18	34	40	13	22	25	12	26	30	39	32	27	10	16	27	26	24	15	23	12	28	21	27	16	14	25	26	17	11	29	8	8	36	12	15	44	19	16	25	21	32	24	19	15	30	28	34	17	27	21	8	32	28	21	35	6	11	26	12	14	28	17	7	22	11	31	21	10	15	24	16	15	6	19	43	22	33	19	10	11	14	14	34	3	31	18	24	14	20	26	11	10	21	23	19	6	22	20	19	14	23	24	11	20	20	35	21	21	43	14	24	14	12	19	13	15	21	8	19	14	14	10	12	16	4	14	24	13	12	34	12	28	6	12	20	21	8	9	10	35	39	9	10	7	14	12	38	17	18	17	33	14	36	5	16	36	28	22	17	9	7	34	11	21	52	28	11	27	11	17	21	8	16	7	33	15	8	24	10	26	3	38	23	7	12	37	36	19	20	17	8	11	6	20	4	17	7	36	13	26	12	20	17	7	13	20	25	17	15	2	13	6	15	9	29	4	13	5	22	4	9	12	4	8	12	33	7	12	13	17	19	11	9	18	11	12	16	19	8	9	18	15	8	15	10	14	3	19	22	10	5	2	13	12	12	7	18	27	11	3	1	8	8	13	20	6	17	11	7	3	15	14	20	2	4	8	21	6	13	32	4	8	8	6	9	5	17	10	4	34	8	6	7	11	11	10	11	21	14	10	8	33	23	6	10	9	12	6	15	16	6	3	5	32	12	2	2	5	14	5	1	8	9	16	12	6	5	8	9	19	4	7	5	4	10	15	8	9	7	11	5	14	6	8	2	10	18	6	8	22	8	6	4	2	5	1	4	5	3	22	4	4	1	2	6	5	3	18	7	4	8	9	25	10	5	4	1	7	4	9	8	11	18	7	4	9	0	10	6	13	2	27	6	2	2	6	5	14	4	0	8	3	4	6	7	3	2	10	3	3	8	3	9	4	2	6	8	1	4	5	6	4	7	2	1	5	7	3	3	7	0	2	8	4	5	2	7	5	3	5	2	8	4	7	8	0	7	4	7	1	2	3	2	2	6	0	4	2	0	3	0	1	1	3	1	2	1	0	0	2	1	4	0	0	5	1	5	0	0	3	0	0	0	1	2	1	0	3	30	4	2	4	0	0	0	2	0	0	0
ne0053	804	1210	571	560	620	456	497	416	380	501	382	394	405	335	475	325	275	389	282	357	376	249	263	277	290	292	455	355	279	392	386	293	274	261	338	325	207	323	239	297	227	273	201	215	183	228	210	166	216	266	203	298	220	205	164	233	249	266	225	212	182	363	265	176	331	142	143	217	211	254	211	217	190	242	209	309	150	210	163	173	179	174	181	197	241	175	168	222	159	201	187	195	182	221	134	125	172	202	123	110	229	176	181	161	189	220	200	139	159	114	140	131	143	118	184	150	165	148	179	139	147	149	232	128	119	203	92	103	146	126	246	91	174	200	184	306	121	133	130	189	133	114	66	173	193	145	118	299	122	162	147	146	134	132	126	123	160	119	124	126	145	164	149	169	151	163	113	198	183	165	119	149	102	218	127	120	199	117	160	163	199	163	161	94	107	155	145	101	153	114	118	113	81	181	132	164	124	113	117	117	152	192	140	106	273	80	112	156	68	107	122	133	106	56	77	185	140	188	132	177	248	111	139	95	189	124	176	214	120	135	127	84	132	145	85	251	144	147	116	141	89	94	126	151	113	183	137	67	123	78	110	87	68	131	109	102	93	179	133	158	132	198	93	111	131	70	70	127	123	155	123	117	78	105	85	98	93	80	128	68	121	72	84	299	145	242	112	126	109	41	179	103	151	95	69	115	143	117	111	79	125	112	136	63	60	119	145	192	65	91	136	154	114	118	143	73	81	162	79	155	106	149	86	153	70	141	69	96	84	110	63	67	75	80	97	56	126	125	133	161	66	57	192	106	69	77	50	104	137	116	94	101	103	70	74	65	104	61	129	104	113	142	91	129	94	65	111	110	77	53	124	92	142	42	84	186	102	95	117	81	104	109	101	62	121	68	92	99	69	72	101	84	88	105	104	72	92	101	102	71	137	107	58	68	55	63	92	71	99	104	97	79	52	63	77	67	106	68	91	50	53	124	68	99	52	123	52	88	106	80	76	80	90	82	80	24	157	58	53	67	76	189	53	56	135	107	107	59	108	40	87	96	66	61	78	90	42	82	70	20	36	34	100	80	78	47	80	117	64	50	71	49	51	51	83	74	43	65	70	82	89	123	90	77	45	63	70	81	126	70	59	81	121	159	86	76	52	63	35	60	66	86	43	69	87	83	112	42	61	67	49	100	44	55	59	107	53	109	74	54	102	91	68	53	59	44	83	62	88	39	65	104	39	97	90	123	40	78	113	70	47	84	63	44	92	48	75	59	90	50	70	70	54	35	107	77	32	75	42	69	63	118	31	34	56	37	48	45	63	63	47	41	68	66	57	76	45	40	62	54	79	52	57	56	49	48	64	63	64	54	41	49	74	96	58	84	59	77	24	53	35	43	115	71	59	54	60	86	72	45	58	77	55	54	76	52	53	44	41	66	56	94	57	83	55	63	67	21	54	47	36	22	44	89	64	67	34	26	43	38	37	28	86	45	79	58	93	20	83	36	84	41	94	74	42	32	57	49	76	69	31	70	54	25	103	30	62	52	65	47	81	106	56	42	54	19	62	62	24	38	62	29	80	36	93	24	59	43	98	49	63	77	28	91	75	45	18	88	35	59	42	35	60	40	62	34	103	57	44	62	55	57	83	66	49	49	34	67	30	70	60	63	38	68	55	56	61	84	51	52	54	63	44	66	45	79	51	47	44	61	44	44	37	25	23	42	36	45	31	72	54	48	40	29	35	51	43	37	83	45	33	36	53	52	37	73	28	58	44	18	52	29	19	42	30	30	24	60	25	31	29	17	62	28	37	24	14	34	35	39	55	53	24	56	54	19	32	39	53	66	25	29	28	33	32	11	54	64	27	27	84	40	37	24	43	35	21	31	64	41	15	28	35	5	20	38	39	28	37	24	42	44	17	36	33	53	43	42	70	55	43	35	42	48	80	43	24	17	31	48	58	22	13	26	81	37	23	52	44	36	62	27	41	35	32	35	60	30	36	57	25	69	66	22	53	69	39	37	63	19	21	32	31	64	24	92	19	51	22	42	35	32	45	36	58	23	18	36	26	13	57	27	60	28	69	30	26	32	19	37	38	24	17	37	29	33	35	84	22	36	55	13	26	35	21	49	37	39	38	51	38	19	42	43	41	44	74	22	41	44	45	14	17	68	43	19	50	38	50	19	14	36	43	21	29	66	44	55	52	38	24	38	28	28	36	42	39	23	37	64	33	28	14	37	30	31	10	25	23	45	32	22	25	51	41	53	15	35	21	24	21	16	61	43	35	16	54	19	29	30	25	22	70	30	49	23	14	34	33	28	10	28	16	27	45	30	28	44	32	19	36	26	50	34	24	25	16	42	20	27	28	38	27	21	10	34	25	59	26	27	42	13	41	14	31	72	29	40	23	24	27	10	26	56	11	27	12	14	32	43	39	18	23	13	26	9	20	19	34	12	17	27	35	43	29	24	15	26	17	25	26	24	31	37	51	32	26	11	29	18	37	22	34	30	16	31	25	26	12	45	20	44	72	41	43	31	11	33	22	28	39	21	55	11	6	36	16	29	33	40	23	26	13	57	41	10	19	3	42	40	14	32	14	16	20	18	13	28	32	25	47	58	76	16	21	19	24	27	41	26	26	14	44	32	33	40	14	7	11	11	46	20	64	33	6	20	55	19	19	21	40	38	25	9	39	20	28	27	29	9	16	23	29	28	11	28	30	17	18	21	8	14	44	26	37	18	23	7	18	7	10	23	24	29	26	18	13	24	56	12	26	23	45	11	15	8	30	28	50	24	25	35	9	13	3	21	33	10	38	18	34	21	33	13	15	22	20	19	20	17	27	35	12	40	15	50	34	12	15	23	15	17	22	11	54	20	8	5	32	14	15	34	22	26	25	19	13	20	15	17	39	21	19	39	9	12	10	20	38	33	7	63	15	20	18	29	14	25	9	16	38	2	8	15	21	10	28	43	6	16	12	30	23	28	45	30	10	33	4	13	38	25	51	12	13	19	40	33	10	70	11	8	15	16	26	12	28	8	20	31	27	24	9	19	21	13	9	9	24	12	12	5	6	24	23	5	8	37	17	9	24	42	14	11	21	12	29	5	27	0	7	21	5	19	34	19	12	18	23	21	9	21	6	17	32	21	20	18	32	6	23	15	11	28	8	21	28	3	11	24	7	5	12	10	22	13	19	7	11	2	8	12	6	45	11	13	23	13	12	13	15	22	2	16	23	10	10	14	31	11	11	22	23	23	10	7	27	17	16	13	12	5	10	13	40	16	33	41	5	9	10	6	13	20	7	17	7	21	12	13	8	12	13	3	20	12	9	11	64	11	31	6	2	24	13	6	6	7	21	30	8	6	3	7	9	7	15	13	19	32	5	31	17	18	11	23	9	20	4	8	35	9	27	6	23	5	20	5	9	16	10	11	3	11	10	10	15	5	37	2	14	23	12	9	29	23	15	26	11	3	6	1	8	4	6	1	27	6	24	9	17	24	9	11	16	12	9	15	7	12	5	16	4	19	2	9	10	24	3	3	12	16	7	2	23	5	7	7	13	14	5	3	17	8	11	23	13	6	9	23	6	8	16	2	19	1	20	15	5	2	2	16	17	14	2	14	23	9	11	0	6	3	9	9	11	6	7	3	1	13	15	14	7	4	5	7	6	2	28	5	5	9	1	13	13	17	13	1	10	9	7	3	12	14	9	6	10	18	5	5	5	12	23	15	6	10	5	10	14	2	0	9	9	11	7	8	6	16	6	0	12	12	10	13	3	1	8	2	13	2	8	7	1	5	20	5	7	3	4	4	15	6	11	7	14	5	5	7	17	2	9	6	2	15	1	0	5	8	4	6	3	2	4	4	4	7	14	2	4	2	9	40	3	3	1	1	7	14	12	7	7	8	3	4	6	3	4	3	14	1	9	4	2	3	3	3	4	4	3	20	1	0	2	3	1	3	3	0	2	11	2	4	1	1	3	11	0	3	7	5	0	1	2	5	2	7	1	1	1	1	0	9	2	0	2	5	2	1	2	0	5	2	0	2	0	2	3	3	3	3	1	1	1	8	1	2	3	0	5	4	1	1	1	1	1	1	1	0	1	0	0	2	0	1	0	2	0	0	0	0	0	0	1	2	1	1	2	3	1	3	0	0	0	0	0	0	0	0
ne0054	1084	1355	858	1225	1218	751	729	723	755	477	842	668	487	453	605	489	403	816	563	488	561	421	466	461	584	500	633	569	393	499	632	444	440	383	496	383	285	741	396	425	377	318	482	322	342	294	340	193	233	334	334	456	398	499	369	240	473	626	312	407	335	412	525	467	401	276	271	290	355	469	286	419	246	373	485	704	297	342	287	348	203	339	329	371	470	347	344	350	280	270	301	239	295	322	230	303	316	381	158	210	312	255	312	220	331	331	237	220	216	377	245	193	211	273	348	287	232	218	357	238	260	215	426	152	283	332	200	316	229	247	390	119	363	311	328	650	266	292	234	318	208	92	215	265	362	218	217	527	252	134	205	303	156	230	161	273	244	224	198	245	322	343	174	249	252	268	208	305	320	314	188	348	142	254	230	202	351	190	284	340	380	175	431	255	301	314	367	233	252	255	298	142	312	273	313	301	251	192	224	211	164	419	323	242	419	122	192	205	91	189	208	221	198	77	160	266	301	315	201	362	390	191	199	102	210	177	252	239	160	232	275	146	284	246	160	221	298	286	204	302	231	229	170	267	384	261	117	100	275	126	219	198	195	262	118	165	184	257	171	306	201	287	192	88	307	97	63	226	235	227	193	156	175	237	173	197	268	159	194	185	145	106	168	460	229	484	96	157	162	91	333	89	234	162	216	257	223	192	93	142	211	165	152	109	87	176	208	222	136	255	299	188	227	303	235	249	134	262	143	164	147	146	207	276	179	420	152	181	98	271	129	46	75	155	131	74	143	206	158	279	132	114	189	236	115	120	110	154	261	151	155	207	187	57	121	85	150	185	208	232	116	179	272	236	167	176	194	125	128	80	252	221	228	95	166	319	203	161	150	189	276	119	174	51	130	158	221	176	105	136	204	311	179	162	202	108	164	196	197	151	164	135	102	122	86	133	237	147	114	190	170	116	127	64	215	194	107	129	120	104	83	265	124	107	55	120	94	96	227	170	163	82	97	115	106	22	201	94	201	127	126	342	90	88	147	163	205	186	102	75	156	222	120	135	156	165	106	192	142	63	80	40	175	101	123	122	148	60	125	184	319	63	89	106	181	132	57	114	221	194	212	124	46	166	95	132	116	114	149	91	148	144	267	210	223	156	125	114	83	69	170	142	58	297	137	197	207	88	70	74	84	108	89	72	112	107	105	194	165	96	208	161	141	112	144	105	122	76	113	67	92	92	64	158	204	238	73	73	265	134	48	163	146	92	261	179	200	101	169	123	92	195	93	75	127	115	71	130	77	119	112	151	82	75	116	66	115	73	128	122	106	125	118	123	138	284	126	76	78	78	124	93	86	136	75	120	125	55	74	61	100	62	89	205	114	304	30	118	37	65	47	89	169	80	119	79	143	160	158	218	119	103	142	166	77	79	113	84	51	121	124	169	137	123	77	165	108	12	85	117	64	57	115	100	167	140	85	29	136	99	39	83	129	77	182	119	106	56	161	63	163	71	172	100	108	96	108	129	113	144	60	117	107	90	120	17	86	60	60	77	183	168	75	115	114	47	83	132	65	59	119	43	124	68	101	64	210	96	95	139	125	85	82	122	204	113	52	106	48	84	85	41	88	106	124	64	78	91	76	65	112	83	100	33	109	120	52	138	129	60	67	100	76	174	174	152	117	194	105	116	92	107	66	107	66	188	101	96	56	145	155	76	43	26	31	64	188	72	73	125	155	96	121	70	88	70	63	48	174	96	53	57	54	77	97	150	104	76	75	18	126	83	19	117	36	55	74	92	69	75	41	34	58	64	102	58	29	42	120	53	83	90	47	119	97	15	47	44	91	81	41	52	73	101	29	31	65	71	47	29	121	130	42	46	59	37	58	34	99	58	36	37	119	22	43	54	52	34	56	66	86	109	27	140	62	100	86	78	86	85	84	100	102	88	111	21	72	52	47	76	63	23	19	34	100	70	26	64	106	71	85	44	47	43	37	113	123	97	97	120	55	96	152	15	63	83	49	81	112	50	37	18	59	63	34	108	42	117	75	55	62	69	129	83	68	46	10	72	54	28	53	38	80	35	88	76	14	57	55	57	64	36	118	43	61	89	69	102	37	88	55	22	92	35	53	107	76	12	97	66	129	46	68	57	115	237	71	29	55	81	71	14	35	89	38	44	55	27	108	18	35	51	50	61	82	107	134	80	91	66	64	90	89	52	104	50	86	45	104	44	65	21	38	31	34	74	22	46	31	73	41	76	33	99	100	58	33	89	40	76	30	61	124	68	96	39	68	45	64	31	48	31	119	34	90	49	36	70	57	47	23	29	53	112	15	86	103	97	64	22	34	32	64	120	39	53	26	73	29	56	112	59	37	26	23	59	54	73	34	39	134	14	32	45	110	188	28	96	52	41	19	22	19	70	27	51	39	28	71	105	47	48	29	17	40	4	17	29	53	15	25	66	76	49	84	42	38	67	36	33	40	18	68	74	149	23	74	20	34	84	45	63	72	64	11	94	96	99	33	63	32	78	50	34	70	52	14	63	48	43	116	96	86	28	6	64	38	39	38	52	38	42	38	44	63	13	36	12	65	38	58	56	31	29	43	42	27	71	59	14	48	66	46	61	45	102	26	73	121	46	46	32	82	54	33	45	28	7	20	21	77	42	105	78	27	50	56	23	28	25	162	89	63	7	82	66	29	75	85	43	15	38	40	67	21	76	88	33	144	46	8	81	31	28	48	25	23	0	65	18	30	32	76	66	33	66	35	54	87	27	38	45	87	19	35	17	73	91	32	32	22	28	5	40	29	42	68	5	91	29	68	57	43	22	24	48	54	55	40	48	53	68	17	71	36	75	74	20	35	68	31	37	32	20	116	50	23	26	72	26	15	36	29	32	39	12	31	38	20	31	33	54	29	85	51	25	30	36	33	60	22	70	23	73	42	90	13	39	5	42	47	11	44	73	40	31	21	46	50	51	18	54	36	57	77	85	5	66	24	34	48	39	103	25	14	90	56	84	29	72	28	37	22	17	42	25	60	26	31	38	48	43	37	22	34	35	19	26	66	35	69	5	8	44	13	28	47	68	40	25	20	47	12	25	37	59	56	17	62	9	5	56	14	76	58	34	18	30	42	64	21	14	24	52	39	46	16	35	33	12	38	49	33	35	2	34	32	4	37	47	27	23	58	26	8	25	82	14	20	12	9	3	37	66	10	37	44	12	26	18	27	58	14	48	28	31	15	16	40	29	5	31	51	50	7	98	62	239	13	78	51	10	42	28	48	58	76	49	98	54	25	7	32	34	23	44	26	24	11	7	11	35	30	4	22	62	5	17	101	23	60	12	16	34	26	22	11	16	62	31	23	6	3	7	17	74	15	15	71	73	24	51	22	32	18	35	23	12	32	23	52	11	40	106	74	0	47	25	43	16	10	28	4	16	16	2	26	19	55	8	31	23	18	19	48	54	32	33	22	4	25	16	28	12	22	2	28	10	28	4	27	26	10	13	36	57	24	11	15	22	0	45	20	47	1	22	30	17	18	11	34	26	7	7	53	1	13	13	41	27	12	3	29	15	28	27	34	5	35	24	18	3	10	20	52	2	25	30	4	3	28	31	35	44	10	20	43	9	10	6	41	53	57	26	23	6	2	49	3	20	23	84	3	15	11	21	50	16	48	8	16	23	2	37	2	68	23	5	7	38	19	14	5	12	17	25	27	4	25	19	25	35	28	35	14	8	12	41	15	13	6	15	11	19	7	7	16	35	7	6	23	25	23	12	6	7	20	5	32	50	24	15	1	9	18	17	23	0	9	24	48	15	21	15	14	31	9	13	46	6	35	11	8	6	4	2	21	18	3	1	2	0	9	17	7	9	26	33	37	11	25	14	19	41	17	12	6	11	8	23	22	14	7	16	14	5	16	2	15	2	50	6	0	2	10	12	16	8	10	33	4	5	3	2	10	0	2	17	2	42	4	13	0	15	13	17	1	8	8	11	33	6	0	2	19	4	3	11	1	0	3	7	1	13	75	15	8	5	10	4	7	15	9	4	0	19	4	31	7	11	18	8	12	8	1	4	2	0	3	7	4	1	6	5	2	9	1	2	2	2	4	0	1	6	2	7	6	1	5	4	0	1	3	5	2	2	0	1	15	3	1	5	0	0	1	0	6	0
ne0055	654	823	497	768	714	530	477	482	462	275	540	448	331	289	371	263	196	523	369	334	403	351	246	252	382	332	406	351	246	310	364	287	283	237	309	234	170	472	264	289	225	237	324	183	233	182	172	123	164	196	206	296	240	325	241	140	348	434	206	234	231	273	331	299	266	183	149	180	226	311	112	234	146	240	247	563	192	222	187	160	128	222	203	262	316	194	207	231	169	187	165	168	167	221	112	149	180	180	84	151	196	139	169	128	197	205	165	131	143	289	155	128	129	131	220	132	142	110	213	128	161	127	282	117	196	216	115	163	140	144	280	59	234	170	179	357	148	170	118	168	137	68	111	153	207	141	139	317	189	110	125	216	97	119	98	174	143	138	116	163	182	227	114	160	145	205	137	226	211	168	150	197	105	168	141	109	200	112	217	178	205	105	252	173	168	189	184	128	183	188	167	73	177	178	209	171	125	129	156	133	121	236	166	140	210	64	135	149	61	140	123	164	105	37	78	246	212	198	110	240	288	92	132	90	121	113	152	147	127	142	191	117	182	132	103	116	199	211	141	208	133	104	120	131	227	170	76	47	146	53	123	108	98	162	87	94	94	128	121	198	125	178	90	54	200	54	49	169	143	120	114	92	80	114	127	117	134	72	132	128	98	84	121	212	179	187	55	106	96	48	193	68	150	80	87	165	128	123	53	76	105	99	99	76	76	128	152	219	84	160	176	80	154	180	102	144	90	169	61	93	108	107	118	160	181	264	91	113	66	170	57	35	49	83	87	68	102	142	112	162	72	101	94	134	63	83	80	76	149	97	90	103	120	25	68	61	93	136	128	141	74	94	138	135	99	118	134	64	56	78	133	131	125	51	102	144	143	84	98	109	148	70	95	29	70	104	165	96	74	96	130	182	124	104	88	78	97	106	82	73	97	112	40	61	68	70	142	96	65	133	128	66	72	38	114	125	70	83	106	52	67	134	103	58	53	114	61	59	118	103	93	58	73	106	59	8	106	35	111	79	92	211	61	66	81	100	104	105	77	81	107	108	70	83	96	112	52	102	102	52	32	37	79	77	64	69	93	49	70	118	168	38	52	29	111	83	36	78	92	104	155	74	29	147	59	73	56	72	95	52	102	88	177	110	113	90	60	58	44	54	104	84	46	146	90	140	113	47	40	48	39	56	61	53	60	85	61	144	70	68	125	100	76	35	72	47	98	40	81	26	44	57	39	92	117	142	58	53	166	91	31	78	85	38	131	129	97	61	116	62	51	113	60	40	91	74	44	99	46	73	82	105	47	47	49	35	82	32	61	87	53	80	67	111	72	206	49	38	55	56	68	52	47	71	37	58	74	40	65	49	72	46	58	125	69	160	35	77	35	50	28	72	129	30	67	35	73	62	139	100	65	71	101	100	48	53	81	43	39	80	59	153	86	81	30	95	57	8	51	60	31	44	81	69	130	72	72	22	64	103	14	64	88	40	114	96	55	25	94	56	86	46	99	56	54	48	66	82	90	78	38	75	76	48	78	13	45	38	41	68	103	121	53	73	83	63	69	90	22	40	80	23	87	39	99	74	134	58	77	84	98	51	32	69	101	79	41	77	19	65	35	28	69	66	94	31	44	52	47	28	77	53	60	21	41	94	43	74	39	39	57	56	33	96	122	96	79	121	52	82	48	88	32	61	30	109	78	53	41	122	74	30	32	19	17	48	104	44	45	75	104	55	91	46	77	59	47	32	101	64	33	35	36	45	56	98	71	52	33	20	79	36	15	70	13	34	35	41	38	42	25	24	39	28	74	44	10	24	83	43	46	56	20	55	65	16	30	28	54	55	16	29	52	49	23	13	39	43	44	11	85	84	31	13	30	29	44	32	76	51	32	28	79	12	27	26	34	27	39	32	38	67	27	55	33	63	60	43	57	26	50	65	65	50	59	19	43	24	32	47	34	8	10	32	59	55	14	60	58	65	55	49	29	19	22	67	80	47	49	52	30	75	58	9	29	72	38	50	55	22	11	10	47	41	22	115	21	68	38	35	46	34	84	55	48	25	12	46	34	12	31	21	71	22	41	78	11	27	23	29	34	17	42	30	62	53	46	65	22	60	26	25	30	16	28	67	40	10	72	36	116	22	46	36	63	130	47	13	21	57	26	2	26	53	23	33	33	20	75	21	22	37	41	45	76	69	83	25	37	39	72	40	73	35	62	45	58	29	55	42	30	12	21	29	22	48	11	34	25	29	22	36	18	62	83	46	14	70	31	25	13	24	96	39	37	28	47	27	49	20	43	22	80	26	59	38	26	45	39	22	13	21	38	90	6	50	68	76	42	8	34	24	31	76	33	37	9	47	12	27	38	33	24	23	12	30	22	52	33	22	45	8	33	39	61	93	12	57	22	30	12	15	10	47	15	46	30	21	30	67	53	16	12	19	25	4	11	14	22	12	19	29	48	35	44	26	26	43	11	22	35	14	31	44	89	9	40	11	21	48	34	37	57	47	11	61	38	58	25	45	29	44	38	6	41	51	10	49	33	35	58	37	48	18	5	47	32	30	20	35	30	23	17	28	43	14	31	4	32	25	34	38	31	18	47	22	12	44	51	17	32	31	22	49	26	31	18	34	61	26	24	17	37	21	21	32	14	0	12	26	49	21	63	64	16	48	47	20	17	14	99	53	27	6	58	49	17	80	68	25	11	35	47	36	12	55	67	14	128	39	10	34	34	26	45	17	19	0	39	10	17	16	49	39	22	29	25	50	27	24	22	18	54	16	22	11	35	58	45	35	19	9	1	10	17	20	55	7	41	12	35	18	21	8	49	29	29	31	38	35	49	43	18	30	16	45	71	14	27	39	21	25	19	6	73	38	19	11	68	24	13	16	25	21	44	14	16	22	15	16	20	26	19	41	21	15	21	30	30	25	21	23	19	72	29	50	9	36	8	36	28	7	33	34	34	23	9	28	33	18	10	25	20	32	49	53	2	50	14	40	37	39	45	16	9	63	50	50	29	41	21	12	20	12	21	16	17	7	12	34	36	23	17	17	22	22	20	16	35	28	54	7	8	28	10	36	17	44	16	22	18	23	10	24	21	33	27	11	43	4	3	48	8	41	53	23	14	16	30	46	9	10	22	33	27	31	13	25	17	12	25	25	12	22	1	11	19	4	21	22	8	11	26	16	3	10	46	6	13	7	9	6	39	22	15	16	35	9	19	6	18	44	9	14	22	16	9	3	20	15	7	18	25	31	4	39	20	104	8	24	28	7	30	26	26	36	43	35	53	75	29	7	16	24	23	22	8	18	3	11	3	19	26	1	11	40	3	17	70	10	28	7	11	17	20	4	10	9	54	27	14	2	2	10	7	10	15	22	43	34	22	20	14	16	16	12	17	7	17	10	30	16	26	60	27	4	26	5	25	14	7	10	0	12	5	2	18	13	30	5	24	9	15	10	32	39	39	29	11	3	25	9	18	9	27	3	16	6	13	4	23	18	13	8	23	31	14	8	12	6	0	29	18	24	0	25	19	13	7	7	14	6	8	7	29	2	8	11	22	9	10	0	21	14	17	13	25	6	16	19	17	2	11	20	50	1	27	14	2	4	20	22	14	41	4	4	32	3	6	4	14	43	21	20	23	0	3	32	5	13	23	62	3	16	5	17	29	9	19	8	7	18	0	17	2	23	24	0	38	25	13	8	7	12	10	17	8	10	22	9	18	18	11	17	2	8	6	23	10	3	5	5	9	9	8	3	10	15	5	5	12	14	14	13	4	1	12	2	22	6	12	7	1	13	17	11	15	0	4	8	26	12	15	15	8	14	0	8	23	5	22	10	5	10	0	3	9	9	1	4	2	0	3	16	13	2	11	20	24	5	18	16	16	14	9	2	5	3	8	14	15	16	5	7	19	0	7	2	8	0	36	2	1	3	11	4	10	1	7	19	13	0	4	1	20	0	4	6	2	19	4	13	0	8	6	5	1	8	15	9	16	2	2	2	8	0	1	9	4	0	1	4	2	5	47	13	2	0	2	4	7	7	2	1	1	7	1	17	5	5	4	9	3	5	4	5	1	0	8	7	0	1	3	6	0	4	0	0	1	2	2	3	0	4	1	3	0	0	0	0	0	0	3	1	1	0	3	0	9	7	1	4	2	0	1	1	1	0
ne0056	1476	2063	1166	1019	1344	709	948	608	808	706	811	577	527	508	612	516	479	665	546	498	539	492	528	578	618	534	571	551	412	584	627	435	555	391	568	503	428	555	473	414	419	398	368	344	463	355	317	299	319	491	354	436	445	386	356	380	426	461	391	417	305	430	529	480	523	247	285	321	390	356	365	438	287	422	495	503	386	337	248	372	300	305	387	344	453	334	278	352	298	298	438	257	261	357	306	272	261	399	209	255	333	393	442	235	316	385	276	215	260	303	263	190	212	199	263	325	243	231	371	227	378	208	392	192	206	351	229	328	221	201	431	171	403	358	267	611	253	288	206	292	312	202	223	299	363	206	239	491	210	209	249	316	192	265	218	276	249	225	194	362	266	266	258	205	221	278	213	347	361	447	231	278	201	291	184	234	294	184	288	294	302	255	308	249	270	290	307	194	299	210	285	164	202	345	285	339	245	182	263	180	267	383	342	215	457	149	254	235	134	181	176	215	201	127	190	266	257	312	209	267	313	225	217	150	203	220	230	279	198	209	228	187	246	277	143	339	301	246	174	269	164	173	208	302	355	295	157	126	224	157	238	195	141	274	235	150	213	251	171	261	320	277	147	129	249	143	77	183	222	224	235	242	137	240	120	217	164	139	163	150	237	114	180	445	217	378	116	197	194	102	260	191	190	149	178	206	362	271	153	186	188	206	237	137	111	200	255	248	177	163	285	250	181	235	287	222	137	281	172	192	171	161	190	279	159	325	188	156	129	261	117	121	120	163	140	107	143	187	155	237	123	116	257	186	124	129	108	131	227	246	194	121	138	129	150	94	212	161	196	196	191	204	250	213	169	173	200	203	128	94	207	269	218	95	183	277	224	128	139	165	169	180	156	107	131	122	138	144	136	122	152	183	130	199	178	136	170	172	169	161	218	145	122	116	127	159	219	126	114	150	139	150	127	88	160	194	166	127	111	84	104	267	151	100	128	107	92	118	243	130	255	135	158	122	125	44	189	102	104	165	118	323	85	123	181	160	218	165	137	90	191	176	128	148	117	169	91	143	120	63	95	68	200	119	184	85	153	147	93	112	211	69	91	139	176	128	56	182	156	144	185	161	139	127	68	105	121	142	276	87	119	127	191	196	141	183	92	93	100	95	137	156	50	223	251	164	215	65	74	121	81	157	88	107	137	181	117	182	116	84	187	151	130	111	94	159	136	118	132	66	118	121	71	167	143	200	105	85	185	135	78	133	129	83	175	127	147	90	113	108	138	111	67	87	115	104	74	124	85	150	74	207	58	115	85	61	121	69	152	120	122	140	122	112	127	213	111	92	102	79	104	93	134	71	72	110	126	94	83	89	96	69	122	119	110	170	64	135	41	94	53	72	132	92	137	89	125	112	112	177	99	105	79	109	97	91	115	106	76	85	116	132	97	107	97	118	112	35	90	57	88	49	111	146	126	94	88	52	99	63	46	84	142	76	162	90	127	28	111	61	117	64	164	99	136	69	87	205	94	127	63	122	89	87	167	45	65	97	101	66	187	201	60	181	114	54	107	73	51	43	104	44	117	66	115	50	93	134	94	117	100	113	71	97	122	74	41	99	48	128	86	52	92	96	103	63	108	98	56	64	104	67	84	109	82	71	56	152	80	103	72	93	54	117	78	85	89	72	120	108	105	105	88	121	50	151	100	102	69	117	94	73	80	33	51	57	76	82	56	131	118	121	86	81	93	80	69	80	135	96	68	49	54	88	76	109	69	90	130	39	106	83	42	68	66	59	47	92	57	89	53	40	87	103	56	76	42	52	57	79	66	77	38	81	75	24	45	71	89	120	43	55	62	74	53	35	66	91	33	53	161	95	42	44	94	68	65	47	103	81	69	51	83	63	29	66	31	50	60	78	92	60	25	107	57	70	82	62	95	76	68	83	180	98	113	58	110	55	36	84	76	38	32	43	161	81	45	91	55	56	75	52	45	64	48	72	95	41	84	105	70	77	150	43	99	154	52	44	97	35	62	55	59	78	41	113	43	75	67	53	53	61	87	56	59	44	37	66	60	19	77	37	98	62	77	64	44	59	49	85	65	45	33	57	52	61	87	83	39	63	55	31	56	22	68	89	58	50	79	75	84	21	76	80	53	55	90	49	76	65	90	22	40	91	80	24	54	63	76	40	30	58	90	26	55	85	134	84	89	69	44	101	45	68	77	43	51	44	97	57	64	29	25	46	51	48	41	39	68	80	65	32	54	104	92	51	33	76	51	32	46	24	108	91	66	45	67	47	53	44	59	29	137	36	69	49	31	68	74	35	23	34	43	90	35	45	65	77	41	32	49	51	69	72	45	33	36	78	46	52	27	63	43	44	30	40	43	94	42	33	82	28	31	52	70	132	45	114	32	38	29	27	17	59	44	54	22	28	81	67	52	37	48	39	46	18	40	49	54	19	47	48	62	52	68	43	40	50	57	44	57	23	69	80	94	38	49	15	37	59	34	45	61	51	35	54	61	75	46	88	37	93	63	25	67	67	19	55	45	35	73	48	71	20	13	52	27	36	58	68	49	39	21	45	77	18	27	29	94	52	32	51	44	32	35	47	28	63	59	27	40	74	67	30	37	47	30	45	75	33	25	34	55	72	10	31	22	22	21	31	86	35	100	70	16	42	97	40	32	37	84	53	35	19	70	46	36	63	81	23	17	40	53	54	31	56	80	43	29	30	12	40	40	30	51	23	30	6	72	10	18	45	40	55	45	48	24	55	82	22	62	37	36	22	33	23	57	48	27	30	27	33	12	50	30	28	57	5	63	25	60	43	35	32	19	36	25	40	27	76	40	65	18	44	83	59	50	8	51	53	30	32	19	19	86	37	29	13	41	34	17	59	35	33	43	36	29	30	25	30	45	33	10	61	35	24	22	49	79	70	34	48	35	57	41	90	21	34	18	44	30	38	20	56	31	38	24	55	32	42	38	36	33	27	63	50	21	36	26	38	45	38	78	79	25	78	39	78	22	119	26	7	28	27	43	10	37	21	25	36	47	61	15	41	36	12	22	58	58	30	39	18	7	44	37	13	27	58	15	23	29	64	24	18	27	33	53	31	37	5	14	45	15	45	47	31	27	29	27	39	24	14	19	56	38	32	27	55	39	24	51	50	25	43	6	29	23	19	13	25	8	7	25	19	16	48	42	18	35	12	21	9	21	40	19	40	27	10	18	24	16	37	7	39	33	45	22	21	55	19	8	25	28	26	13	30	66	24	27	45	18	16	27	30	36	32	22	56	21	30	27	27	33	32	27	38	5	17	40	27	72	32	31	5	30	35	10	19	75	14	47	18	7	23	39	9	8	18	61	42	16	8	8	12	18	40	47	21	43	71	15	43	21	40	28	14	29	9	15	12	69	18	27	22	75	16	49	35	38	25	25	16	9	15	45	7	34	14	80	9	39	38	17	13	37	49	23	32	36	11	14	10	20	9	18	5	40	12	21	24	16	18	17	25	31	46	29	17	9	11	3	33	22	33	4	25	16	45	16	25	14	4	12	3	43	8	14	14	42	30	15	7	14	3	23	40	11	11	22	30	9	9	19	24	29	6	21	11	11	9	9	20	29	34	11	20	34	8	17	2	10	14	48	14	18	20	1	13	9	16	21	23	16	10	10	31	8	11	55	9	9	20	9	35	2	27	11	9	35	17	10	13	10	17	18	11	50	11	10	9	16	24	34	16	8	6	10	43	42	12	3	9	40	15	14	10	30	18	4	0	7	30	29	9	1	1	14	4	40	4	7	13	4	5	17	6	15	10	7	17	35	9	20	13	12	14	21	7	40	7	24	9	5	20	3	1	16	12	19	3	5	1	4	11	10	7	41	3	7	16	32	23	15	19	12	0	3	12	20	4	18	22	5	3	10	3	12	12	17	1	12	11	3	7	8	3	17	5	10	20	4	2	7	1	4	12	5	9	4	6	3	12	3	4	13	7	0	7	6	20	1	14	0	6	5	7	4	4	2	1	0	12	10	6	4	16	0	8	6	0	14	10	5	3	0	4	4	14	30	8	3	7	2	14	2	5	2	1	6	1	3	1	2	5	0	5	1	1	1	1	2	1	1	0	1	5	0	2	8	4	0	0	0	2	5	0	3	10	4	4	0	1	0	1	1	1	1	0
ne0057	1071	1032	780	829	726	541	647	494	608	598	496	452	428	476	452	347	365	493	409	399	415	356	352	365	442	390	407	450	273	330	507	294	385	332	376	345	356	377	387	316	299	342	236	213	305	248	262	283	261	302	279	339	264	411	264	244	279	307	335	249	284	300	304	310	335	216	215	254	312	238	280	250	179	262	244	396	262	240	212	208	255	198	304	254	274	289	229	292	183	231	293	170	264	208	152	172	204	218	120	148	287	239	231	226	238	288	188	179	226	211	186	155	203	191	247	287	183	198	198	207	232	185	270	116	170	220	191	208	198	183	310	112	226	220	277	438	149	203	172	227	218	171	159	198	238	151	189	348	160	213	187	192	176	202	108	149	191	121	180	242	187	182	195	183	184	239	193	226	186	259	176	214	171	163	183	142	229	164	176	236	281	135	196	186	148	146	161	155	247	161	208	141	159	227	194	189	186	193	193	186	149	219	203	178	224	144	164	166	101	137	163	161	129	95	120	208	169	233	184	220	225	120	215	111	140	124	196	194	156	182	196	146	188	120	97	149	165	200	120	184	125	156	114	242	211	231	103	68	175	75	157	143	113	134	103	146	132	225	126	189	166	192	141	127	149	136	68	127	152	151	136	141	119	156	76	136	112	114	124	117	145	100	112	239	183	237	58	123	144	79	192	128	188	126	196	152	196	164	108	132	139	122	169	103	99	140	233	190	129	149	150	162	154	147	145	146	106	244	81	135	124	125	140	179	125	226	129	91	115	113	58	107	74	106	98	74	137	150	105	161	89	93	109	141	134	130	96	123	151	116	123	136	157	73	106	111	110	79	127	136	117	143	141	140	177	77	182	92	118	77	138	100	133	53	117	168	154	88	127	140	215	83	155	97	89	83	129	117	109	84	133	178	103	157	110	100	120	142	98	82	123	114	104	111	78	76	126	105	111	130	95	59	94	89	115	137	89	92	108	64	134	117	110	73	64	43	60	106	161	108	126	57	83	80	61	30	157	56	99	105	78	226	50	89	133	123	115	115	73	95	107	100	79	104	86	115	72	102	62	51	49	44	80	80	95	74	106	106	80	88	158	63	56	123	109	86	60	78	93	98	123	124	72	82	65	114	82	89	163	62	84	110	119	196	141	137	58	71	37	62	94	95	70	142	133	97	73	53	73	85	54	70	68	60	86	76	93	155	117	64	128	106	83	71	87	108	55	98	103	66	121	108	61	112	161	142	62	77	131	62	50	73	81	37	117	88	135	75	123	78	56	77	70	52	103	120	48	91	52	96	71	90	46	61	47	45	88	59	78	84	68	96	73	96	101	151	51	57	69	50	76	47	66	54	66	74	98	56	49	62	44	52	73	104	71	139	63	105	39	51	32	62	98	64	92	44	108	62	71	159	76	49	87	64	63	72	74	75	33	73	87	112	83	93	72	103	101	17	59	64	43	44	75	63	88	89	45	35	58	57	32	70	80	33	94	78	51	51	83	65	134	25	102	125	89	59	62	114	65	92	61	76	66	54	70	24	61	60	50	44	94	98	45	123	75	30	34	85	23	54	53	44	83	35	87	42	103	67	30	42	101	101	57	60	93	61	38	96	39	136	62	31	88	96	70	27	48	80	53	41	60	58	72	46	43	54	35	65	64	63	67	61	55	94	81	85	66	52	81	87	61	56	43	58	31	141	46	59	66	61	81	49	47	18	33	72	67	63	51	74	68	73	44	47	52	76	43	62	99	60	28	36	66	55	34	89	51	90	33	26	79	44	25	57	31	51	46	48	47	44	34	39	27	44	48	27	18	25	57	19	60	83	25	79	57	33	51	32	64	63	37	20	22	47	23	19	60	54	29	26	76	65	28	11	50	28	48	16	69	48	29	30	58	23	33	28	35	66	31	57	45	57	14	83	34	55	59	44	37	48	68	56	108	67	78	37	42	31	26	84	67	13	28	32	41	53	23	44	56	47	49	27	43	22	43	51	65	60	44	51	52	48	98	19	52	61	44	46	39	21	32	37	47	62	25	77	33	72	41	47	42	27	71	40	72	41	28	31	44	26	27	35	79	39	47	46	53	43	35	33	31	21	44	27	49	40	38	81	39	55	45	19	41	14	37	66	44	20	53	91	80	18	71	45	59	87	46	23	54	48	29	16	37	67	28	36	42	31	68	22	27	39	46	35	48	61	76	92	55	32	40	30	41	30	43	56	42	25	52	57	20	13	18	26	18	38	17	33	16	75	19	30	17	58	60	45	22	66	23	39	9	48	71	43	44	34	42	30	40	26	28	17	58	26	44	22	28	40	23	31	11	29	21	54	32	40	43	40	34	38	34	18	46	48	30	41	14	48	19	34	35	29	21	23	15	36	49	50	16	27	52	20	36	50	42	106	34	63	25	24	10	45	10	55	17	26	17	24	38	46	27	20	15	35	23	5	28	15	39	7	30	47	44	54	42	21	24	52	17	23	35	21	40	50	52	18	37	11	27	45	43	41	36	32	26	45	32	68	14	31	17	54	70	16	33	30	23	33	30	32	43	39	45	28	12	39	26	33	24	52	67	21	28	26	38	19	16	22	32	26	45	26	20	28	14	21	6	34	45	27	45	33	33	37	27	37	10	34	41	16	31	24	33	27	21	16	21	6	8	27	49	18	59	57	8	32	49	11	20	22	80	40	14	5	51	30	25	26	49	16	16	15	27	41	15	33	51	27	39	37	17	43	34	36	32	23	17	5	35	30	26	41	28	41	23	22	21	42	37	15	39	21	40	38	17	17	31	51	22	19	22	12	10	19	13	10	40	3	27	29	37	28	25	16	35	44	22	41	22	59	24	43	9	26	25	36	69	14	17	37	20	21	23	20	55	38	11	20	38	10	8	17	23	20	44	17	18	24	15	16	13	38	22	53	21	19	15	16	31	28	8	46	15	46	27	49	28	22	4	38	38	10	25	58	33	17	12	34	16	25	16	37	12	31	38	32	9	32	20	37	19	37	40	17	16	26	32	57	21	34	23	29	23	10	15	18	45	11	29	14	22	14	12	34	15	21	14	13	20	16	51	7	8	20	23	15	17	37	17	14	18	21	11	18	24	33	19	20	38	7	3	22	5	44	31	16	17	10	14	33	34	20	19	25	32	35	12	19	12	15	50	19	21	22	4	10	11	7	15	26	26	6	19	9	8	29	42	13	8	7	3	3	13	44	8	28	10	3	18	11	14	20	4	25	17	14	7	7	15	11	13	16	17	26	9	22	33	36	10	32	16	5	8	17	50	21	29	32	60	41	23	13	19	22	12	23	8	11	19	9	28	15	16	2	19	27	11	9	44	13	28	5	4	21	15	10	3	11	32	19	10	6	8	10	8	53	13	16	24	27	5	18	9	17	26	20	24	17	5	6	25	10	23	33	45	2	23	11	10	7	5	24	5	17	17	5	10	5	32	4	41	16	18	9	21	23	17	17	9	2	8	8	18	0	23	2	14	14	15	6	18	15	5	7	24	28	9	16	5	8	2	23	14	24	1	11	7	17	15	4	10	2	6	11	26	3	7	7	20	12	14	6	19	13	17	24	18	10	17	16	12	9	11	7	24	3	20	22	7	3	10	10	10	28	5	12	27	6	9	4	6	12	35	6	8	12	4	10	1	16	18	24	4	10	12	11	16	11	29	8	8	14	1	14	5	27	8	2	19	17	8	1	4	7	8	13	4	15	17	8	7	11	17	20	5	7	10	28	13	6	3	5	7	5	5	2	8	13	1	2	7	14	10	3	1	5	7	6	19	3	13	24	0	5	6	6	8	4	7	8	24	4	17	10	5	31	2	3	10	6	23	10	6	10	3	2	7	9	1	0	2	0	7	6	3	4	14	12	67	2	16	19	9	16	5	5	6	5	10	16	7	8	5	4	8	3	16	4	9	0	6	6	1	1	4	9	5	4	6	13	4	0	5	5	6	12	1	4	8	19	5	4	1	0	8	11	1	5	18	9	3	5	2	4	8	3	6	1	2	0	1	2	1	5	26	5	6	1	4	3	9	6	6	2	0	4	5	4	10	6	1	8	2	0	0	3	1	0	1	5	1	1	2	2	7	2	2	2	2	1	1	0	0	4	1	1	4	0	1	2	0	1	1	5	0	0	4	4	0	0	6	1	0	1	10	3	1	0
ne0058	2672	2050	1313	1210	1172	900	940	802	1132	873	1104	753	708	752	843	572	554	903	477	516	661	646	621	719	688	814	704	551	773	657	686	622	532	498	578	625	547	669	620	622	563	502	675	664	438	426	427	452	421	574	398	456	352	530	488	431	677	487	583	413	369	457	560	604	467	553	387	498	489	501	456	388	529	538	487	471	415	497	541	530	413	523	301	442	439	369	447	382	297	499	365	295	293	403	432	359	356	388	367	392	416	335	306	300	378	337	356	312	294	303	367	340	243	274	301	339	290	311	568	289	305	289	418	351	374	359	387	345	263	284	338	298	485	338	326	532	415	368	264	447	320	298	402	415	345	292	392	524	375	346	314	340	291	313	415	448	273	352	223	230	396	371	332	372	257	304	316	361	393	218	303	363	268	331	213	225	342	220	311	324	454	299	288	246	238	384	272	329	332	314	323	310	349	255	276	225	287	184	338	285	292	274	361	295	523	304	321	215	242	291	198	329	327	228	169	324	324	316	260	313	275	246	293	254	304	275	287	331	347	335	284	293	335	287	371	230	263	257	220	269	217	282	228	196	304	212	266	337	329	216	245	328	188	341	188	172	339	266	267	322	229	242	250	245	277	184	190	289	256	236	278	221	248	276	214	245	241	265	203	221	286	251	220	545	260	491	213	253	279	151	237	248	243	218	205	273	216	212	169	232	268	294	276	216	237	274	254	269	216	302	228	215	199	189	260	263	241	252	190	205	257	237	250	319	216	167	210	211	230	274	202	216	179	175	240	224	170	278	184	218	203	215	181	204	182	230	205	220	250	271	185	273	187	179	214	219	176	238	258	287	240	141	100	264	252	226	220	167	200	202	185	220	156	198	229	246	175	226	186	172	172	274	172	198	195	175	239	142	176	204	190	175	186	216	233	216	243	233	281	146	200	224	213	184	195	196	224	167	211	196	186	224	179	183	198	158	219	202	199	179	138	255	155	185	153	287	167	153	244	234	136	182	143	187	151	149	186	204	178	183	163	241	212	175	129	194	226	174	136	194	142	225	121	195	182	158	138	184	139	127	171	158	231	166	132	147	136	176	149	204	111	169	183	212	132	180	135	205	177	228	188	226	177	208	127	196	203	166	80	147	155	147	155	281	177	177	204	160	167	125	135	155	141	84	85	159	220	157	114	169	138	146	183	141	147	109	169	169	162	126	165	218	116	72	169	149	165	95	176	115	99	119	132	155	113	136	87	100	145	167	182	140	130	156	173	141	155	193	163	126	129	185	130	150	183	153	144	149	120	166	145	145	117	157	167	162	141	122	147	153	117	139	184	142	154	63	118	116	107	110	134	121	129	130	170	135	153	119	119	119	137	124	109	143	120	134	131	161	96	114	134	177	139	130	148	140	133	89	124	112	132	103	111	181	132	163	122	128	103	96	114	98	92	128	149	117	122	100	124	114	187	120	137	92	107	104	94	91	169	186	104	34	103	121	133	152	178	75	117	132	170	157	104	109	125	112	105	91	94	85	73	117	122	130	125	109	141	106	116	115	164	139	131	75	80	102	132	152	111	86	111	132	120	159	101	180	128	235	147	123	156	80	84	103	175	137	74	137	86	115	134	91	107	99	67	104	101	122	82	99	86	123	98	116	149	83	70	115	119	69	73	109	113	106	111	94	80	89	113	116	103	89	107	96	101	120	107	104	102	89	93	127	44	94	91	107	152	95	94	88	111	105	84	91	129	84	114	69	120	139	78	71	122	99	119	123	134	62	94	92	143	90	66	108	69	104	98	143	107	115	77	78	84	92	79	79	69	68	80	96	93	111	103	88	101	76	111	74	74	83	91	80	166	63	68	130	86	108	53	92	81	107	47	103	72	64	72	135	85	70	53	88	110	78	71	108	57	90	72	94	132	112	75	78	54	107	74	102	117	130	114	84	38	97	87	155	85	99	93	103	82	112	65	69	92	81	82	81	68	80	68	78	66	68	103	76	101	99	117	79	83	92	72	75	92	72	60	87	89	136	56	56	80	77	69	44	73	80	112	65	72	82	92	60	127	71	72	82	89	61	82	57	79	66	78	81	49	77	43	76	70	103	48	87	81	114	62	112	56	64	61	63	126	63	68	94	87	58	52	91	80	112	84	95	69	51	120	73	74	63	153	64	117	77	47	71	71	63	60	55	77	60	74	88	78	85	86	58	82	116	74	63	70	55	87	60	61	81	60	76	78	46	58	59	54	69	58	73	76	69	58	122	81	70	128	60	92	65	75	58	62	71	80	79	79	71	70	54	64	64	102	64	84	60	67	86	103	71	92	64	94	66	61	71	30	76	63	53	78	52	54	65	53	98	103	62	67	81	75	66	49	92	54	45	51	83	72	45	42	74	74	91	86	23	100	120	63	54	37	53	78	24	59	69	55	126	51	121	62	58	53	40	75	48	51	50	31	48	47	65	57	53	37	106	85	77	72	69	75	58	74	51	106	68	68	72	66	60	64	94	50	52	50	37	37	57	72	89	45	72	65	64	39	57	64	74	32	68	67	38	78	36	90	26	58	50	56	57	56	39	72	58	128	69	33	38	68	30	66	49	58	66	40	51	37	34	65	86	34	44	72	57	43	47	54	24	42	80	67	54	51	62	62	48	34	45	102	39	69	44	56	47	74	53	61	53	39	109	32	63	77	66	99	37	67	56	82	56	72	47	39	52	34	70	26	73	50	61	30	47	41	56	54	44	48	37	48	44	76	39	47	52	83	70	25	77	46	93	65	52	49	68	74	16	35	53	59	98	66	38	46	25	37	48	33	42	68	27	84	34	30	44	24	46	43	43	43	37	67	28	79	47	26	48	65	51	40	47	80	71	36	67	21	30	64	63	50	24	95	41	40	47	51	26	64	49	32	22	42	60	37	31	51	70	36	29	43	50	60	35	37	81	72	31	40	31	33	46	31	35	27	13	54	43	47	23	39	38	63	42	43	52	35	45	62	79	37	31	59	25	66	50	133	45	43	69	43	67	29	31	27	36	31	41	24	38	25	37	28	31	49	31	50	40	35	44	48	30	46	53	27	24	49	46	28	41	41	70	22	32	49	36	35	46	20	27	34	37	37	14	16	35	33	72	37	39	31	28	35	42	56	98	24	33	27	46	32	27	27	35	29	50	19	26	46	23	30	38	31	73	13	48	56	51	21	36	69	25	26	16	17	18	30	73	37	35	29	28	34	26	30	30	49	47	31	34	21	28	23	29	18	39	47	34	39	47	31	16	26	5	30	33	37	38	48	31	45	28	20	40	48	32	53	28	18	37	21	41	32	20	31	20	33	15	15	51	41	30	44	44	52	35	15	24	29	40	20	31	28	23	25	21	20	48	17	30	34	9	19	57	32	17	34	30	28	34	28	30	27	16	21	35	18	27	34	28	25	22	68	30	33	78	18	36	31	31	15	21	32	26	34	26	29	20	13	21	29	14	13	23	18	36	17	19	21	14	24	32	15	19	40	25	11	33	21	14	31	28	34	22	19	48	39	24	13	33	20	15	2	27	32	20	16	19	62	13	31	12	34	36	25	13	21	21	41	16	27	16	11	24	23	16	16	27	17	12	18	21	11	17	14	9	21	10	15	17	25	10	23	1	37	18	45	25	11	14	15	17	7	7	32	15	24	13	5	10	9	24	17	15	17	13	12	22	23	47	8	17	40	32	13	8	9	26	11	34	14	11	22	11	30	15	28	27	11	8	16	29	10	14	9	6	12	19	12	5	31	39	7	3	7	24	31	16	16	10	11	10	17	13	12	1	11	11	10	19	17	3	21	10	58	5	27	8	11	5	8	21	7	14	48	16	15	10	19	4	12	6	4	8	7	5	5	19	6	6	54	7	11	7	20	12	7	18	14	7	2	4	2	14	8	23	4	7	14	6	9	12	10	6	3	6	7	6	12	11	8	19	3	5	18	10	5	5	18	8	5	4	19	6	4	12	6	9	11	11	1	12	3	19	7	5	4	3	4	7	3	4	7	3	5	8	19	19	8	10	11	1	18	5	7	2	5	12	2	1	8	6	5	0	7	0	1	8	2	14	3	1	6	4	0	1	1	8	6	2	2	0	1	3	5	0	0	1	2	8	3	0	1	0	0	0	0	2	0	1	5	4	2	0	2	0	0	2	0	2	0	0
ne0059	1796	1800	1132	1710	1686	1085	1170	950	1020	936	1041	852	726	760	867	701	563	840	725	620	743	646	519	677	719	672	841	731	599	731	710	609	658	546	667	566	532	855	576	513	551	510	501	476	525	459	455	450	425	517	548	601	656	748	499	358	516	587	503	565	476	477	541	470	539	394	387	400	510	494	333	537	324	395	563	853	364	440	423	316	349	364	498	521	614	429	376	490	355	429	379	264	439	351	232	338	341	394	257	375	504	371	455	387	493	486	434	340	301	379	289	302	332	320	449	317	330	357	339	337	349	359	481	256	370	485	238	343	354	322	523	187	415	384	423	700	298	341	317	416	288	248	308	345	454	346	267	511	317	325	310	338	334	334	208	321	337	236	301	437	374	359	264	352	259	368	266	378	375	463	360	352	230	321	315	229	457	269	364	390	585	254	440	390	338	305	355	287	421	334	301	229	367	380	345	412	275	280	336	368	272	466	329	335	333	222	243	342	116	264	276	330	231	157	284	398	331	342	300	413	459	273	280	221	307	299	330	316	302	288	316	263	384	260	212	252	407	365	260	320	273	217	174	415	351	425	223	133	324	156	275	309	222	270	167	239	232	388	286	385	248	353	199	205	290	188	150	249	280	239	245	186	210	265	174	251	233	228	176	237	176	173	223	391	318	280	117	224	244	125	407	204	274	244	317	228	323	223	151	203	274	194	222	140	186	224	338	383	189	219	339	253	272	284	220	216	207	390	194	251	206	191	295	315	236	336	211	183	224	266	163	179	148	203	185	174	209	308	221	362	150	198	217	369	166	168	188	178	284	185	205	189	228	87	155	202	253	186	241	229	193	165	327	315	262	178	276	168	216	172	182	257	275	143	187	209	229	219	223	228	407	171	192	139	219	187	233	211	200	157	281	404	299	202	212	171	208	278	131	175	183	223	173	179	137	134	239	178	235	288	198	105	185	154	202	205	191	175	288	126	141	268	197	156	94	221	155	184	242	198	216	116	205	184	158	45	228	96	150	167	170	397	132	128	202	192	213	180	133	143	185	192	159	189	188	196	107	178	151	79	111	93	212	127	173	161	161	194	135	168	659	101	134	159	229	161	86	175	196	144	256	175	124	191	152	91	177	181	222	95	212	184	227	202	262	205	126	131	99	111	165	187	101	274	216	235	157	71	117	170	111	105	126	111	137	208	155	235	195	160	245	218	171	99	169	172	162	129	136	176	156	118	89	167	299	277	116	89	222	108	56	159	183	69	218	191	255	105	251	155	100	150	160	97	167	159	84	181	68	180	152	149	108	111	124	102	145	113	108	143	141	136	157	164	167	254	115	117	101	120	162	111	115	124	110	144	159	83	136	117	117	88	117	206	133	280	87	162	103	91	60	80	144	167	162	78	152	186	168	434	121	123	166	152	88	117	166	108	69	163	101	214	125	105	134	181	121	37	93	113	84	67	127	133	157	196	132	57	118	118	65	131	145	115	204	155	124	64	156	102	172	56	216	146	131	128	119	182	102	173	71	161	117	93	130	38	66	83	94	91	155	191	100	168	181	85	99	137	64	66	122	90	148	61	171	106	165	134	119	145	169	128	79	147	127	120	69	161	57	160	89	42	120	225	161	76	131	143	98	97	148	118	119	86	130	125	82	137	51	88	128	93	88	197	138	119	101	98	126	175	121	150	99	147	63	186	125	127	98	131	149	78	93	42	44	91	122	97	100	113	187	125	117	67	129	113	117	95	147	123	82	59	96	124	83	154	114	136	79	36	114	85	55	126	76	64	75	118	87	106	58	104	63	103	79	76	75	67	123	68	71	91	50	140	100	43	72	64	113	87	42	38	91	109	74	36	108	86	73	51	135	153	54	42	152	47	83	51	149	88	59	49	148	31	66	71	64	46	73	58	94	86	49	128	76	112	136	109	87	110	114	127	160	124	148	57	83	54	58	68	65	19	49	48	106	91	51	77	125	100	132	64	86	41	56	122	129	96	123	88	69	119	188	55	68	104	112	84	86	57	40	65	59	91	42	171	58	140	43	90	82	97	129	84	125	66	50	100	82	45	62	61	129	65	95	79	84	58	60	49	62	35	58	59	55	96	93	128	41	84	64	38	49	59	65	104	94	27	112	90	158	34	98	65	106	107	94	53	68	102	51	35	46	112	78	72	108	47	122	53	48	57	93	61	88	151	111	129	112	65	107	71	88	52	102	82	95	56	100	108	68	21	62	39	56	64	41	69	56	121	39	37	43	116	108	58	44	150	67	70	41	32	115	87	106	51	80	80	64	53	69	59	106	52	102	62	45	84	74	70	41	60	60	101	46	94	125	108	61	24	45	50	102	89	40	74	33	84	53	65	67	77	33	53	35	66	83	88	43	47	110	34	92	108	105	177	43	68	54	44	56	58	26	88	48	82	58	48	85	91	55	22	27	60	36	8	62	43	66	34	39	87	101	56	89	47	42	79	63	49	49	50	74	92	127	35	58	23	70	79	95	62	79	66	44	71	94	99	49	64	43	107	114	38	45	70	27	46	77	96	77	79	71	40	30	67	35	70	93	60	57	45	46	70	68	21	48	39	53	52	79	58	41	44	35	55	27	68	76	40	51	54	130	70	63	66	25	41	76	47	50	29	68	68	30	54	33	18	32	58	96	28	115	108	23	71	96	101	28	44	121	84	37	23	77	65	40	77	88	46	35	50	68	41	28	72	98	70	80	58	36	84	49	43	73	50	43	5	75	29	46	48	71	82	57	66	52	82	38	25	60	38	65	48	41	48	102	52	66	39	50	26	17	41	42	23	88	10	87	30	86	50	49	36	33	53	54	75	43	119	72	82	20	55	52	63	103	31	36	33	37	69	47	39	98	52	18	21	76	68	34	56	31	51	70	42	29	41	36	31	45	70	46	82	57	29	23	31	55	54	22	67	48	76	54	85	42	60	23	49	30	21	39	144	45	44	39	62	43	67	20	28	42	71	74	57	13	81	36	85	43	56	64	31	19	82	69	118	40	47	46	44	20	15	42	33	56	20	11	31	42	42	19	63	30	25	46	37	47	46	64	14	16	47	31	47	51	75	37	39	38	33	29	22	34	51	56	31	78	14	7	65	14	39	76	36	33	30	38	82	31	44	22	43	49	43	32	43	18	17	70	34	31	37	3	32	37	17	31	58	24	28	32	18	16	61	48	19	22	12	17	19	39	56	30	48	49	13	27	36	25	49	23	55	39	45	27	24	46	26	12	21	41	43	11	43	56	41	13	34	54	21	38	25	35	49	43	54	37	53	34	21	27	38	28	45	12	29	111	32	50	29	24	4	32	61	17	26	70	15	35	23	13	40	17	25	6	29	69	42	14	5	10	13	14	61	35	31	52	59	16	44	26	33	48	20	50	25	20	31	62	25	38	18	95	22	46	28	28	37	10	42	5	35	20	3	22	26	57	7	85	36	22	22	38	70	47	42	45	6	30	7	23	10	48	6	34	17	31	14	42	33	16	14	38	135	18	25	32	37	4	41	27	64	1	35	14	14	19	17	54	16	23	14	30	9	22	19	42	32	25	16	32	14	31	36	44	17	29	15	23	6	29	22	77	3	42	37	16	7	7	17	30	46	9	27	43	13	14	3	19	22	43	26	22	49	7	29	11	25	39	54	16	13	27	22	34	20	46	11	5	37	5	23	9	41	23	9	17	15	16	12	21	20	15	21	19	21	47	20	19	25	9	22	15	9	31	43	35	13	7	12	21	25	11	13	20	20	3	4	29	38	27	22	11	19	20	8	42	13	25	30	4	9	19	7	21	6	13	16	38	18	21	11	9	30	10	18	30	8	27	12	24	9	8	13	21	10	2	4	2	2	15	14	10	11	31	24	11	10	18	29	21	23	16	5	5	13	22	29	23	32	11	12	26	12	12	7	21	2	20	5	2	2	10	13	14	10	8	27	12	7	7	3	12	7	9	5	71	22	2	14	6	1	7	9	0	10	17	13	9	18	15	6	12	6	7	11	2	1	4	13	8	11	5	6	6	17	9	3	8	7	9	3	2	11	2	12	13	20	11	9	3	6	6	3	3	0	5	14	3	1	8	13	3	8	0	0	1	4	6	0	0	7	2	7	3	1	3	1	0	4	2	8	6	0	6	5	23	4	3	1	0	0	1	0	3	0
ne0060	849	1073	583	532	617	533	585	510	409	426	402	395	391	403	463	347	332	343	329	369	373	313	271	341	328	334	370	371	244	423	327	260	365	302	304	315	267	304	278	273	206	299	201	242	278	249	239	238	193	272	246	307	220	264	211	226	217	311	248	224	247	232	266	214	284	181	210	212	227	221	195	232	204	179	215	332	178	211	207	139	201	176	275	176	237	208	154	247	165	212	245	164	211	178	106	140	185	214	135	190	272	211	260	195	206	263	162	179	166	166	171	141	161	179	232	166	200	151	183	192	159	199	202	112	139	184	111	163	185	172	277	99	235	165	189	233	121	119	173	175	138	135	119	167	176	173	141	210	118	180	179	141	154	142	109	136	126	122	169	218	154	151	181	203	125	134	110	196	159	259	123	131	123	214	170	124	212	157	146	140	233	124	174	113	152	164	164	116	153	133	108	126	118	207	149	218	109	150	141	165	157	196	148	132	204	106	119	181	79	112	159	140	102	87	106	189	143	178	143	167	189	125	145	101	177	138	141	200	119	112	135	101	183	121	79	193	147	152	131	122	144	99	108	144	112	198	123	78	103	73	127	113	89	123	122	135	95	156	111	155	174	178	79	128	106	79	83	128	106	127	124	115	81	126	91	105	94	92	100	92	123	74	78	185	162	120	81	103	110	57	178	103	131	100	119	97	195	110	91	81	116	88	143	98	69	96	146	181	77	101	132	127	114	145	123	79	93	173	112	127	128	122	94	169	84	201	113	91	88	119	65	83	67	101	102	65	67	163	76	168	54	82	136	102	83	95	71	88	112	103	102	87	107	56	71	98	82	80	93	92	103	78	147	140	106	68	98	107	90	68	107	106	135	59	93	117	89	97	80	90	139	117	94	62	86	42	79	99	84	77	134	117	69	102	125	86	84	80	79	97	100	126	72	89	75	69	102	77	102	108	87	58	48	72	87	79	95	83	141	44	73	100	108	81	47	100	58	87	105	68	148	95	71	81	63	31	93	47	77	73	75	155	61	47	103	90	114	63	74	71	98	98	64	71	90	84	40	90	53	41	50	41	90	62	73	49	72	88	60	75	122	63	54	58	98	68	38	68	57	67	64	69	74	97	44	52	64	97	157	57	108	72	103	94	87	91	59	59	64	50	54	63	50	127	126	94	79	34	73	72	41	70	54	55	76	108	61	108	68	66	97	97	91	31	64	69	59	60	71	45	70	78	42	97	104	131	39	50	79	87	46	68	68	45	65	62	78	45	140	47	72	82	51	48	91	68	43	62	30	66	54	122	33	57	43	36	51	36	65	72	79	42	64	65	62	155	60	77	63	46	73	61	69	47	59	54	83	66	57	58	37	54	77	99	58	68	58	69	32	54	35	61	69	62	61	56	72	60	83	110	78	76	64	70	51	35	48	50	58	74	42	99	56	60	71	61	64	20	61	48	31	38	47	62	56	83	44	37	32	52	32	36	103	41	78	62	84	31	83	41	88	27	107	63	59	40	44	108	57	68	24	62	67	42	82	25	37	51	63	50	83	70	44	112	64	20	60	39	33	51	38	39	77	33	93	49	82	79	63	47	55	66	46	51	62	42	29	96	30	56	46	24	54	61	70	56	66	49	28	48	61	57	60	59	58	77	46	64	33	49	39	40	42	83	61	44	57	49	54	64	46	54	33	63	59	73	65	39	47	56	57	42	48	23	22	44	30	38	27	71	37	53	43	20	44	57	56	51	57	35	32	26	45	57	39	67	30	63	53	29	63	36	27	51	31	28	24	42	38	44	30	48	45	37	40	44	27	44	39	37	31	49	26	59	77	18	45	34	49	41	22	27	16	38	41	10	49	61	26	26	72	23	33	15	49	29	34	27	69	37	30	27	30	22	17	26	29	31	37	29	36	31	38	56	32	43	46	39	38	53	39	32	105	41	51	23	46	18	32	37	40	29	40	26	68	31	13	47	54	68	51	34	25	34	17	47	60	31	49	34	25	50	59	18	40	59	43	34	39	21	18	38	27	63	35	63	35	52	24	21	36	30	43	39	64	15	31	36	33	13	48	28	41	34	56	44	35	41	25	41	36	22	32	36	16	69	34	74	19	44	26	17	18	12	36	45	32	28	54	49	35	20	35	36	34	45	71	22	42	30	35	21	18	48	31	10	35	29	38	30	15	38	50	14	30	51	35	47	39	25	39	45	33	35	33	43	48	26	38	75	39	19	19	18	25	25	22	19	33	53	35	22	20	51	47	36	19	36	31	39	20	25	54	43	21	23	38	34	32	36	28	22	55	26	47	27	8	43	35	20	5	24	26	23	25	34	34	49	18	19	42	26	54	43	26	25	27	48	22	27	17	34	26	26	17	19	23	50	41	27	41	16	46	31	37	47	24	46	23	27	20	15	10	44	22	31	24	20	47	41	33	21	17	20	20	7	20	17	28	5	28	54	46	25	36	29	30	31	21	28	21	17	19	23	45	21	21	11	20	29	28	45	29	35	30	33	30	46	24	36	22	33	49	28	33	29	13	40	21	34	34	31	34	22	15	34	16	18	29	34	28	13	14	31	35	8	18	13	41	22	12	37	21	27	31	25	14	22	25	10	23	32	22	36	27	19	10	15	27	20	23	10	23	26	23	27	14	10	6	25	38	14	59	29	17	23	49	50	13	13	38	35	22	9	39	28	17	19	41	16	16	30	19	18	11	28	21	16	14	24	8	23	28	25	32	30	23	5	18	20	14	24	19	25	21	33	20	24	31	19	24	22	23	14	19	19	33	20	52	21	19	19	12	16	11	14	40	2	20	17	37	25	28	11	12	20	21	18	27	54	34	32	9	35	20	39	33	7	18	18	24	22	17	18	44	32	24	11	38	19	14	29	21	14	56	18	18	17	16	10	33	22	23	32	57	15	19	21	24	23	16	29	19	24	15	25	14	18	5	19	18	13	24	25	21	13	28	33	17	23	16	16	12	29	37	32	10	31	8	22	29	56	37	14	17	19	28	44	25	51	12	19	8	14	14	11	18	5	11	40	17	20	15	14	15	18	8	13	10	16	17	8	11	10	24	13	11	29	13	13	18	33	27	15	16	14	20	12	21	1	7	19	8	15	32	16	15	18	17	27	14	29	18	23	23	20	17	22	23	13	25	15	13	20	9	9	18	7	25	14	13	6	13	11	22	16	15	11	16	4	6	5	18	22	12	14	21	9	13	21	12	13	7	23	19	16	13	13	20	5	13	13	9	10	6	11	32	17	7	10	16	4	15	18	17	19	17	26	6	15	17	4	13	24	21	27	5	16	12	16	16	12	18	2	13	19	10	14	29	10	13	5	1	8	14	6	7	8	26	24	11	5	7	7	11	22	14	19	21	18	14	24	13	14	22	8	12	41	5	15	28	12	18	2	18	3	20	16	8	11	10	12	1	7	7	6	10	8	34	7	23	18	23	6	33	30	15	28	14	4	6	8	12	5	12	2	20	11	15	9	8	17	6	7	18	11	10	4	7	15	3	11	13	21	3	10	10	25	3	8	22	2	8	8	9	6	4	3	17	15	7	2	12	4	12	9	14	4	10	17	9	4	15	14	20	2	12	14	6	0	2	3	13	13	7	14	15	4	6	11	6	3	12	15	8	10	6	6	3	12	8	14	10	4	2	12	8	6	15	9	3	13	2	8	7	4	7	2	5	8	4	2	3	4	7	6	9	11	4	8	8	12	15	9	2	10	4	25	20	3	4	4	10	4	4	6	4	4	7	0	8	4	13	5	2	7	7	2	18	4	12	5	2	5	10	2	3	3	7	1	9	6	9	5	11	3	5	1	12	4	7	12	2	10	2	0	6	5	1	1	3	1	6	3	4	3	6	0	8	2	12	25	11	8	8	4	5	6	8	5	3	10	2	6	6	3	5	8	8	1	7	5	0	2	0	5	3	7	3	9	1	0	2	1	1	2	2	3	9	7	3	2	5	0	3	5	0	6	3	0	3	4	6	3	6	0	3	1	1	1	0	6	3	2	0	7	1	2	2	2	3	6	5	3	0	0	1	2	2	4	1	5	1	4	0	0	2	0	2	3	1	0	2	2	3	1	4	2	2	2	1	0	0	4	3	0	1	0	2	1	0	0	1	1	1	0	1	1	0	1	0	1	0	0	0	0	1	0
ne0061	2189	2268	1548	2229	2247	1154	1662	1013	1109	1257	1227	1038	837	855	1029	893	668	1077	953	738	952	747	720	1022	834	872	948	926	726	766	890	823	861	704	837	634	731	867	815	575	628	604	613	650	639	512	586	462	581	627	650	789	817	1175	731	425	591	659	704	707	562	620	654	467	630	480	441	573	646	613	563	681	397	512	667	895	450	550	503	363	461	477	685	597	679	558	455	615	448	577	572	320	550	474	358	485	413	476	350	495	642	510	713	431	568	629	544	388	380	575	355	406	398	377	535	516	391	455	394	388	320	416	507	334	445	555	304	429	402	375	729	242	596	484	513	918	254	431	382	530	352	288	392	471	556	341	340	554	366	386	390	402	337	451	197	363	370	295	368	721	440	461	390	394	338	543	366	421	546	639	381	470	305	428	375	272	583	328	420	421	958	394	537	367	442	404	427	344	456	363	262	273	453	538	429	557	333	358	308	379	293	529	368	399	377	284	320	406	131	330	337	314	234	190	436	456	384	469	306	481	522	346	332	278	354	271	363	469	306	379	377	367	340	245	234	353	546	486	286	376	217	296	192	518	273	491	246	207	375	181	379	419	262	290	270	294	329	426	312	385	401	429	222	208	278	237	141	381	351	252	296	259	257	333	192	259	270	278	212	273	251	209	292	413	482	354	170	268	342	154	507	231	415	285	396	303	471	222	131	264	346	302	257	168	251	266	358	414	144	232	360	365	398	317	253	151	284	369	292	378	255	272	287	437	232	578	291	212	271	262	154	210	146	289	218	215	224	536	239	408	210	256	340	501	211	220	268	184	364	233	257	248	285	117	221	212	284	241	278	246	176	296	469	332	272	178	357	166	221	234	254	319	374	143	250	263	186	177	261	292	742	194	263	167	191	210	226	272	252	194	502	489	243	162	317	212	276	319	198	308	207	340	210	219	169	220	293	221	225	285	255	163	223	177	153	177	195	185	329	159	199	240	269	152	119	263	136	239	341	213	376	138	212	203	198	55	268	150	174	197	164	496	145	162	302	257	226	141	194	187	193	277	174	234	218	268	164	213	168	103	157	130	217	152	230	162	223	291	123	205	742	106	130	221	298	206	144	200	231	174	297	247	147	208	156	114	192	204	356	115	311	229	273	225	293	233	153	166	110	99	222	174	149	364	364	184	165	70	129	174	127	142	144	157	180	231	184	206	231	165	251	288	216	131	206	239	146	160	177	236	210	160	82	214	376	353	163	124	285	122	89	240	209	111	247	148	342	169	292	154	114	154	146	94	201	178	74	234	73	186	190	224	141	126	159	113	200	155	144	205	222	92	180	172	190	451	148	207	130	160	196	133	138	149	117	135	218	111	113	123	121	96	124	217	124	267	82	209	82	104	79	114	207	204	207	125	245	259	184	461	239	202	197	149	101	169	146	152	109	189	165	317	175	113	193	237	198	37	87	99	72	100	170	165	225	193	196	84	136	151	68	178	157	92	237	162	156	131	187	120	221	95	283	165	172	121	150	287	129	201	110	165	125	110	180	63	87	93	94	86	200	189	136	279	153	75	111	134	72	72	138	91	153	64	275	70	287	221	159	176	180	172	108	125	132	113	65	215	63	261	114	77	179	246	157	72	142	196	107	75	172	116	125	92	156	97	90	158	154	105	103	124	110	225	144	201	136	213	183	201	139	153	132	171	63	221	92	124	155	164	175	91	85	50	54	109	154	110	99	149	200	158	141	75	94	152	132	162	156	90	113	73	85	133	87	151	125	163	119	55	155	94	75	172	93	122	86	129	77	151	48	91	77	138	108	134	110	75	140	62	104	106	54	145	202	32	116	62	148	105	57	49	110	106	74	47	144	115	91	52	156	190	59	56	208	46	106	58	143	112	41	39	184	62	70	79	61	97	96	127	107	107	39	112	81	123	128	92	121	129	132	102	266	134	172	87	136	84	82	124	58	27	55	49	100	121	38	92	157	189	145	65	76	36	53	130	155	85	118	120	82	90	232	45	113	140	128	66	105	77	74	54	60	140	44	187	52	160	51	57	101	77	165	124	125	68	59	153	110	38	93	79	115	57	133	93	59	60	87	56	104	57	53	45	84	126	105	151	55	100	107	25	68	51	120	135	90	31	124	106	168	55	106	79	118	221	120	51	87	105	81	59	79	123	102	77	90	74	165	70	49	73	76	78	85	140	127	223	151	78	87	110	82	58	129	97	91	66	105	241	67	27	56	41	55	66	51	73	40	174	30	56	46	162	119	52	50	155	56	71	52	39	133	106	74	51	111	91	97	65	83	57	113	47	97	73	41	85	100	80	29	60	63	129	53	102	112	103	70	47	52	54	130	83	56	69	47	91	58	79	76	101	52	73	41	61	75	116	57	36	108	58	71	202	98	207	43	94	64	59	49	104	39	116	55	87	52	64	67	146	65	39	30	83	41	9	65	55	68	34	48	92	115	84	93	57	30	118	76	63	54	41	116	82	151	55	86	48	65	75	100	96	82	76	42	87	84	109	56	91	69	113	137	28	54	79	73	61	89	77	86	69	72	22	24	51	41	66	150	80	113	36	43	70	90	33	68	52	58	104	74	69	38	54	50	77	43	79	84	22	56	96	147	49	82	96	45	44	83	61	56	47	86	70	54	60	37	9	27	80	81	46	116	114	32	80	112	66	51	59	123	85	53	23	86	63	68	70	109	45	45	45	91	36	40	56	96	79	116	53	42	76	61	74	73	49	41	4	79	30	36	39	48	90	63	80	47	87	46	38	70	34	94	51	43	74	101	54	96	25	54	52	37	42	42	33	95	10	87	48	72	49	73	32	56	71	49	83	40	206	80	98	19	55	69	81	88	33	52	38	46	65	53	54	96	83	26	25	86	81	28	67	38	51	150	58	31	38	31	36	41	77	44	71	43	18	44	38	58	54	32	60	40	68	72	151	44	57	33	81	42	109	45	146	41	81	25	71	50	74	30	47	31	71	68	64	23	84	43	93	63	141	59	50	26	94	61	94	38	100	47	57	24	23	39	37	63	33	28	60	50	33	53	74	22	39	30	47	40	62	82	10	20	46	42	28	50	87	56	48	48	80	32	23	33	39	65	47	47	15	12	74	16	35	97	65	38	22	61	82	34	50	34	47	61	54	27	38	23	33	62	48	33	34	13	33	26	23	17	57	12	19	19	8	28	58	41	23	36	8	35	14	41	64	36	56	34	27	37	26	27	67	32	74	42	34	27	10	55	36	11	24	44	36	12	34	85	53	21	57	55	18	40	27	42	67	55	56	47	61	44	32	49	45	41	50	35	29	77	36	92	33	22	12	19	53	25	15	133	14	31	24	19	65	25	26	18	26	71	42	10	7	15	12	7	126	36	48	54	69	5	37	23	38	42	32	47	20	14	22	103	26	50	19	103	12	39	31	20	52	9	44	8	41	24	0	19	21	91	19	101	36	14	22	73	54	21	21	29	5	27	8	19	5	48	7	32	12	39	23	24	47	14	27	38	190	36	33	44	32	2	35	34	65	1	40	31	24	20	14	62	10	12	7	33	11	25	28	34	25	37	6	24	18	25	32	17	18	24	19	36	9	32	20	83	6	38	42	12	12	6	18	32	63	6	16	44	14	14	3	23	11	26	19	26	55	10	30	8	30	36	42	11	16	24	39	40	37	42	14	13	28	5	39	17	43	34	4	42	30	16	17	20	33	19	7	24	16	42	21	18	25	16	29	9	11	38	59	32	23	5	11	29	29	11	3	22	26	12	5	19	29	22	33	9	13	14	7	50	31	36	36	9	18	19	5	23	10	10	23	33	19	20	9	11	39	7	16	37	17	29	34	15	10	7	8	23	18	5	3	3	6	9	19	10	17	24	16	8	8	20	40	17	14	17	2	7	7	27	20	19	31	13	17	32	4	6	18	23	9	19	10	2	8	3	20	12	4	9	35	6	10	11	7	7	6	17	5	84	20	7	11	2	4	11	9	0	9	33	17	2	3	10	11	18	8	11	7	7	0	6	5	4	5	11	4	3	1	8	6	9	9	6	15	2	12	10	12	16	11	9	8	4	11	1	2	4	0	3	14	6	0	7	14	1	6	1	4	2	2	5	0	0	10	0	7	1	2	4	2	1	1	3	2	2	1	0	5	38	6	0	1	0	0	1	1	1	0
ne0069	1719	835	562	1220	246	908	606	790	614	596	262	674	848	750	733	508	709	231	332	607	463	429	295	249	390	407	347	414	297	538	216	361	345	577	266	356	433	220	246	299	204	370	167	289	235	515	443	478	314	216	503	267	213	346	196	390	95	230	278	243	416	144	171	177	272	309	414	205	173	118	145	145	236	263	183	160	238	339	270	84	320	188	397	175	145	377	125	185	170	282	157	222	430	209	100	161	396	166	113	188	405	108	205	415	174	278	241	400	265	164	166	178	429	396	380	212	417	307	104	404	212	371	147	231	234	398	153	109	432	380	185	181	114	217	258	102	114	99	374	131	196	285	104	128	288	339	138	129	188	245	150	61	337	205	196	111	194	55	388	246	118	107	163	352	171	140	95	216	95	137	196	106	128	337	363	146	203	354	99	79	474	149	107	147	107	97	101	118	136	102	162	238	68	195	85	97	116	349	198	291	120	100	69	94	92	242	97	216	187	179	346	212	128	192	226	254	108	118	169	124	96	149	92	209	193	163	206	125	99	119	76	150	108	66	130	157	118	105	118	69	223	90	72	205	93	189	329	105	105	103	75	60	119	85	102	338	85	151	127	108	57	132	104	194	114	179	168	124	82	99	139	146	84	83	132	58	124	103	104	49	39	94	60	37	101	64	101	108	149	60	149	201	64	107	269	58	112	146	141	97	103	97	130	140	152	73	182	125	169	74	56	38	83	83	104	76	151	185	105	158	113	84	118	152	129	152	106	56	134	103	61	223	109	98	100	143	97	210	133	151	105	190	88	376	249	47	139	102	36	47	61	57	88	82	64	250	98	52	72	68	101	46	54	49	82	72	99	72	197	126	55	35	102	68	67	97	81	123	114	68	234	106	73	197	132	254	51	59	117	77	184	144	112	187	105	73	46	64	46	80	67	93	188	135	111	60	52	56	232	117	58	36	69	162	79	82	78	98	135	43	80	35	98	99	130	156	79	99	48	108	47	109	34	112	32	54	85	83	69	78	148	55	44	85	89	64	53	67	115	110	44	112	52	37	52	52	60	72	61	88	55	42	72	80	25	91	38	75	66	23	145	156	74	66	149	44	107	47	24	35	227	45	99	41	95	45	63	109	42	101	61	62	25	83	50	85	84	69	71	87	20	49	76	27	56	104	24	29	104	98	61	57	68	22	71	59	41	134	45	89	36	42	55	144	46	34	63	87	70	53	72	120	83	64	170	102	25	63	50	69	30	19	49	30	29	24	118	90	115	54	24	70	110	52	96	65	56	39	32	66	75	56	61	36	33	41	44	79	28	42	62	58	28	52	48	50	28	74	57	68	67	44	34	32	61	78	89	79	88	91	25	100	87	57	60	63	61	42	86	28	98	43	38	104	31	71	73	22	20	59	75	24	44	23	47	15	45	49	36	56	37	43	62	81	58	61	43	42	70	42	34	41	44	79	27	66	34	69	28	21	56	39	88	47	18	21	36	51	58	52	94	60	85	60	29	95	39	30	77	27	58	45	26	25	31	98	51	38	78	26	27	10	67	34	41	36	23	35	24	65	23	63	60	27	107	53	94	47	73	16	41	52	81	52	32	43	70	114	63	9	24	38	62	81	18	38	129	88	67	32	26	78	57	51	60	46	84	14	76	74	70	17	44	33	52	23	80	82	37	40	45	8	33	55	32	35	28	29	75	46	44	21	65	56	53	46	13	48	40	11	199	25	14	47	41	39	65	46	56	26	35	52	46	49	17	33	21	57	7	20	8	37	59	45	27	46	29	29	38	28	77	91	26	32	24	18	18	67	17	33	24	37	39	32	54	77	53	43	37	24	61	8	19	69	76	23	62	87	51	47	19	216	49	9	11	64	11	18	86	13	53	32	200	21	21	26	59	17	97	11	23	19	49	99	32	42	22	31	33	19	59	46	25	25	22	62	26	16	24	10	30	19	26	54	20	52	36	15	32	48	35	16	64	26	20	13	18	26	38	11	23	22	27	59	27	19	27	32	11	38	25	61	60	34	50	27	68	34	23	67	24	10	20	18	36	37	67	30	24	22	20	61	16	46	34	18	39	52	12	23	19	36	40	22	9	20	9	44	34	14	31	55	12	27	29	18	69	62	24	10	9	29	71	17	73	60	14	34	20	31	15	55	16	26	34	20	37	55	25	43	25	16	19	24	25	37	35	50	44	10	52	20	51	30	10	12	29	14	15	68	45	20	56	28	17	12	26	22	20	35	20	38	18	33	15	30	36	17	12	52	34	61	16	20	8	22	17	16	19	50	4	34	11	29	25	24	24	10	6	18	22	33	28	12	21	23	16	20	39	27	55	26	24	27	14	11	14	62	26	6	5	13	25	45	27	31	98	17	27	25	4	34	18	49	6	7	32	25	22	38	13	21	52	28	16	10	19	19	18	24	35	15	24	39	40	27	129	8	18	21	11	30	18	20	11	15	42	15	16	27	24	51	11	29	7	25	24	44	70	39	23	15	15	23	26	14	8	19	13	60	17	19	28	39	13	16	27	19	8	31	8	38	11	40	22	8	12	63	8	14	14	33	15	69	12	27	15	10	10	42	15	10	18	12	16	19	13	3	29	18	30	32	11	20	16	49	13	7	10	10	40	10	9	8	8	35	16	37	59	22	15	6	7	10	5	11	7	34	12	12	8	16	5	12	24	6	30	24	9	12	18	24	6	12	9	9	13	7	15	42	24	48	19	26	10	24	27	26	14	29	28	11	25	19	5	9	30	3	7	14	9	37	8	10	21	14	6	18	47	8	45	16	62	10	13	4	17	26	9	39	13	25	19	23	36	10	34	6	15	13	27	15	10	17	5	11	3	19	8	17	13	4	35	63	11	16	18	8	9	19	19	7	10	22	38	30	16	13	19	11	15	20	42	7	28	26	12	13	2	11	7	12	3	38	10	6	13	3	11	17	11	27	22	17	34	6	8	10	8	9	19	18	12	45	3	8	11	3	15	20	14	41	5	2	8	4	9	1	94	8	14	24	12	3	31	13	7	4	23	12	8	29	24	7	4	9	6	4	11	13	22	48	16	11	44	3	9	8	8	5	3	31	15	12	13	11	4	7	48	12	8	7	21	15	19	10	5	23	8	19	27	9	30	6	40	7	14	11	9	12	11	36	5	32	8	5	9	4	21	34	38	58	7	8	3	2	14	11	13	8	47	9	18	11	18	12	4	12	19	4	6	19	18	6	10	25	18	3	8	4	9	4	7	2	10	15	31	8	15	26	6	9	3	8	11	11	15	30	10	4	9	4	18	7	20	4	26	5	11	2	7	9	4	4	5	10	19	30	2	7	7	4	3	30	14	17	0	7	1	2	12	15	6	3	8	7	4	10	7	3	9	27	3	6	2	6	3	11	9	61	30	1	12	6	34	41	3	4	4	6	16	4	13	10	2	11	12	3	9	13	7	4	16	7	13	16	5	6	5	17	1	16	8	15	4	18	4	9	6	2	36	23	4	1	2	4	2	9	2	17	20	4	5	6	19	2	7	13	8	8	2	0	3	6	1	32	8	2	2	4	7	20	8	12	3	4	7	12	7	3	10	13	6	3	11	7	6	4	9	2	3	1	1	8	4	3	27	11	1	17	0	2	0	16	2	3	6	7	1	9	1	33	0	4	14	16	2	5	5	7	8	14	8	1	8	3	7	11	0	1	5	3	3	38	5	5	2	5	1	2	2	1	3	11	3	5	8	3	8	0	3	11	2	1	2	9	0	2	5	9	1	0	2	0	1	11	0	14	1	5	4	2	6	4	2	3	2	0	12	3	0	3	3	2	2	26	1	26	9	2	0	4	4	1	3	1	0	3	2	16	4	9	3	0	1	1	0	4	0	3	0	11	4	1	6	5	9	2	2	12	2	0	1	6	2	2	3	13	1	5	0	5	4	1	1	4	4	4	1	8	2	3	4	1	2	1	0	0	0	1	15	1	3	1	0	2	5	1	0	1	1	1	1	3	11	2	2	0	0	1	1	3	0	0	2	2	1	3	0	4	1	1	1	1	0	0	0	0	2	0	0	1	1	6	0	1	1	1	0	0	0	0	1	2	0	0	0	3	2	1	1	2	18	0	0	0	2	1	0	0	0	0	0	1	0	0	0	0	1	0	0	0	0	0	1	0	0	0
ne0070	1745	1158	766	899	397	910	649	642	725	558	450	685	791	665	691	617	820	457	482	646	611	483	417	332	447	436	477	685	384	548	307	314	455	486	371	356	449	277	446	426	408	344	294	306	243	493	466	429	603	303	401	376	255	366	181	561	195	336	307	273	405	283	197	344	328	287	448	248	320	331	260	294	262	372	230	319	363	398	259	260	285	228	345	216	297	365	251	280	245	221	168	377	371	377	210	273	317	234	157	148	334	140	253	366	214	297	198	401	268	122	202	192	371	349	325	431	346	372	159	329	294	316	209	210	212	372	216	123	339	341	254	296	240	157	252	185	150	186	310	186	313	386	153	197	253	319	230	185	184	275	195	150	333	345	229	148	362	170	310	268	240	179	180	231	256	197	187	323	194	98	160	163	225	333	289	213	231	289	187	156	352	227	182	284	104	259	121	217	193	167	240	202	86	220	161	130	139	322	265	215	179	155	116	203	113	206	146	227	241	141	289	177	127	229	324	197	221	183	293	196	186	152	164	181	221	119	236	110	152	149	151	145	85	98	168	161	159	170	204	150	98	163	214	224	188	263	205	171	171	184	186	154	164	110	170	271	118	171	144	80	87	205	140	158	124	231	170	154	173	137	141	205	143	157	161	134	129	133	117	109	81	139	138	74	171	141	231	123	157	142	207	158	155	133	212	133	132	237	196	138	148	158	206	145	198	159	297	113	209	101	128	77	164	124	132	158	113	236	88	149	130	140	152	134	114	73	160	138	124	121	159	214	180	111	93	107	134	385	144	154	112	103	104	319	244	108	117	231	85	71	106	141	144	101	116	199	59	88	87	72	101	115	58	65	122	74	130	115	168	101	112	84	153	108	179	121	159	192	124	115	228	85	117	192	110	194	86	126	90	170	263	137	109	221	74	109	96	109	102	89	128	215	167	93	143	107	91	118	181	140	130	108	86	130	84	164	139	95	88	109	138	68	195	105	139	115	111	107	111	69	28	94	91	87	95	87	91	62	160	113	117	121	121	108	99	101	115	151	196	65	98	87	101	113	98	93	116	111	89	174	125	80	59	129	51	89	50	145	58	65	152	110	97	83	117	92	104	70	112	56	173	82	85	137	84	86	70	102	24	160	79	107	94	97	109	105	80	103	131	131	58	103	90	35	29	78	68	122	92	83	87	186	121	51	87	64	74	155	73	100	88	39	105	125	70	79	67	93	66	76	79	116	75	69	87	137	68	121	83	57	76	49	90	90	56	58	168	133	128	127	53	111	78	86	71	52	75	71	96	78	69	81	108	79	99	72	64	55	47	124	55	130	62	86	81	85	18	67	41	69	96	83	66	46	53	105	57	68	169	111	80	90	79	113	51	45	61	78	123	81	114	62	55	127	73	57	81	52	61	48	98	91	109	61	74	43	66	94	31	123	85	114	78	114	42	96	67	87	67	78	70	47	76	102	63	100	45	68	55	96	106	100	71	59	70	64	31	68	110	76	69	105	118	106	72	77	53	19	119	37	91	67	70	86	55	55	77	55	65	63	60	46	59	35	40	35	97	72	51	135	78	54	48	53	98	34	95	84	77	31	64	73	72	52	39	62	130	76	99	67	60	117	56	35	51	51	46	65	86	130	43	46	30	50	71	42	69	28	133	102	81	50	59	72	76	71	50	63	62	54	120	69	48	88	75	46	38	56	71	33	59	33	63	61	68	72	35	41	48	33	131	58	63	31	55	62	92	63	83	127	36	35	52	43	63	63	25	86	26	66	10	61	79	68	60	44	47	50	56	96	45	37	38	31	52	51	42	62	69	43	52	61	38	55	90	47	83	120	41	51	67	54	17	60	53	50	49	71	67	94	17	148	63	14	37	45	23	41	60	24	35	69	123	51	75	29	75	56	52	33	57	46	34	172	62	50	36	44	19	18	23	42	24	30	33	109	19	33	27	39	51	56	44	30	47	43	27	38	70	68	117	41	34	28	58	17	29	37	21	62	62	31	44	41	43	38	40	33	37	59	55	80	105	26	37	71	50	74	38	53	69	114	63	60	45	37	72	36	26	29	46	68	26	42	53	25	26	77	24	15	51	31	29	32	28	24	21	48	63	44	34	44	20	31	26	31	81	90	45	30	26	34	41	25	38	42	7	65	47	42	32	44	53	32	35	30	36	43	51	39	31	46	20	16	33	68	104	31	80	17	31	33	44	25	34	21	30	89	11	67	79	24	14	43	29	33	50	60	27	60	74	44	27	21	31	31	42	23	10	41	24	31	23	118	16	29	36	40	58	52	40	40	38	15	32	95	37	32	95	17	45	17	36	16	36	39	21	47	41	49	24	34	25	41	37	26	10	50	29	40	17	35	31	40	53	17	74	9	57	15	33	22	14	63	26	34	56	24	41	29	23	47	23	38	48	31	17	30	33	38	30	30	41	25	46	50	35	30	21	35	13	39	16	46	9	78	20	45	17	14	22	56	19	26	28	24	62	28	30	50	36	46	43	37	40	31	16	11	44	30	26	30	22	53	43	74	54	27	22	13	30	26	14	53	20	34	33	42	19	16	29	16	30	29	13	51	24	25	35	24	26	11	15	18	13	36	42	26	34	23	19	20	12	11	50	40	37	19	32	16	47	11	28	31	33	38	19	32	12	17	22	9	19	23	13	18	9	41	36	49	23	40	19	24	23	25	34	20	12	30	13	13	24	84	23	19	50	21	26	20	25	25	18	46	34	17	20	17	39	30	17	21	31	17	8	7	35	31	86	39	18	29	31	24	14	24	18	13	49	26	14	18	27	27	17	34	33	29	26	31	12	10	23	29	28	26	25	8	27	14	24	15	31	15	7	15	18	35	21	16	23	16	19	23	28	15	10	8	25	10	22	7	28	28	58	19	27	28	25	15	16	9	29	14	48	20	24	9	14	32	13	21	17	38	12	5	20	12	19	15	34	54	18	11	14	16	9	11	10	23	5	35	36	36	17	23	8	16	27	29	85	56	18	19	7	17	19	10	13	17	17	11	16	14	7	15	13	20	18	4	19	22	15	15	11	25	6	15	20	28	17	36	27	20	21	20	29	12	26	23	4	22	12	23	28	9	12	11	34	28	35	24	17	19	26	34	20	22	21	49	17	6	22	21	22	12	11	4	19	24	24	7	14	19	31	20	17	22	15	20	114	9	12	15	10	10	8	14	25	12	27	21	22	21	13	18	19	17	22	10	20	23	14	19	11	51	6	7	7	8	28	19	12	11	10	30	6	18	20	26	43	9	8	17	18	18	21	10	25	6	20	20	6	76	34	13	8	22	4	4	2	10	14	8	12	7	11	51	10	15	8	32	4	3	9	23	2	4	4	9	8	25	12	7	7	11	7	12	7	7	4	15	42	8	5	29	11	17	16	4	14	7	11	11	17	7	7	16	19	5	4	9	12	21	8	8	20	3	24	9	13	11	12	13	10	12	10	23	20	19	9	12	21	4	6	10	10	13	10	17	21	7	10	4	10	20	12	20	16	17	23	4	4	7	18	7	3	16	66	10	0	6	11	6	8	6	10	6	4	5	3	19	5	11	17	14	20	9	7	6	8	19	8	2	15	14	8	7	7	9	13	5	1	2	7	2	9	5	3	23	2	11	5	7	13	4	5	4	9	16	5	15	5	12	21	21	5	7	4	9	16	23	12	2	7	7	2	10	70	6	14	3	6	6	6	8	7	7	6	6	7	5	13	6	6	5	18	3	4	4	13	2	5	7	29	7	2	5	5	35	3	1	12	1	7	1	6	15	17	9	1	8	11	19	3	13	4	2	1	11	0	1	6	3	2	4	6	26	5	5	6	4	6	2	3	1	0	1	5	2	3	8	4	2	8	3	0	6	0	2	2	0	6	5	1	5	8	14	1	5	6	6	39	3	4	3	2	30	6	0	68	4	1	1	2	6	5	3	2	1	0	3	4	18	0	0	6	4	21	2	7	2	0	3	2	1	7	2	1	3	1	2	0	0	0	0	0	0	14	1	2	2	7	0	9	1	0	0	0	4	2	4	10	3	2	2	4	1	2	2	1	0	2	2	0	2	5	0	9	2	1	0	0	0	0	3	1	2	6	4	3	2	22	4	0	0	0	0	3	0	1	0	1	0	3	2	0	2	0	2	0	0	3	0	1	0	0	0
ne0071	1698	2644	1300	1025	1226	738	847	592	794	1151	768	677	626	483	867	789	659	682	951	563	577	526	677	369	702	600	551	589	562	603	630	641	484	365	673	437	494	612	553	640	542	439	396	412	349	336	303	484	583	373	255	420	368	370	327	439	425	437	495	318	282	371	539	465	356	516	266	359	495	490	494	613	395	331	490	490	354	497	461	387	361	437	169	416	532	196	436	401	489	425	324	471	202	364	378	486	195	363	346	366	361	307	260	284	287	298	293	193	310	305	323	453	189	212	172	427	146	359	403	192	287	162	349	391	378	275	304	198	134	168	289	331	292	317	386	542	351	287	158	254	292	247	192	210	447	312	270	340	337	301	239	249	357	354	241	255	326	309	117	162	303	359	287	283	346	294	283	328	299	129	269	303	276	369	120	367	262	134	293	267	148	318	265	302	213	324	238	342	307	294	287	173	202	218	291	159	207	163	220	253	204	226	204	283	258	244	274	194	254	367	108	189	293	201	405	197	250	283	307	270	274	147	262	282	271	169	217	301	337	234	290	264	244	271	244	306	283	280	203	179	225	216	224	168	226	240	195	157	271	256	151	182	261	194	252	85	182	264	261	266	152	175	245	151	280	240	142	179	273	297	139	214	205	238	178	151	206	202	238	282	257	222	198	247	224	284	352	242	343	283	198	162	255	232	144	223	100	210	189	194	252	229	190	193	262	183	205	164	162	245	221	214	243	162	232	167	254	209	106	191	174	168	194	180	151	109	178	222	224	136	142	148	210	78	161	229	215	267	179	167	235	218	265	146	159	209	261	284	226	208	190	181	174	168	189	177	173	207	192	207	153	226	82	190	179	186	235	186	150	222	118	173	172	135	134	226	148	245	172	133	102	151	159	154	165	193	136	213	113	160	136	143	162	179	119	107	212	248	201	148	209	228	117	151	163	146	172	250	167	192	142	130	156	106	205	145	156	140	135	147	221	268	186	161	88	113	173	160	240	167	64	192	153	182	156	75	115	217	246	149	90	268	218	191	221	127	170	148	151	111	166	84	185	109	168	169	158	141	146	153	107	105	165	184	124	160	138	115	205	127	82	71	122	113	108	139	140	114	161	152	117	154	125	137	148	163	109	106	84	142	153	202	226	123	157	84	108	189	144	145	161	117	173	50	89	109	144	206	164	134	109	93	108	149	117	133	104	118	125	111	110	108	191	193	172	102	113	117	116	121	173	119	138	146	165	141	134	139	150	120	128	161	135	81	178	120	242	160	117	141	109	130	137	110	108	126	139	123	107	80	173	148	167	101	136	92	125	119	150	145	44	121	73	139	130	60	67	73	72	86	116	114	93	112	107	66	128	67	178	103	150	71	113	185	104	133	126	127	82	117	140	105	105	102	103	85	133	139	117	101	68	141	155	166	132	100	72	59	122	108	145	112	121	184	61	138	104	94	100	153	80	86	127	125	163	136	157	140	100	112	117	128	98	125	69	72	131	109	160	84	117	112	84	114	65	152	75	27	68	70	125	117	93	70	107	68	106	103	82	52	146	134	74	28	125	132	75	99	80	68	88	120	113	88	76	105	87	106	103	113	113	123	90	106	132	76	111	108	134	120	97	82	116	83	81	51	39	95	68	148	167	82	86	64	91	75	82	163	123	135	69	128	138	115	99	116	87	101	57	89	100	164	113	79	134	121	89	73	94	142	161	61	86	87	69	69	88	79	75	78	70	71	111	80	76	113	56	152	79	78	32	51	54	80	71	158	65	83	137	96	75	81	76	70	113	57	88	62	84	63	37	68	117	64	73	74	83	63	91	81	82	70	86	64	100	58	109	66	111	93	65	51	69	93	47	75	72	77	65	91	81	39	55	73	76	67	81	71	62	98	89	91	31	46	46	88	74	119	77	92	35	75	60	97	101	114	77	60	78	88	61	108	11	71	64	85	45	60	61	82	71	58	78	71	89	89	96	75	89	66	52	84	50	61	62	60	96	112	77	85	104	59	52	43	63	124	51	111	73	78	67	78	62	77	74	45	76	94	70	47	71	89	113	80	68	53	53	64	105	45	148	118	61	46	121	82	31	70	70	59	60	41	54	66	61	53	89	54	86	69	137	61	58	60	57	79	78	45	43	61	64	58	59	103	45	47	62	83	90	73	86	71	91	52	103	58	59	77	77	28	58	70	80	55	97	61	49	71	76	80	34	60	66	34	72	58	48	54	51	39	52	52	47	57	65	60	36	56	48	59	46	45	62	68	87	54	46	83	55	104	43	63	101	56	46	48	88	44	32	44	47	64	106	89	47	44	32	65	98	45	43	57	47	40	49	75	63	65	46	70	41	60	54	55	60	45	28	48	60	24	106	90	48	43	97	66	47	67	57	44	53	54	52	60	66	109	107	21	53	42	18	73	69	62	39	34	71	57	47	74	44	72	38	31	41	47	95	38	73	23	37	64	66	47	37	32	49	58	38	57	50	123	57	53	94	61	41	35	43	57	103	143	38	49	53	55	67	57	35	87	67	51	69	50	52	47	69	66	32	49	62	33	90	31	21	83	74	34	59	38	63	51	35	41	56	62	49	57	34	46	48	43	69	39	49	71	69	51	70	61	56	89	35	28	53	39	43	47	57	74	42	45	51	65	49	57	39	16	59	27	42	36	70	71	71	54	48	20	73	63	83	35	55	63	57	26	40	45	99	56	32	45	40	75	64	59	47	28	55	46	23	44	93	34	56	47	48	27	85	35	21	48	45	24	49	37	59	65	37	49	31	18	66	85	14	23	61	32	35	42	41	27	26	22	37	19	54	48	34	61	52	71	75	18	26	46	45	19	77	33	35	67	50	63	31	51	27	36	40	68	27	31	26	38	88	40	39	26	36	38	51	51	59	31	38	49	48	57	28	25	63	33	28	39	38	46	14	47	28	53	44	29	42	45	33	46	54	35	61	29	44	70	31	38	47	51	37	48	38	22	53	32	28	50	34	65	54	41	27	31	100	28	44	41	35	28	58	38	27	49	37	42	40	66	84	44	31	38	30	50	27	31	50	43	29	11	12	35	59	37	27	83	28	15	24	46	31	27	21	63	28	49	27	40	49	25	27	17	33	31	28	39	52	38	23	29	14	44	38	39	22	19	12	33	33	48	25	26	26	25	42	53	25	66	15	51	31	42	18	20	68	23	42	22	36	30	33	31	44	59	41	32	25	22	30	16	73	32	55	20	33	30	22	12	33	30	33	35	31	34	40	23	18	55	21	26	42	36	32	36	21	29	37	6	23	29	26	12	67	19	24	22	22	25	60	33	42	56	11	18	15	32	17	20	28	20	25	30	28	24	35	32	16	15	22	36	19	13	20	43	23	20	38	25	14	48	35	52	41	27	23	36	21	46	8	17	35	37	20	15	26	8	28	19	42	17	24	7	40	29	22	36	16	21	23	30	26	10	39	26	13	41	28	20	65	38	11	34	34	4	17	36	47	9	9	37	8	17	11	31	21	11	24	21	57	25	8	36	14	22	17	18	14	31	9	32	26	31	31	3	16	30	16	30	33	19	19	40	7	13	14	2	10	30	24	18	38	36	28	22	13	16	34	13	7	12	14	23	16	0	13	26	47	35	39	22	26	24	8	20	10	27	31	8	19	30	31	20	24	26	33	16	11	17	27	49	22	27	27	20	10	22	20	5	7	26	20	13	13	10	20	19	17	12	17	5	17	19	18	6	19	12	19	10	17	17	12	9	6	8	6	4	3	3	14	12	9	13	10	24	27	11	21	19	7	10	14	15	9	45	21	25	5	15	9	9	25	5	7	23	4	8	16	16	13	7	27	6	5	10	25	4	6	16	15	2	4	10	16	12	13	19	4	13	14	7	2	11	10	15	6	8	13	9	10	16	18	12	13	4	9	17	19	8	18	9	8	4	25	2	5	5	20	7	2	10	9	15	13	11	5	17	4	5	6	2	24	4	4	4	4	6	2	8	9	11	3	3	5	6	6	5	4	7	5	4	5	8	2	3	15	4	11	8	7	4	4	2	7	8	6	10	5	2	17	6	2	8	0	4	3	0	5	4	0	2	2	0	0	2	8	1	5	3	8	13	0	2	5	3	1	5	1	4	4	5	0	1	3	2	1	1	0	0	0	0	0	81	2	0	1	5	0	0	0	0	0	0
ne0072	1583	849	565	1226	258	817	779	637	642	669	338	679	839	721	620	482	606	300	242	615	548	443	252	292	307	414	365	390	210	407	284	303	328	603	394	299	453	274	341	337	238	313	177	271	229	577	441	435	228	262	490	330	214	528	222	381	133	232	317	254	464	157	300	239	269	309	478	227	211	176	147	129	198	423	111	256	382	264	252	141	345	232	398	210	291	410	155	257	74	279	110	215	436	287	114	129	394	212	132	149	289	114	169	392	149	264	167	420	270	189	141	191	441	457	392	179	423	293	116	402	190	386	138	201	199	374	150	149	415	397	216	214	205	128	196	147	129	103	378	192	301	255	100	181	131	229	119	155	199	293	161	80	259	146	150	104	208	103	411	352	139	136	183	272	116	159	111	276	185	95	144	112	156	248	360	146	227	369	130	78	686	104	107	156	93	201	102	126	179	151	122	209	74	179	102	106	86	389	185	207	123	115	90	117	126	272	114	154	186	165	368	158	107	188	128	191	123	174	155	169	151	183	133	218	135	135	191	102	121	138	112	159	139	61	128	136	68	150	163	96	94	124	48	167	112	187	217	128	134	96	67	101	82	105	83	353	51	199	115	141	100	202	101	194	88	203	111	197	94	136	126	137	140	96	112	68	117	166	121	51	87	126	60	72	213	128	125	77	85	62	179	221	120	114	178	74	131	236	117	61	120	151	141	107	162	103	200	119	154	83	118	48	124	78	73	93	171	237	89	126	123	113	93	221	103	103	93	54	123	58	81	216	124	109	111	136	99	333	97	109	103	150	80	321	221	67	146	88	64	81	83	83	154	52	81	176	143	71	66	46	110	78	58	78	174	41	92	74	142	133	45	44	97	152	79	149	110	134	93	69	333	108	71	222	144	201	61	90	101	90	231	125	127	214	118	70	66	98	65	98	96	246	190	104	84	61	57	35	155	111	79	63	51	195	36	100	94	97	110	75	90	73	174	63	134	218	87	127	92	68	44	136	82	94	62	53	126	52	66	56	91	124	69	80	111	96	61	95	103	88	61	110	34	40	91	49	53	63	74	93	67	21	56	58	29	80	51	150	75	42	131	125	134	67	97	68	89	38	42	42	189	83	75	74	104	87	77	151	40	79	158	73	52	110	92	68	60	73	80	82	28	61	64	27	39	65	21	41	93	80	50	83	67	29	70	66	61	127	74	56	49	59	92	26	74	60	44	70	72	41	54	106	71	84	55	103	29	57	50	58	38	35	80	34	31	22	58	159	130	70	16	81	70	40	97	44	49	47	30	52	44	43	55	46	60	53	42	74	27	71	62	86	40	54	37	89	16	56	33	47	96	36	34	43	96	115	52	82	97	85	55	70	111	87	39	43	67	73	107	69	71	43	34	179	36	69	66	49	36	58	147	45	68	30	48	15	63	43	28	104	54	65	32	90	68	67	75	33	44	28	53	58	48	81	42	91	28	23	42	47	49	12	114	24	42	49	43	35	103	63	68	41	68	55	32	44	70	35	62	38	48	75	38	32	44	65	67	22	120	61	55	16	50	45	80	31	67	45	22	51	39	50	48	51	142	33	68	142	82	30	46	51	53	48	32	39	66	87	51	161	35	48	56	76	28	48	58	76	59	62	41	62	53	61	55	34	61	35	66	81	42	50	34	69	56	45	39	56	28	46	66	24	22	51	57	44	30	51	61	40	44	29	38	41	37	48	8	30	36	8	181	29	19	34	13	47	83	34	63	49	39	37	69	32	29	158	18	71	10	25	23	91	85	45	36	61	42	33	51	43	39	59	29	52	43	24	10	60	33	32	51	27	22	60	140	52	60	36	22	46	35	38	12	34	57	31	51	102	46	34	36	188	47	11	25	19	34	33	114	25	12	45	171	25	26	33	51	33	27	8	51	39	38	59	54	33	44	35	29	37	49	32	34	27	33	137	101	6	31	45	38	24	20	33	23	38	43	15	66	136	65	29	50	18	35	26	23	16	23	41	25	33	43	43	13	32	19	26	19	41	15	63	50	26	27	36	35	77	25	47	33	30	142	32	36	33	55	21	45	21	22	24	34	38	41	22	11	59	9	19	17	30	20	27	16	18	11	83	26	23	21	22	14	44	31	24	26	47	35	41	14	21	54	12	24	29	24	34	17	27	40	48	23	35	49	17	20	28	25	40	29	24	14	11	15	54	13	63	51	8	39	38	19	22	28	22	17	33	17	132	53	43	16	20	10	21	17	23	31	60	37	11	21	41	24	18	37	24	37	15	3	16	38	32	19	27	22	23	21	40	17	23	36	22	18	37	20	21	19	42	21	30	22	36	45	15	17	18	33	24	45	25	21	17	19	17	7	97	14	18	9	32	26	33	16	34	38	17	11	28	14	40	15	22	17	26	33	155	30	24	20	29	24	72	13	12	21	25	26	22	20	20	19	97	26	19	19	18	19	19	9	25	35	43	17	28	17	140	15	27	28	21	12	25	7	8	42	28	43	22	31	15	28	25	15	19	11	15	18	17	25	19	55	19	41	33	29	20	18	23	16	32	16	9	22	19	14	88	16	2	32	24	15	58	8	41	15	14	20	23	19	15	17	21	8	14	15	4	18	13	17	13	8	8	24	9	18	6	24	11	26	3	12	13	21	28	29	33	11	26	24	12	12	11	10	17	6	66	3	24	12	19	5	19	42	15	51	22	13	8	11	32	9	21	25	13	13	10	6	26	19	17	19	23	29	21	19	19	24	15	11	20	9	18	5	11	20	18	23	16	24	19	133	20	23	19	6	19	47	7	19	30	43	23	6	12	15	14	23	26	18	15	30	18	21	38	78	12	15	23	29	22	22	14	10	8	21	24	11	18	9	6	18	25	7	25	12	13	16	37	15	8	24	9	115	18	33	11	27	21	9	19	13	19	26	12	22	10	14	11	9	32	12	26	7	20	15	21	6	19	17	17	15	10	24	4	18	17	14	11	30	47	23	15	13	4	10	14	9	13	40	119	9	0	10	13	11	6	10	23	10	10	6	13	11	10	15	8	17	6	14	16	12	6	11	15	1	16	16	128	18	17	18	3	9	11	22	11	9	0	16	13	9	15	12	8	8	7	19	26	25	18	17	13	30	9	15	14	16	72	9	15	28	8	26	9	17	13	21	21	16	7	21	2	14	13	22	4	13	9	18	5	7	6	9	5	26	7	7	12	13	9	9	18	7	8	10	8	12	4	10	25	10	6	9	18	16	6	4	7	20	6	5	4	9	4	3	7	17	3	32	10	3	12	15	20	20	16	15	3	4	1	9	12	10	11	7	12	8	4	81	11	9	8	11	7	22	27	8	8	6	9	2	12	14	29	3	6	7	5	9	12	4	2	11	23	6	15	9	7	3	13	6	2	13	10	2	4	21	5	15	4	8	9	20	7	1	6	16	5	19	7	5	13	4	6	2	0	22	9	26	19	7	5	18	9	11	17	17	14	1	9	12	6	22	8	13	11	17	0	10	23	8	2	7	4	4	1	10	7	15	11	3	7	26	3	3	21	3	8	6	2	1	9	3	10	18	1	4	10	1	24	8	10	2	6	19	7	8	13	0	8	2	0	19	11	7	8	2	8	16	6	0	4	10	3	7	13	4	16	8	0	4	4	1	2	4	5	0	9	2	22	1	7	17	10	5	5	6	13	7	15	9	3	12	2	0	10	24	3	1	2	0	25	5	15	4	8	1	2	0	2	8	8	3	6	14	1	0	0	6	8	13	0	6	4	2	1	17	8	25	0	1	3	3	5	1	6	15	24	3	0	0	8	15	6	8	0	1	3	0	0	6	5	12	5	6	6	5	3	0	30	3	3	2	2	1	12	3	4	6	17	1	4	4	7	0	8	2	1	0	24	9	4	0	4	4	1	3	4	4	1	2	3	1	2	6	3	1	4	0	5	2	0	4	2	5	1	0	3	0	0	1	6	0	0	10	6	1	1	6	3	3	1	6	1	8	3	2	3	4	2	4	2	1	1	2	2	3	2	0	1	1	1	6	0	1	8	2	5	4	0	0	1	1	0	6	1	0	1	1	1	1	2	1	6	0	2	2	0	1	1	0	1	0	1	1	0	3	2	3	1	25	1	0	1	0	0	0	0	0	1	0	0	0	2	0	0	0	0	0	0	0	1	0	0	0	0
ne0073	3123	1536	1081	1203	588	1441	1686	1182	1194	1104	649	1087	1346	1325	1071	944	1186	614	588	1066	923	727	546	715	711	738	582	851	416	711	474	506	727	961	407	570	856	415	615	739	515	598	350	501	460	961	845	773	567	486	814	539	362	460	400	694	312	425	439	448	755	359	256	424	446	489	743	458	441	338	294	315	398	615	223	489	564	532	447	198	598	337	717	307	372	749	322	456	307	402	273	363	716	468	232	317	632	335	303	379	531	265	279	728	353	531	307	688	471	326	305	347	747	732	649	381	670	465	237	694	378	669	225	310	332	475	368	347	676	657	411	432	355	258	375	244	233	316	634	273	362	499	235	263	247	477	382	247	298	377	346	234	542	379	369	223	418	210	657	331	326	215	344	427	272	302	322	430	212	322	268	312	318	484	619	244	313	613	225	233	352	220	251	308	228	242	252	286	321	202	241	451	115	339	234	230	292	601	346	373	205	233	149	231	183	432	198	365	362	301	596	248	184	397	300	272	212	221	441	243	206	308	201	343	246	238	283	241	164	233	168	292	194	147	234	248	156	254	279	235	200	190	182	227	227	364	398	250	238	167	259	148	264	189	243	579	185	349	227	178	174	223	173	368	202	430	286	238	164	185	310	339	256	241	228	195	173	306	171	129	140	269	127	89	214	145	206	147	109	160	275	362	174	236	317	137	312	238	234	281	182	101	203	244	230	208	348	196	330	179	175	102	187	127	131	187	223	380	224	248	231	198	226	198	181	227	280	138	181	163	153	371	253	238	229	187	203	277	278	230	161	216	188	234	329	128	199	281	130	94	217	147	206	143	200	312	173	132	112	105	216	131	409	103	130	135	214	174	292	177	94	123	229	218	184	153	189	254	225	259	157	229	227	306	180	197	135	174	197	128	186	222	179	319	172	185	130	150	76	191	149	251	256	218	177	115	91	150	316	212	175	95	136	277	144	204	168	152	199	151	150	132	200	204	223	393	135	166	107	105	132	173	72	125	102	149	130	96	122	209	149	145	116	147	190	211	102	176	166	193	94	171	142	165	125	132	105	86	131	224	144	63	98	118	63	160	110	105	158	95	83	242	196	111	193	132	145	63	55	52	146	162	198	63	172	80	124	215	113	116	138	159	92	150	111	249	146	97	161	186	79	128	159	373	131	153	71	95	199	133	104	142	144	51	173	107	163	186	136	150	149	70	140	120	121	149	76	160	120	104	157	190	146	133	87	150	130	127	93	109	101	68	116	127	46	52	82	83	164	146	57	88	145	119	131	92	110	134	76	168	117	107	119	103	117	97	141	97	75	100	141	162	44	156	166	142	79	152	88	145	125	139	103	94	123	156	131	112	183	145	50	136	156	136	104	61	91	109	168	100	109	85	70	59	150	104	63	91	76	71	151	101	108	63	72	56	84	155	69	136	69	87	92	137	323	127	100	77	72	97	64	105	74	113	56	131	82	90	66	56	97	95	127	83	87	65	82	74	153	142	147	120	137	145	138	91	75	115	74	64	142	101	81	98	103	73	103	101	139	47	78	46	118	130	93	88	44	82	67	242	77	119	92	51	109	74	107	102	230	69	119	133	82	67	40	59	123	134	104	63	75	125	125	123	89	94	86	57	123	99	53	84	91	118	76	79	94	60	58	104	90	86	77	97	95	70	65	108	122	61	106	41	43	103	94	35	21	84	127	62	64	65	83	113	92	123	21	75	79	41	105	122	54	63	70	117	68	72	51	60	44	55	61	61	65	33	79	69	33	69	29	58	151	85	75	79	68	61	75	64	82	103	54	61	79	60	38	89	70	49	77	86	58	121	121	64	73	93	75	58	74	72	34	51	89	51	102	118	89	67	34	121	96	40	47	99	50	72	126	28	93	82	94	59	72	64	113	45	50	32	77	59	47	96	80	48	55	64	52	31	61	73	114	55	59	77	113	35	60	41	82	66	67	71	23	60	59	47	89	118	132	65	61	44	39	33	39	51	34	37	64	43	44	94	53	74	66	62	40	57	52	121	70	70	94	41	102	99	32	72	60	31	50	68	54	54	117	29	46	64	53	66	59	61	42	95	52	74	23	46	40	63	56	70	29	29	22	66	83	39	54	75	24	86	33	58	59	75	79	39	32	37	58	25	57	38	43	61	42	50	29	106	54	59	83	44	72	63	40	93	60	61	26	42	51	76	35	42	58	32	44	68	29	44	26	26	52	38	41	106	27	59	47	41	19	42	70	31	38	61	66	37	44	46	33	62	53	37	28	47	42	71	47	44	36	28	37	50	35	92	31	47	72	29	50	46	35	25	35	37	48	61	54	18	70	39	30	27	54	83	51	51	89	43	29	22	56	111	37	52	19	34	25	80	35	46	54	16	94	39	52	61	43	38	22	25	75	30	65	44	39	45	39	56	63	26	44	58	48	41	38	38	50	130	43	87	32	25	30	56	28	62	33	46	18	24	45	35	34	46	61	90	12	40	14	32	49	50	62	68	47	41	42	68	62	38	19	35	59	29	21	65	39	88	51	16	44	54	39	41	13	57	25	25	63	36	39	134	24	30	31	43	24	62	13	58	50	28	33	36	33	23	49	26	18	34	27	15	47	27	46	15	27	16	47	25	24	32	48	14	40	25	29	24	48	39	33	74	28	43	47	32	16	24	17	40	15	79	22	34	15	34	13	39	58	14	51	15	29	53	46	28	27	30	39	85	23	33	20	52	76	41	24	62	25	33	40	57	27	34	36	27	18	36	15	20	23	14	18	73	35	44	22	26	14	20	25	10	48	24	51	31	53	40	30	39	21	39	26	29	41	43	22	40	19	43	104	26	41	12	59	18	37	29	13	31	18	34	17	11	30	10	42	40	27	46	19	17	19	22	28	13	36	32	87	26	28	34	43	18	30	22	73	17	39	22	40	22	9	24	12	34	22	31	30	35	54	17	13	28	45	31	23	21	55	15	18	24	13	30	28	52	26	53	13	15	38	19	24	36	69	79	14	6	18	78	17	7	30	56	15	36	31	18	9	24	11	21	66	27	12	32	67	16	21	29	30	3	20	18	24	23	28	10	45	18	26	7	16	13	31	44	47	40	27	45	4	17	57	37	31	36	28	13	33	27	21	24	27	37	28	21	45	8	29	13	32	33	23	30	35	14	17	12	31	18	15	25	37	33	32	28	17	28	24	8	5	22	30	32	23	16	34	31	19	51	11	16	20	16	20	42	13	25	33	25	15	14	9	22	22	13	42	8	32	12	8	18	43	14	36	21	2	12	24	23	31	11	16	5	8	24	19	16	16	23	63	22	18	7	88	11	24	24	44	19	40	20	10	14	9	12	7	23	13	18	6	13	14	11	11	24	18	12	17	12	11	16	9	6	11	24	15	14	18	19	10	15	24	14	42	13	18	11	10	24	5	23	16	4	10	16	12	13	8	13	8	3	40	15	25	16	51	25	13	12	6	10	15	16	9	38	13	4	5	11	19	9	8	5	45	38	21	4	9	5	11	7	14	11	45	12	11	10	24	11	5	24	52	16	2	6	11	19	11	9	11	8	7	8	14	24	11	26	12	9	12	7	29	14	6	29	4	1	79	16	10	15	22	10	9	6	7	9	11	45	11	17	2	22	8	6	10	22	6	7	8	7	6	2	8	14	2	12	22	24	13	16	11	4	13	20	22	4	9	2	0	22	4	8	7	6	1	17	13	8	12	7	8	3	3	9	2	6	4	13	10	4	14	4	9	4	14	4	7	5	9	3	8	14	2	5	4	4	5	15	4	31	11	27	5	4	6	5	8	7	7	26	15	1	4	1	15	3	3	6	13	4	3	3	8	6	4	4	3	6	0	5	2	9	19	16	3	4	3	3	3	9	6	0	3	5	17	4	2	10	3	6	9	14	7	1	6	3	2	8	3	32	13	4	9	8	0	0	5	2	4	9	0	5	0	267	6	7	0	7	8	3	3	2	3	5	8	4	7	4	27	4	2	5	264	2	3	9	1	3	2	0	2	13	15	5	4	1	4	0	0	5	2	4	3	5	1	0	0	0	3	0	0	0	1	8	3	5	0	5	2	4	6	0	9	1	0	1	3	0	0	3	4	2	0	1	32	3	0	0	2	0	0	0	4	2	1	5	0	1	0	0	0	3	0	0	0	0	0	0	0	0
ne0074	596	315	342	417	120	378	223	311	216	228	109	281	316	344	214	244	262	129	152	239	161	201	145	104	182	174	97	204	111	158	89	95	120	214	105	122	196	76	179	82	112	141	73	102	170	202	197	208	123	88	180	104	103	203	80	147	50	80	141	115	173	68	46	66	101	105	173	88	102	56	89	60	95	83	57	67	74	105	105	66	116	53	150	100	55	157	80	90	53	84	48	84	204	63	28	85	154	85	65	68	111	44	72	172	68	81	101	162	97	70	54	70	154	161	153	95	139	89	63	164	78	166	67	51	85	111	78	137	142	155	89	72	86	48	119	43	46	62	151	103	79	107	50	95	50	91	56	78	61	142	62	46	75	75	85	43	44	34	160	88	52	48	65	95	55	48	64	72	66	39	54	49	58	58	137	95	73	141	34	27	153	41	37	82	54	102	55	48	85	29	54	117	79	64	33	52	48	136	43	73	47	37	129	47	77	97	58	122	69	58	138	37	48	56	86	96	65	54	84	45	24	73	34	52	39	54	71	65	54	48	47	51	48	37	45	103	33	52	34	48	33	61	58	183	20	69	76	57	47	16	35	78	49	45	41	132	39	105	76	42	35	69	50	108	27	110	111	77	49	61	57	79	40	58	31	31	42	29	54	26	20	70	24	63	51	131	32	33	70	36	56	68	25	53	265	58	58	52	39	61	69	47	44	36	38	38	114	57	96	23	29	29	27	29	49	16	41	129	30	81	36	37	48	128	59	66	58	29	48	20	28	88	31	31	61	33	30	81	36	68	21	35	26	79	81	24	37	49	26	20	31	42	31	24	44	63	33	22	26	14	32	43	29	33	76	5	50	26	140	34	41	14	52	30	42	61	27	32	51	45	132	42	48	77	41	51	24	25	41	28	84	148	41	134	25	43	24	40	92	28	20	36	71	92	41	18	18	29	46	35	35	33	26	60	46	30	38	28	42	32	42	75	49	23	46	27	40	32	25	25	26	37	16	22	17	20	9	23	34	36	20	23	16	49	41	40	21	31	68	40	28	23	34	37	22	22	35	18	22	34	64	27	14	25	26	62	25	22	31	23	93	97	32	72	101	34	23	9	16	29	40	16	45	28	26	17	38	44	16	35	51	43	23	16	21	32	17	30	20	25	4	22	37	27	19	16	19	14	42	23	26	11	24	6	25	26	26	64	13	20	25	18	23	28	21	71	11	30	16	38	25	56	25	30	66	30	18	23	31	7	12	7	18	23	17	81	53	54	68	29	12	13	26	18	31	18	31	30	26	28	12	19	19	14	19	25	24	27	9	21	19	17	17	28	35	40	17	20	14	8	23	21	18	14	25	57	33	31	10	38	17	17	31	38	12	39	30	44	28	15	31	19	10	32	23	36	64	15	7	97	47	18	18	33	18	9	25	20	14	28	38	16	20	5	67	23	33	6	16	30	15	24	11	58	6	23	6	11	7	18	14	16	44	19	26	19	41	20	29	36	28	24	29	31	19	30	19	17	29	21	33	15	13	12	8	17	24	12	32	16	10	9	7	14	15	15	11	19	9	49	7	22	10	14	43	20	40	46	8	8	34	25	20	8	51	4	37	45	13	7	13	14	20	48	10	25	25	65	22	10	11	27	15	21	26	10	19	11	27	55	30	11	22	18	27	9	29	53	23	8	28	6	12	12	10	4	7	17	29	5	25	9	18	24	18	29	6	14	16	10	30	18	13	22	10	18	45	17	42	6	30	16	23	9	10	22	12	16	2	7	4	26	18	13	13	21	15	9	9	20	14	37	5	15	9	12	6	15	12	8	24	27	19	24	37	20	27	7	22	19	19	12	7	9	7	14	16	31	14	13	18	37	19	4	10	4	7	5	76	14	5	17	28	7	6	21	14	4	6	7	4	11	4	54	12	14	12	17	8	4	14	5	15	12	11	31	9	6	5	5	29	8	23	5	7	10	9	4	13	39	41	7	19	5	10	7	14	19	8	17	17	14	82	10	8	11	11	18	6	7	13	14	28	19	21	11	23	14	17	37	11	13	10	3	11	7	25	11	13	5	4	11	14	14	13	11	4	22	6	7	10	11	7	7	11	13	7	19	7	4	10	14	8	14	16	6	15	30	11	4	14	10	25	6	9	19	5	14	20	10	10	15	11	20	13	6	11	13	11	18	6	5	3	8	24	8	13	61	20	13	20	11	8	9	3	2	10	10	5	35	15	7	3	13	5	2	15	1	4	61	6	7	7	13	5	6	9	2	3	12	4	17	20	9	3	9	9	8	7	24	6	1	17	3	8	8	8	23	12	24	22	5	12	10	8	8	2	5	15	13	15	4	22	12	2	9	6	27	9	5	1	5	8	19	13	8	16	11	12	13	6	15	12	17	13	4	13	21	7	4	17	12	2	14	9	1	7	9	2	5	9	1	8	15	57	10	7	6	7	8	9	7	54	13	4	7	7	6	11	6	3	32	3	9	5	6	14	12	7	8	10	9	3	4	11	3	5	1	7	5	7	15	2	5	10	6	13	5	8	10	3	7	1	11	9	6	9	10	2	2	3	11	15	7	11	14	5	13	1	6	7	3	5	11	5	6	12	3	3	6	4	1	13	0	9	26	1	1	5	9	6	1	2	5	4	6	6	7	5	19	7	4	6	1	6	9	12	9	1	7	5	3	6	11	13	2	9	4	0	9	6	3	3	14	5	15	8	8	9	3	2	12	7	8	16	4	14	4	3	3	15	6	2	4	2	6	7	2	26	7	11	11	0	4	4	9	8	12	7	4	14	4	8	3	6	7	11	4	3	15	10	18	4	7	16	6	20	6	7	26	8	11	4	6	5	3	11	10	1	10	0	3	14	3	21	16	3	0	2	6	7	4	4	3	30	3	10	2	5	3	5	7	18	5	25	8	4	1	4	0	3	3	5	3	2	7	18	2	2	6	10	12	18	23	3	2	5	22	1	6	1	10	5	5	6	13	5	1	10	10	0	31	4	0	2	1	8	7	3	5	4	5	3	0	2	5	3	1	6	2	2	11	9	0	2	3	0	0	4	3	37	5	2	3	2	1	5	0	7	0	1	8	3	5	3	1	10	5	7	12	3	0	7	10	18	10	3	11	7	4	2	3	4	2	5	1	5	1	1	7	10	1	3	1	4	3	0	4	2	4	8	1	2	0	3	7	10	2	0	4	1	1	15	3	1	5	1	2	2	0	3	8	3	5	2	9	2	3	0	12	4	4	2	3	0	12	5	7	7	9	4	4	1	3	0	1	4	11	14	7	0	3	5	0	4	5	21	4	34	0	1	4	2	2	3	5	18	18	0	2	7	0	2	5	1	8	0	2	2	4	9	6	5	3	1	47	1	1	2	1	0	11	6	0	1	1	0	6	4	2	3	2	12	3	1	2	7	0	2	1	1	2	2	2	2	2	2	2	3	3	48	2	1	4	8	5	1	1	4	0	0	6	1	1	2	2	2	1	10	0	3	2	1	0	3	3	1	2	3	9	3	1	1	4	3	0	1	3	6	1	0	0	2	3	4	3	3	2	3	4	5	3	8	4	2	2	1	0	5	1	1	5	0	0	13	6	1	0	2	2	0	0	2	1	1	1	5	0	0	3	1	0	3	6	0	6	0	3	0	0	0	2	0	1	1	7	2	3	3	3	1	1	3	0	2	0	0	5	8	1	2	0	1	6	1	1	1	2	0	3	1	3	4	1	0	1	10	0	0	1	5	10	1	2	0	3	2	0	0	4	1	3	1	0	3	1	0	0	2	4	1	1	1	0	2	1	0	0	2	0	2	1	0	1	3	1	2	0	0	3	0	7	4	3	1	1	1	0	0	1	0	0	0	1	0	0	2	2	0	0	0	6	2	2	0	0	0	4	3	0	3	0	2	1	1	0	0	9	1	0	0	0	2	3	1	3	5	0	0	2	0	6	0	1	0	0	0	0	3	2	0	1	2	0	1	44	1	0	4	0	2	0	0	0	1	0	0	0	0	0	0	0	0	0	0	0	0	0	43	8	0	0	1	0	0	0	0	0	2	0	1	0	0	5	1	0	0	0	0	0	2	0	0	0	0	0	0	0	1	0	0	6	1	1	0	0	0	0	0	0	0	0	0	0	0	0	0	0	0	0	0	0	0	0	0	0	0	0
ne0075	2025	2645	1556	1379	2005	1449	1211	1166	1084	1173	1433	1152	919	897	685	927	813	999	812	824	876	936	936	892	881	833	795	708	724	688	830	901	649	710	732	654	659	848	640	593	662	660	760	655	614	526	584	544	494	652	609	620	565	677	556	561	647	774	427	570	552	601	814	554	606	520	534	708	553	687	522	632	495	508	728	867	477	512	423	571	553	415	475	560	677	484	416	498	576	428	456	465	422	402	608	516	540	478	507	428	444	468	475	441	505	430	471	431	405	462	401	392	454	430	424	424	433	458	536	383	413	420	590	394	408	420	391	478	399	430	484	392	451	501	477	558	437	408	382	425	347	355	525	417	404	345	448	502	351	331	424	371	280	305	444	418	360	524	328	316	457	408	396	302	447	462	351	261	441	294	330	420	383	284	368	265	425	368	490	361	378	386	413	291	319	450	402	349	336	355	272	297	419	383	358	369	387	331	232	331	355	627	340	412	321	358	318	249	294	295	323	309	360	317	251	304	352	400	278	406	451	305	322	228	238	311	371	334	325	317	329	228	554	350	318	252	414	345	310	320	307	380	446	287	271	253	286	364	332	318	362	299	342	321	308	276	373	243	319	535	336	286	242	199	441	259	220	310	311	223	306	236	337	281	363	326	368	348	251	372	286	303	350	274	404	258	199	268	275	279	320	288	312	224	229	240	301	250	210	275	299	354	268	253	188	273	241	189	136	267	361	243	347	296	245	198	204	190	200	247	302	229	193	326	237	237	231	370	270	271	283	257	248	158	246	188	257	258	222	274	243	190	305	171	243	270	184	186	311	221	224	305	244	233	265	208	217	291	276	265	291	278	278	275	245	184	214	215	181	184	222	297	224	294	281	240	166	162	216	225	278	264	212	248	219	191	225	241	154	264	245	259	202	152	229	217	186	250	224	221	229	194	246	212	231	271	298	229	174	218	247	230	238	239	154	156	221	212	196	185	228	244	224	188	182	280	173	191	291	167	232	517	163	253	285	194	251	178	220	173	257	244	227	189	200	159	305	130	143	187	207	166	255	174	183	212	228	242	190	229	200	218	255	190	189	163	207	282	190	238	187	155	241	221	167	254	169	302	209	204	181	317	192	183	445	159	253	184	210	154	223	141	240	219	248	146	252	215	202	209	204	163	158	187	201	192	184	134	167	215	240	168	198	209	174	190	126	157	197	219	180	221	196	213	177	159	215	156	186	169	264	117	157	196	186	151	203	189	251	173	154	221	242	197	249	234	216	229	161	192	135	154	158	163	116	164	165	199	191	133	174	199	157	192	189	168	145	180	176	145	106	80	195	225	104	156	216	95	157	184	209	109	155	130	140	153	177	105	145	162	159	126	231	154	164	214	137	164	158	126	130	196	147	139	126	151	149	184	211	268	223	177	147	139	104	206	120	130	166	140	146	207	171	125	125	170	151	94	144	129	167	134	182	83	175	137	148	172	135	176	100	129	138	166	135	161	182	141	150	148	140	174	123	96	123	99	127	140	135	83	164	183	179	166	150	161	192	85	158	135	228	216	134	191	125	155	138	170	135	96	166	103	113	165	160	98	130	125	166	143	151	127	109	131	142	123	123	107	110	158	118	124	105	129	116	143	122	123	108	84	167	93	152	111	146	141	188	155	133	60	129	154	138	123	227	156	128	115	99	145	88	147	125	134	111	192	122	137	85	157	135	120	135	111	132	110	170	97	184	81	136	105	155	84	184	106	129	129	94	169	168	137	68	107	153	135	118	106	121	123	116	97	138	131	149	106	94	159	107	117	112	100	124	141	148	130	138	177	132	114	83	109	63	98	130	69	106	111	129	134	154	92	144	139	115	115	94	110	106	101	128	99	104	93	119	73	132	126	130	104	81	106	96	133	80	110	80	108	104	118	145	110	108	118	113	75	84	111	100	127	66	119	97	100	98	225	96	92	111	134	110	89	87	94	134	117	75	120	87	118	86	99	62	98	80	122	132	57	146	118	94	82	100	85	133	71	77	56	103	82	93	67	77	68	65	108	101	101	86	105	83	118	133	94	63	121	74	105	71	96	127	86	89	82	90	113	102	152	71	103	95	155	77	90	94	81	121	66	84	112	51	107	115	97	87	114	86	56	83	117	94	57	77	96	111	75	88	60	76	103	113	89	108	99	71	127	78	88	123	72	103	84	84	84	54	118	84	103	87	80	69	84	76	104	103	96	61	92	109	117	84	94	75	108	68	101	87	90	87	66	71	105	60	331	105	52	104	131	107	66	74	70	74	114	72	83	81	67	138	55	86	53	130	82	69	72	143	103	89	68	99	68	124	104	90	91	100	94	114	58	58	78	67	100	95	76	91	82	91	64	91	98	87	85	61	54	64	91	66	65	89	56	65	67	92	137	56	67	76	66	76	67	51	52	95	120	86	99	75	87	90	80	137	82	83	45	63	116	69	90	77	105	61	84	111	78	64	60	88	68	108	62	94	95	100	69	76	81	59	58	81	87	112	86	71	89	69	102	78	75	86	85	76	48	68	73	54	76	82	61	70	57	61	51	50	66	48	78	137	51	75	51	59	59	79	46	75	44	67	53	60	50	70	48	95	61	84	79	67	52	65	55	99	54	58	211	52	67	86	86	42	50	84	66	40	71	50	58	55	60	90	111	48	102	51	55	68	82	99	46	101	91	57	72	65	70	69	81	92	72	74	54	60	32	48	67	94	47	62	39	49	55	55	57	24	49	52	57	58	70	49	43	72	99	68	86	57	82	43	76	68	117	71	43	91	48	58	40	45	45	43	69	52	59	59	59	78	57	58	50	79	24	71	100	77	68	58	21	71	54	73	40	39	61	48	43	48	50	57	39	57	138	38	45	86	51	32	73	73	33	39	75	63	72	83	39	24	41	59	61	69	68	32	94	51	36	37	56	70	60	43	90	83	66	80	51	37	58	56	64	52	50	46	53	36	46	68	57	92	53	56	28	79	27	58	70	53	55	60	65	23	84	37	33	31	52	71	43	43	55	40	28	63	174	45	30	31	45	27	69	50	77	35	187	63	43	32	37	55	41	35	38	29	61	35	37	49	47	34	75	45	28	24	43	22	62	64	35	35	33	23	90	20	44	50	43	74	73	54	40	26	35	52	51	40	62	57	43	26	25	21	66	38	32	20	44	50	58	40	34	12	21	36	41	39	137	32	52	23	25	39	38	37	57	44	32	46	35	52	44	52	54	48	41	33	43	40	41	40	29	37	55	43	71	32	38	26	20	51	117	37	44	69	47	40	60	75	38	39	35	40	47	19	28	41	67	30	31	30	34	46	32	25	16	48	54	44	18	43	26	26	35	91	28	37	30	25	34	39	42	17	28	28	35	23	45	39	46	56	61	31	57	39	43	41	41	30	26	35	47	51	41	28	30	58	37	41	30	22	37	36	72	17	45	31	14	43	57	74	24	57	41	26	26	29	25	26	23	29	23	34	26	18	22	18	25	43	23	23	28	13	17	34	55	20	30	44	34	39	20	33	30	30	27	33	38	38	12	20	21	58	24	44	24	19	19	24	53	43	36	22	32	30	15	41	17	24	21	25	30	35	21	21	30	27	25	19	37	11	39	20	36	19	29	18	19	17	39	18	22	40	51	28	20	35	22	16	23	15	11	42	31	30	27	9	16	23	20	28	31	33	20	10	17	19	30	22	18	12	32	24	29	19	13	31	11	21	8	29	95	20	18	12	24	19	18	5	41	11	21	20	17	20	26	24	30	59	25	13	8	28	15	34	20	18	23	25	10	24	13	17	15	14	16	28	16	14	9	20	22	19	36	17	28	17	9	7	14	15	10	29	6	24	22	19	18	19	11	11	9	14	17	22	18	16	18	14	8	3	12	15	5	8	22	15	15	22	44	12	17	8	19	7	6	13	25	9	4	16	19	20	11	9	17	12	11	13	9	17	4	7	9	16	13	5	95	3	14	10	13	6	12	11	13	19	9	1	7	7	11	14	13	18	8	9	5	5	15	9	8	9	7	26	3	1	5	6	12	6	12	3	7	15	10	3	6	5	1	4	11	10	8	4	13	8	8	0	8	3	10	8	5	7	19	0	8	4	2	2	2	7	7	0	3	2	3	1	4	3	3	2	3	0	1	4	2	5	9	3	2	0	2	0	1	1	2	0	0
ne0076	1556	2337	1489	1159	1298	1114	908	868	908	1043	1077	768	722	631	640	843	645	788	765	557	651	716	779	682	703	710	828	600	704	682	633	576	533	485	560	556	465	687	597	489	530	522	449	536	413	357	427	439	481	480	431	497	543	470	577	458	618	578	389	486	377	466	608	496	442	375	390	501	450	621	703	522	431	425	544	697	435	394	346	485	368	392	296	407	569	331	536	425	434	351	384	385	279	360	356	481	335	438	434	373	324	358	388	288	392	331	431	277	279	298	325	329	291	276	306	423	293	356	357	258	288	272	464	308	295	347	397	297	237	275	410	350	343	350	367	540	327	338	261	320	290	275	364	303	366	327	315	317	256	289	326	306	272	265	362	361	333	429	226	327	332	381	282	305	319	307	278	236	297	248	312	297	282	268	224	242	339	226	355	333	301	305	309	272	247	341	278	300	291	334	259	279	268	282	302	233	226	197	274	263	273	292	266	325	241	240	244	192	327	230	214	354	287	283	379	264	301	282	309	298	358	209	288	187	280	261	259	352	284	258	272	174	282	233	259	273	303	301	300	257	215	296	264	190	271	224	220	247	313	265	254	291	290	269	240	158	223	250	256	270	226	259	208	209	349	236	170	273	264	245	250	208	264	234	236	224	276	193	232	289	231	252	286	239	402	277	231	250	226	218	284	169	254	210	144	206	208	244	196	191	221	213	211	211	151	278	236	237	122	217	285	245	259	266	179	177	156	159	195	232	281	239	179	277	167	193	171	275	236	256	158	180	205	154	191	137	241	228	184	235	208	135	301	282	168	215	124	166	220	198	187	259	199	167	147	187	187	246	208	191	223	192	174	235	197	160	226	170	134	124	191	283	207	176	217	148	166	126	194	184	217	195	145	175	221	168	228	215	143	205	206	162	154	147	192	166	198	189	167	168	226	162	191	191	174	180	215	407	138	216	209	205	184	139	86	132	163	171	163	164	194	262	189	192	183	160	129	161	243	224	161	178	127	207	220	152	221	167	219	137	199	267	183	132	150	130	202	112	173	193	200	163	208	160	176	183	163	186	153	199	148	146	191	174	153	139	151	150	182	156	119	144	168	131	106	176	137	177	164	157	134	212	144	183	127	143	161	124	145	148	176	136	243	179	232	142	182	163	127	159	156	197	158	104	145	143	180	140	119	159	171	150	156	123	125	196	127	124	164	140	143	143	159	188	157	98	176	110	164	131	125	146	139	131	119	137	117	141	176	134	138	208	180	147	198	114	121	169	135	185	110	140	350	119	147	182	165	156	133	114	151	163	130	163	128	130	104	128	150	144	107	84	127	141	82	129	140	90	98	153	159	110	120	117	138	140	154	145	118	133	157	133	182	157	159	163	101	109	132	157	101	186	129	159	122	133	118	156	183	102	150	166	149	188	129	139	132	106	133	127	111	151	154	149	101	130	102	98	137	106	141	141	138	78	150	130	184	138	142	144	106	119	115	110	93	118	193	90	143	107	136	143	98	106	95	89	131	109	138	101	127	160	134	117	119	104	116	83	95	153	179	122	100	101	118	117	119	144	116	135	128	89	80	116	99	51	103	147	107	156	99	106	103	128	111	115	103	93	99	153	91	96	95	127	115	92	145	153	95	94	123	105	122	76	114	118	90	120	127	62	95	104	82	124	142	124	114	124	79	132	77	124	116	134	81	157	124	97	82	103	104	98	60	70	91	69	114	89	123	87	112	88	103	61	117	108	78	112	71	111	82	102	94	84	112	130	54	83	82	322	97	116	106	94	113	75	84	100	98	87	93	82	97	76	113	107	78	72	111	109	70	80	80	116	123	64	76	97	95	91	106	81	136	118	75	96	87	56	72	103	84	76	89	79	118	68	89	147	66	103	52	97	63	82	61	109	73	77	88	84	98	92	54	97	112	89	117	78	80	82	61	88	67	70	138	131	93	65	108	95	149	76	84	70	134	65	78	98	82	101	123	95	64	83	78	88	104	50	84	106	71	81	91	68	95	47	62	65	88	81	61	74	83	293	60	109	92	89	63	73	77	95	126	82	80	84	69	80	74	83	91	64	91	69	71	112	65	70	64	66	62	112	71	84	113	57	83	70	73	94	65	75	75	77	62	118	74	59	82	101	64	56	84	63	80	62	76	54	50	78	79	78	74	77	85	72	63	84	82	70	90	54	77	47	44	115	107	69	60	115	51	74	90	74	67	87	67	81	91	96	82	86	70	76	41	74	55	76	99	47	69	73	75	72	76	73	105	83	55	50	62	38	89	77	75	56	81	52	95	62	58	55	125	47	71	60	110	71	73	45	57	61	98	53	85	75	64	101	93	60	46	57	56	118	56	63	57	39	73	57	60	53	64	59	60	50	51	52	81	57	63	84	53	49	73	166	54	71	59	50	258	38	58	61	53	106	71	92	56	63	91	63	101	50	69	62	51	73	71	57	45	63	40	55	55	89	50	79	58	52	99	44	58	66	76	40	63	51	49	59	58	78	64	70	49	72	60	69	52	76	65	58	55	55	66	66	37	89	56	69	72	62	73	56	55	44	70	44	93	28	68	52	32	40	50	30	71	66	63	48	59	51	47	44	66	56	64	57	47	57	66	81	69	47	98	65	44	68	66	80	52	51	58	77	48	45	50	38	48	49	63	83	53	76	51	61	40	25	287	41	40	65	35	51	81	59	61	65	70	111	48	51	49	23	45	54	53	54	49	42	36	41	39	63	54	43	31	38	35	50	37	33	73	63	64	52	46	64	37	74	42	65	72	41	69	46	51	28	50	44	45	76	46	58	60	50	48	49	97	38	66	42	58	68	45	48	28	38	79	37	77	47	47	45	26	35	43	50	57	28	38	58	40	40	75	50	42	41	61	28	46	40	45	48	56	52	23	33	60	51	42	57	20	54	44	27	43	52	35	71	41	63	49	61	53	27	37	41	42	36	33	39	39	39	33	53	26	55	66	52	42	29	53	31	69	60	48	53	46	56	37	57	29	25	39	45	64	42	48	39	27	32	40	33	30	26	31	37	42	50	29	47	34	46	48	33	54	52	24	45	22	35	43	48	28	61	42	27	23	271	46	51	27	65	27	42	53	38	32	27	26	69	66	22	39	40	58	45	47	43	16	34	49	27	31	43	37	34	45	26	39	46	38	25	18	48	42	35	30	30	19	23	34	42	33	62	24	24	30	27	29	22	27	48	33	24	32	22	31	27	44	54	27	27	25	38	24	49	25	31	26	37	36	32	24	28	29	18	46	63	55	28	39	43	47	45	25	30	53	25	33	23	16	33	37	42	34	45	37	29	46	35	32	20	30	59	25	20	31	32	66	28	48	24	24	17	31	27	28	31	8	25	33	46	14	7	32	32	60	31	23	37	28	31	34	53	27	25	33	23	40	32	39	27	60	32	25	21	27	26	24	28	30	37	22	15	34	27	37	58	12	32	20	32	20	31	22	28	29	18	29	16	27	20	12	16	34	28	16	21	25	13	41	19	28	21	25	26	38	8	21	253	25	27	14	37	33	9	15	10	42	34	32	21	28	21	18	41	18	20	20	13	26	13	24	18	19	14	32	27	14	15	27	19	13	17	24	39	12	22	8	28	18	33	12	30	21	21	28	18	20	19	38	23	16	16	16	17	21	12	27	35	16	23	27	24	26	18	25	16	27	23	23	48	23	21	18	16	6	32	33	31	18	15	27	23	8	6	19	20	18	11	6	17	18	8	7	26	7	10	11	15	18	11	23	15	22	21	12	7	13	18	18	18	17	19	21	7	13	24	10	11	14	14	16	34	17	10	14	25	7	8	16	17	11	10	10	14	11	5	17	3	17	15	4	13	24	12	14	11	10	14	16	11	11	13	6	4	8	3	7	8	9	27	9	3	14	3	15	10	14	12	11	7	7	14	6	4	12	8	10	15	12	4	11	18	10	12	0	17	7	4	6	7	7	17	12	9	14	6	6	11	6	19	18	15	8	8	12	9	9	14	3	8	5	5	6	5	4	7	7	3	4	6	3	4	2	3	13	2	6	1	5	5	7	5	5	8	0	9	4	6	3	3	3	6	3	5	4	9	9	2	2	3	2	5	3	2	0	2	0	5	1	2	3	5	9	3	2	0	1	1	1	1	2	1	2	4	6	4	2	0	0	2	1	0	2	0
ne0077	2750	3425	1929	2286	1958	1844	1744	1513	1392	1697	1481	1277	1151	1078	889	1066	1044	1239	1059	896	1006	1128	1012	1471	1149	1042	1047	1059	1073	995	959	863	867	779	965	869	800	1061	845	754	767	868	827	806	794	519	643	780	714	807	637	761	834	812	930	704	924	809	702	822	665	705	792	812	770	777	623	730	728	791	616	681	750	651	813	1021	687	597	705	676	644	665	553	625	777	480	690	645	608	654	602	484	555	516	622	622	487	650	645	561	535	634	712	451	667	548	616	461	373	756	602	576	484	455	455	582	449	562	540	419	479	422	594	498	544	456	651	435	369	417	596	549	574	528	577	715	598	484	388	563	478	506	556	544	598	442	560	652	495	517	575	465	421	424	503	616	496	585	354	619	516	504	474	402	656	468	440	316	457	517	480	491	513	346	358	408	582	346	588	438	527	445	523	396	494	472	525	436	466	551	317	498	416	466	492	539	454	295	356	380	477	471	358	503	421	422	471	417	463	406	337	514	464	486	326	423	494	428	405	521	542	429	456	377	359	366	369	483	436	361	467	356	448	343	431	386	426	480	457	430	486	391	392	399	476	371	347	430	393	490	429	428	452	538	413	246	332	394	446	409	444	432	341	397	519	367	379	498	351	357	334	346	418	414	464	364	379	348	378	429	348	378	385	393	498	336	276	343	331	411	410	258	384	386	377	339	454	341	343	343	394	393	355	328	335	279	351	360	238	475	414	309	369	403	316	311	297	282	308	325	372	372	300	433	347	366	345	417	366	404	364	327	366	471	350	265	362	323	287	327	319	294	380	306	298	373	256	247	416	301	301	360	310	263	338	279	244	314	303	301	339	279	358	341	314	256	330	287	265	254	319	489	272	374	338	238	272	162	289	253	316	309	265	301	320	228	307	291	255	313	285	462	343	232	304	283	264	251	244	257	345	242	255	308	303	304	292	242	217	305	365	232	327	240	217	180	277	287	269	312	304	282	250	273	325	249	247	296	329	297	295	272	247	302	283	248	328	293	288	262	302	321	259	250	272	227	416	178	233	268	306	295	262	223	260	254	309	331	194	303	308	200	243	220	214	246	227	371	316	267	578	265	264	264	242	276	260	347	255	253	204	540	252	292	234	217	230	244	285	227	273	201	280	257	275	223	263	272	250	281	182	266	274	290	287	246	254	201	222	265	263	252	252	164	199	260	203	210	227	252	237	262	207	293	204	212	297	248	242	205	250	210	230	189	257	213	168	235	244	231	200	230	261	224	250	123	331	262	224	236	164	233	275	235	208	265	221	239	229	180	248	238	254	294	225	229	188	251	234	200	217	134	200	249	161	270	170	165	187	435	255	177	219	168	220	221	223	204	137	219	231	142	247	186	212	261	212	170	224	190	177	256	177	297	178	242	187	200	244	359	234	242	178	170	158	209	227	171	207	201	158	256	215	145	244	167	161	164	232	149	206	210	183	156	191	203	162	184	259	253	156	163	184	197	198	253	223	173	174	163	203	270	152	162	171	145	207	257	193	131	220	243	178	196	196	203	161	128	147	231	385	214	150	284	202	165	198	217	162	155	173	181	142	165	177	114	209	130	132	204	201	195	148	148	186	194	165	161	187	155	154	157	115	202	181	186	185	178	189	134	212	199	162	159	182	209	92	184	173	118	140	158	153	186	219	188	200	201	128	214	147	198	144	189	138	238	172	200	121	138	204	178	118	157	174	131	117	179	207	118	154	146	216	123	182	149	180	159	120	229	143	193	129	129	188	143	191	161	82	167	133	177	197	159	174	148	170	178	164	133	146	130	147	163	181	199	156	83	208	128	94	119	160	181	288	153	164	145	153	137	176	140	197	118	87	137	114	112	104	178	112	108	162	98	207	72	188	154	131	114	71	138	114	165	136	132	103	112	121	126	244	139	131	139	127	141	155	154	104	115	146	164	241	86	148	295	273	128	168	131	163	103	131	134	176	122	133	145	114	162	156	129	133	121	144	139	148	121	142	104	136	122	161	138	132	106	112	104	146	137	128	108	135	114	117	143	153	132	105	111	113	111	142	132	135	128	125	114	111	147	120	100	140	96	108	185	153	112	95	88	111	149	121	127	146	126	192	106	104	169	110	119	94	123	152	147	110	113	127	127	141	114	116	85	148	111	142	107	120	144	106	128	129	117	87	152	109	93	130	90	153	138	102	95	106	148	124	128	94	117	121	131	133	124	101	136	98	113	114	99	110	141	113	133	98	128	122	136	150	142	128	101	98	80	140	86	157	166	109	74	94	85	186	123	115	120	81	104	140	107	92	68	131	97	105	87	138	128	119	89	116	102	162	139	95	117	88	161	154	81	123	111	85	138	91	101	62	88	102	84	81	106	100	98	83	89	82	71	113	92	85	82	128	111	115	155	98	104	95	81	90	104	76	106	103	130	126	108	103	94	161	95	129	89	147	78	89	139	103	108	75	122	62	109	97	98	101	74	67	90	139	73	128	104	103	86	75	101	74	95	98	104	132	126	88	107	86	105	110	82	108	96	124	72	98	89	80	91	104	99	91	105	94	99	123	76	90	86	109	70	76	76	71	75	60	67	98	67	103	74	120	68	118	85	86	100	102	118	71	94	94	91	85	58	94	61	54	85	96	105	72	78	100	74	53	75	67	77	81	81	99	91	75	142	54	108	187	81	106	80	86	111	98	59	111	89	86	125	87	83	103	79	83	53	63	57	137	105	107	57	67	128	63	88	64	68	76	76	84	91	78	71	89	128	74	71	66	85	86	101	52	101	73	74	112	60	88	58	69	44	74	102	91	93	40	74	122	59	85	77	98	61	64	94	104	65	68	54	84	91	101	65	87	69	75	56	92	63	67	50	76	114	71	69	90	61	38	68	85	62	61	60	83	69	70	84	44	70	111	79	87	58	44	84	59	70	46	83	71	64	43	84	70	88	98	67	67	60	65	62	39	61	35	139	47	47	67	78	91	65	71	42	67	56	59	64	78	71	87	80	33	61	72	37	41	71	79	78	49	78	57	55	53	43	51	46	56	39	42	86	98	55	46	86	80	50	66	65	42	50	74	60	58	104	32	47	70	37	43	62	79	52	34	80	58	61	42	60	60	42	36	109	43	60	76	58	96	69	76	126	32	64	42	68	60	59	79	52	62	41	42	69	48	52	31	46	55	52	51	42	48	46	46	48	48	74	42	61	34	44	46	36	52	77	44	54	48	49	57	63	48	70	60	68	61	62	42	54	53	57	38	74	49	80	50	53	62	42	51	20	63	60	40	64	56	80	56	50	32	72	41	60	23	46	54	44	31	31	117	41	55	51	41	47	72	50	46	36	37	45	81	64	48	30	40	43	45	45	49	56	19	28	43	48	32	65	31	59	54	42	50	51	41	33	41	56	44	31	56	34	49	45	53	36	60	53	45	48	39	29	40	30	37	40	31	23	60	48	59	22	52	49	63	37	46	57	47	36	28	40	44	42	38	28	26	32	38	44	30	24	39	25	59	45	31	36	50	35	59	33	40	53	33	40	101	59	45	18	22	33	66	32	42	30	59	35	34	51	52	26	56	102	41	18	44	24	39	16	23	29	17	18	36	24	26	18	34	44	34	50	30	44	30	55	32	22	34	42	37	22	36	29	48	38	14	44	33	27	25	30	42	41	17	42	16	27	26	24	34	27	55	35	19	52	32	35	49	33	45	41	30	34	15	14	52	35	21	21	25	40	25	30	15	33	16	25	31	45	20	25	23	30	25	26	25	23	28	28	16	16	29	24	36	23	23	34	18	7	43	30	29	28	12	21	21	32	20	11	19	33	11	25	13	17	17	17	6	33	42	18	44	11	19	14	13	20	32	15	11	13	30	17	26	17	16	13	15	20	12	11	32	9	13	27	15	10	17	14	21	24	22	17	14	16	27	22	26	47	28	18	15	18	16	11	21	15	24	21	11	14	27	11	29	13	19	21	45	18	19	12	12	16	8	17	17	8	12	10	17	19	25	18	19	17	6	3	12	12	7	12	7	13	17	57	6	9	16	8	12	5	7	8	10	4	4	9	4	12	16	11	11	9	6	10	7	10	12	9	2	12	0	4	7	8	0	7	4	7	1	7	6	3	0	4	11	3	8	8	2	7	4	2	2	1	5	5	24	9	4	8	0	0	2	3	0	3	0	0
ne0078	3013	3718	2109	1970	1910	1939	1676	1492	1546	1863	1765	1447	1273	1287	1118	1255	1207	1366	1049	1033	1036	1145	1095	1251	1206	1192	1241	1220	996	1072	1063	961	955	879	1046	950	935	1106	941	744	807	969	984	802	842	650	713	882	876	952	730	931	797	713	845	949	959	973	762	802	746	787	1062	901	857	711	775	832	755	951	661	813	775	586	996	1318	661	720	643	761	720	760	600	584	1064	578	626	747	654	593	767	605	598	515	820	761	603	626	632	492	603	728	737	541	684	643	746	575	534	599	609	585	566	543	519	662	527	666	541	495	525	506	674	522	541	557	619	417	455	486	687	635	648	586	667	1049	596	478	439	520	512	585	517	590	637	549	545	878	492	487	589	453	513	522	583	566	515	688	421	571	501	579	560	470	551	589	478	387	498	531	527	565	520	459	429	426	769	413	648	472	527	579	522	449	465	573	527	467	522	527	332	556	404	528	509	575	477	381	417	437	482	520	447	538	563	526	443	435	586	392	432	484	430	496	389	433	545	474	471	521	729	436	525	368	384	373	373	473	509	464	500	330	442	434	484	463	561	574	576	417	450	480	382	474	627	401	432	411	380	443	421	401	467	533	441	329	288	412	388	398	480	447	336	380	588	401	363	469	432	426	369	392	468	381	427	423	323	391	414	485	456	380	482	581	647	545	358	370	439	425	520	407	433	410	400	368	476	343	353	331	383	376	426	359	301	345	417	322	237	382	576	291	463	435	359	339	285	323	290	414	453	439	305	471	281	404	293	482	372	500	370	369	337	358	355	264	364	393	333	469	314	267	467	305	396	406	252	278	452	373	278	343	352	314	375	347	347	428	355	330	417	375	342	366	370	347	346	328	292	238	380	425	315	354	413	351	268	203	378	238	289	361	241	378	382	264	336	367	235	393	360	338	328	296	300	305	315	290	332	246	350	239	312	284	290	352	362	285	290	384	411	353	353	287	217	189	313	341	266	240	312	389	279	326	335	206	238	278	471	313	367	344	436	318	329	280	379	328	363	252	341	440	332	234	284	218	383	193	281	221	298	261	264	236	312	277	284	336	290	366	255	278	273	304	250	214	252	314	309	272	332	299	285	251	232	287	274	314	309	281	225	400	258	347	246	278	223	258	341	261	263	220	363	354	326	224	330	245	215	305	213	277	286	279	315	265	345	245	219	259	322	279	229	212	195	226	179	224	230	279	240	264	299	228	228	193	315	271	246	223	283	235	230	229	224	236	165	259	218	244	224	323	315	271	305	164	226	251	223	227	281	244	220	199	214	228	252	300	225	182	252	326	277	258	258	219	166	226	324	252	200	138	260	283	166	280	215	143	205	264	328	167	224	178	210	251	256	181	196	183	241	180	250	247	229	226	185	192	251	237	173	303	237	252	173	220	257	244	264	187	281	258	254	277	177	202	164	179	205	229	250	291	209	145	205	223	170	202	203	174	200	216	195	171	234	234	134	186	215	277	178	192	155	233	228	275	209	185	236	204	211	266	196	186	191	139	226	249	202	156	236	213	226	189	230	190	198	159	167	209	283	286	160	218	200	134	232	230	157	174	269	158	134	196	171	126	204	207	113	250	216	219	155	174	245	186	188	164	203	166	191	223	144	176	180	167	237	227	180	165	210	143	210	183	185	181	108	210	220	124	137	198	148	233	191	166	176	206	133	237	175	205	176	267	144	279	178	154	130	219	163	181	121	139	169	151	128	206	186	164	179	140	251	127	247	180	191	197	174	196	167	170	147	157	269	180	198	147	142	165	181	212	203	182	182	146	189	277	166	145	179	138	186	133	185	184	154	101	225	161	130	116	155	201	190	166	152	167	129	192	217	161	229	195	106	134	135	122	154	168	167	128	154	65	160	143	192	110	170	149	116	163	103	151	124	160	148	94	153	146	205	156	100	173	142	126	149	113	130	127	94	149	194	101	186	260	156	135	185	173	241	127	114	127	195	137	122	172	148	160	163	154	132	121	149	146	164	111	167	171	138	155	101	144	173	121	105	105	134	139	112	107	150	116	102	196	168	197	124	114	131	164	209	128	122	151	126	106	108	121	154	131	144	137	112	230	138	118	118	110	151	224	107	152	126	82	159	110	113	167	147	120	101	114	96	193	116	119	127	118	121	110	136	81	165	106	105	116	108	120	112	111	119	86	128	110	121	105	185	107	165	124	169	111	98	170	119	151	86	151	111	128	129	138	118	130	96	120	128	108	124	119	127	129	120	144	98	147	135	120	155	84	88	97	175	103	185	213	131	102	89	79	184	136	155	103	99	100	196	95	122	102	187	97	93	132	202	165	128	93	101	126	222	163	108	110	123	161	201	100	127	121	86	142	119	133	36	104	127	94	128	111	117	124	111	62	75	95	124	87	113	92	87	92	119	301	110	105	115	95	65	110	92	99	96	137	142	106	124	101	126	111	194	72	149	82	74	132	100	105	71	118	57	164	95	120	76	111	120	106	139	73	124	87	117	92	93	86	89	97	121	109	146	115	62	119	104	136	99	106	100	75	99	99	129	111	97	122	81	107	95	79	168	114	89	66	71	90	100	94	84	84	84	110	97	72	112	91	132	107	89	61	111	67	81	101	112	162	87	98	97	130	128	70	88	68	83	108	131	143	86	69	99	107	71	80	86	100	66	57	96	130	125	181	52	73	103	66	108	79	113	114	104	91	154	105	97	116	144	96	80	87	94	108	88	81	144	102	58	65	56	64	72	117	73	51	81	79	108	84	89	70	121	101	90	109	58	151	124	122	75	161	100	40	121	67	68	77	57	66	73	83	68	102	45	116	103	78	120	72	109	56	84	161	100	73	77	68	132	73	147	73	52	69	51	57	96	51	114	77	57	90	47	63	120	106	41	69	81	50	70	100	75	64	64	96	41	52	107	56	101	72	53	93	70	70	73	96	81	110	60	115	68	118	60	109	75	82	44	70	58	64	50	66	43	34	52	69	136	71	66	48	107	47	65	72	74	75	69	81	52	64	47	49	37	56	84	85	51	67	51	47	73	59	55	36	60	56	53	89	89	61	44	111	121	53	56	52	64	43	48	49	62	81	61	63	87	60	25	72	71	80	41	112	44	62	46	65	73	53	38	135	52	85	60	61	71	51	88	95	33	47	53	59	68	107	62	55	68	51	48	73	42	60	33	78	48	62	53	55	42	35	73	71	42	77	60	53	48	48	50	42	56	78	28	47	52	36	63	52	56	125	98	69	42	68	36	66	53	41	45	79	55	64	49	27	57	31	62	36	81	75	65	79	54	80	52	59	25	45	64	55	30	79	65	78	31	65	144	50	89	72	55	44	103	80	46	25	103	49	94	48	43	51	55	44	59	92	55	47	29	33	36	48	27	46	53	46	58	57	37	36	48	41	51	65	46	30	65	26	56	47	61	45	85	35	57	59	70	83	40	51	38	51	56	19	60	54	75	32	45	50	54	40	46	47	51	34	32	42	47	30	37	18	21	30	58	52	23	33	51	26	51	49	60	38	58	29	63	44	48	61	33	44	38	56	45	27	38	52	82	78	53	29	90	27	29	74	101	97	62	38	38	17	92	41	33	18	42	29	22	35	33	33	20	29	33	47	20	33	24	46	53	55	32	35	66	20	53	24	35	26	55	40	28	24	31	20	25	23	49	49	19	34	30	49	30	35	51	29	66	13	38	84	25	34	27	34	19	46	40	37	24	50	49	44	27	10	32	25	28	43	33	33	18	28	20	38	20	38	40	17	31	32	23	18	42	31	19	15	36	60	30	27	17	42	21	31	24	29	26	26	26	31	32	52	41	26	31	32	28	21	19	38	17	16	23	37	25	12	74	14	20	22	56	11	44	19	9	10	14	11	24	24	19	29	32	16	17	4	40	9	19	30	23	18	28	12	21	19	17	29	32	8	33	21	38	11	36	19	19	17	18	16	91	22	14	21	8	19	27	11	29	17	26	33	22	27	6	22	12	41	11	16	18	11	13	25	17	40	27	16	11	14	10	2	5	6	17	10	14	7	12	27	15	15	10	8	18	4	11	1	12	8	13	9	6	17	7	5	6	13	9	9	5	26	9	5	6	11	3	1	7	6	9	7	8	9	0	3	5	1	2	9	8	9	19	5	6	3	0	3	3	1	5	5	18	3	2	8	2	1	1	3	0	11	0	1
ne0079	1591	1645	919	829	1023	1016	834	802	697	937	821	682	610	613	571	529	511	604	590	507	524	568	524	708	606	450	562	541	477	512	477	386	500	467	440	479	473	545	468	366	422	464	456	416	441	342	379	393	379	474	392	447	379	292	444	427	431	403	357	360	362	411	404	368	422	351	367	385	335	473	297	355	310	329	438	494	356	309	325	336	354	295	372	318	396	296	322	371	368	309	472	283	295	218	362	299	312	300	260	228	273	378	325	262	368	330	289	296	250	328	245	232	316	307	263	267	288	322	283	282	274	254	283	221	251	240	277	230	231	269	329	285	265	226	334	323	256	257	234	258	250	267	223	273	257	236	310	268	236	239	301	260	236	199	268	248	276	303	221	275	267	270	285	216	253	296	262	149	230	292	262	273	287	183	216	177	294	202	301	239	165	273	221	220	179	258	207	204	210	301	157	248	198	280	258	351	205	203	187	190	262	237	170	268	189	240	201	239	264	180	221	202	193	245	152	179	245	249	208	237	244	176	241	202	171	154	195	230	181	219	231	173	187	211	251	200	226	263	217	211	231	263	280	183	165	185	197	221	217	222	248	229	205	194	264	176	192	216	204	181	229	167	164	183	256	189	202	174	212	165	213	175	267	218	252	168	159	225	171	190	147	199	248	149	268	218	186	156	169	193	244	181	243	203	185	125	237	164	153	165	224	131	192	173	149	238	179	129	117	174	182	161	243	227	150	210	140	119	131	209	231	202	166	169	131	220	168	188	197	202	156	177	176	207	164	141	209	161	186	215	175	151	188	91	156	135	120	133	182	149	154	161	153	154	148	162	147	187	129	165	212	170	260	196	184	183	174	138	144	122	131	192	162	179	180	166	127	115	168	124	99	194	140	170	160	110	165	140	130	150	117	173	151	98	117	144	147	164	173	131	171	142	134	146	160	171	139	121	119	179	172	145	125	146	96	90	163	156	143	155	127	159	129	145	147	128	138	153	126	154	212	120	184	128	175	140	156	101	189	140	162	127	141	99	155	132	155	81	92	133	141	117	103	113	127	153	135	145	155	177	155	121	126	166	135	124	132	149	122	131	77	149	130	107	108	165	121	152	130	110	76	167	157	149	122	130	89	106	219	118	100	129	163	131	135	116	123	140	131	171	137	126	156	150	216	103	123	110	95	126	131	118	103	131	114	85	110	111	132	138	144	150	132	92	129	108	106	130	115	117	155	131	146	118	113	120	109	121	116	93	81	176	137	133	138	99	84	87	108	129	99	94	101	120	106	118	130	120	62	115	110	140	130	162	105	122	88	112	163	104	79	62	135	114	92	170	77	73	124	159	138	121	124	110	113	86	85	95	89	107	123	87	123	117	114	97	102	72	146	120	63	155	92	83	96	105	106	107	152	112	97	130	118	106	80	100	133	103	104	105	109	158	86	60	89	106	93	104	121	85	109	100	104	77	140	102	95	59	80	111	98	108	62	89	95	100	129	86	98	96	81	127	101	86	94	77	82	151	100	92	107	117	137	112	101	107	114	73	67	95	107	84	82	158	89	99	83	102	71	75	94	66	70	71	57	65	94	69	62	107	97	111	91	96	83	112	90	68	66	94	94	102	70	109	91	111	88	96	98	62	120	86	73	111	93	71	56	113	75	38	64	93	65	112	83	128	88	93	81	143	90	91	91	96	74	113	67	80	73	77	73	75	57	66	85	72	101	69	93	67	56	69	79	47	67	92	96	98	73	73	60	93	70	81	95	81	71	88	101	78	92	75	119	71	68	82	76	133	89	75	104	63	115	68	81	104	54	50	88	50	60	63	67	95	43	79	61	87	56	77	100	73	80	58	53	71	74	47	71	63	56	30	94	121	99	80	75	68	53	47	108	64	47	71	77	77	81	83	65	43	92	71	50	83	60	52	62	62	68	53	61	59	147	41	89	96	41	58	83	58	66	39	74	89	48	80	68	82	67	50	88	46	64	41	57	78	64	49	77	77	62	70	42	96	84	41	58	66	58	78	42	51	56	53	67	63	91	65	59	63	51	64	71	86	60	82	59	77	49	71	78	55	65	75	58	74	76	45	98	34	46	82	63	78	51	74	66	56	82	54	78	69	76	76	43	48	69	52	52	71	32	63	63	50	61	47	61	58	53	58	83	57	50	63	45	85	62	66	79	79	54	47	61	44	51	84	34	68	61	59	70	55	56	59	103	73	74	38	73	41	48	39	48	70	46	62	68	77	61	64	38	84	45	42	63	33	70	110	43	43	37	53	45	58	54	55	65	61	77	50	41	43	68	72	59	42	113	54	72	48	48	58	77	36	61	43	52	51	77	56	37	45	55	49	54	40	19	32	50	57	66	61	47	79	52	56	48	38	70	49	50	36	53	32	48	65	43	30	55	37	50	53	47	57	70	68	65	47	48	62	73	60	99	48	78	86	49	62	41	62	42	45	24	61	57	53	55	50	34	36	45	47	38	53	42	35	50	48	57	30	53	41	56	59	54	41	44	38	62	55	33	52	50	39	35	48	40	39	32	55	33	45	37	64	45	35	29	37	52	27	41	60	39	60	28	41	53	60	39	63	50	32	62	39	34	28	57	41	43	48	32	23	66	13	53	20	36	32	41	70	61	53	41	39	29	40	41	43	37	36	63	72	37	65	24	50	21	39	45	40	41	45	43	51	43	33	57	61	33	39	39	51	36	35	38	38	39	48	37	28	33	41	37	55	34	41	34	50	33	43	39	39	40	60	71	48	36	43	19	48	30	52	37	30	55	43	42	31	47	11	35	33	35	38	34	37	46	53	33	33	46	17	38	59	47	46	20	38	35	36	60	35	21	38	32	19	28	37	35	35	23	34	37	37	50	34	13	37	31	38	44	47	36	33	9	49	19	32	53	30	55	27	26	36	22	29	34	27	32	32	24	45	22	31	46	40	51	46	39	40	24	27	16	37	19	21	32	45	36	39	45	27	42	26	28	36	40	38	33	29	22	19	15	24	23	42	42	15	36	20	15	25	20	22	16	21	21	39	33	46	27	32	38	43	27	26	45	22	34	43	15	25	37	60	21	31	31	35	33	41	35	38	39	33	22	28	10	19	18	30	41	47	20	35	15	28	39	26	26	25	17	25	31	32	26	19	45	12	20	39	16	20	16	20	14	30	22	17	18	44	30	21	31	26	14	34	31	31	18	28	20	27	29	21	15	27	27	27	35	33	28	40	46	26	22	23	45	38	17	32	29	20	20	24	16	21	15	8	25	8	27	49	30	23	23	19	25	32	6	12	22	22	9	8	21	23	35	32	12	12	49	32	15	21	35	21	30	11	27	22	20	19	20	19	19	25	24	39	12	17	9	20	13	30	19	28	24	20	24	18	23	15	21	16	30	32	16	19	22	15	27	34	19	13	30	16	15	27	10	26	34	16	37	20	9	12	32	15	15	8	24	24	12	17	10	19	13	17	26	25	31	16	19	18	9	27	18	20	9	12	12	11	25	33	20	14	19	20	38	47	20	29	26	17	12	22	23	9	19	9	16	12	17	10	16	16	22	44	20	15	8	11	18	9	23	21	11	18	15	9	26	24	15	59	6	18	18	16	28	22	14	17	7	33	10	21	9	28	6	21	14	16	13	29	12	13	22	11	15	16	11	19	8	6	11	3	17	11	17	11	13	8	33	15	22	12	26	17	15	21	28	28	15	6	32	3	22	11	8	11	18	6	5	15	8	15	5	18	10	9	12	10	21	7	16	11	3	6	17	16	26	9	11	3	8	14	13	13	13	10	11	20	12	8	9	19	15	21	26	20	7	7	6	10	5	13	12	5	9	8	12	6	6	8	9	10	12	5	2	18	6	14	15	5	6	13	11	7	19	7	1	5	13	7	10	6	11	1	11	7	11	13	5	7	17	15	20	9	8	5	1	6	8	9	5	5	4	8	6	1	9	5	10	7	14	6	8	7	5	13	8	1	9	11	7	5	9	5	5	5	8	3	6	8	4	4	10	7	3	5	8	5	6	4	4	15	6	1	2	2	9	2	6	3	4	5	3	3	0	3	4	1	1	6	1	0	0	2	2	7	4	0	5	4	4	1	2	5	2	0	3	5	4	3	8	2	7	3	2	2	1	1	0	1	0	1	2	3	0	1	4	0	1	1	0	1	0	0
ne0080	2581	2618	1434	1652	1167	1590	1408	1309	1012	1254	1061	1157	1013	1026	897	905	968	788	944	899	884	964	740	942	836	720	891	833	800	910	686	713	729	801	954	695	804	677	617	665	607	771	570	640	755	588	600	760	696	755	634	708	563	687	686	701	463	582	589	598	605	560	568	527	629	629	641	578	580	513	472	479	555	549	552	683	529	494	576	397	602	536	587	508	551	462	464	555	410	510	651	452	539	463	406	439	492	400	502	442	492	559	571	455	524	466	508	482	399	546	454	405	497	496	431	457	498	494	372	430	406	444	454	421	450	553	464	339	418	454	487	408	340	393	476	351	358	309	405	388	439	508	349	527	345	431	392	344	435	418	510	307	374	341	391	350	385	362	393	547	386	372	432	398	429	351	364	341	360	461	438	319	457	396	399	285	431	352	360	240	565	459	324	332	323	327	344	368	315	353	249	376	328	417	308	406	325	385	329	354	358	285	243	361	231	383	285	414	377	325	361	399	299	315	312	450	315	327	301	335	400	322	352	345	382	375	294	304	321	243	321	330	294	267	491	349	348	325	309	299	413	334	264	398	231	264	348	270	263	332	304	276	339	241	308	313	247	279	326	256	337	305	226	315	262	306	358	282	272	286	263	244	350	253	354	244	281	330	307	273	215	258	258	178	329	191	274	260	260	340	333	291	282	340	432	204	387	261	230	226	248	283	261	265	322	245	240	385	259	242	277	211	277	244	219	150	273	279	297	289	294	298	252	255	245	350	281	245	281	202	304	306	280	236	281	250	319	312	265	246	261	289	313	400	301	232	244	222	215	211	208	237	269	272	215	306	226	187	227	175	225	219	313	219	282	197	256	258	305	247	170	193	236	234	234	184	191	160	274	212	307	244	199	271	259	337	160	233	222	240	279	308	242	204	256	209	193	204	179	218	253	274	238	265	247	189	187	180	223	278	217	171	230	264	137	172	220	261	199	255	221	199	261	249	255	298	214	249	191	203	283	211	148	259	203	255	220	160	222	168	217	222	216	172	233	169	225	123	220	202	241	242	158	189	215	193	217	199	181	247	193	210	178	150	140	190	164	304	133	195	227	251	197	184	238	206	257	237	165	144	288	235	172	170	197	134	193	216	258	211	159	155	180	159	172	139	182	152	172	203	124	192	215	242	269	160	158	158	174	238	159	189	175	148	155	247	155	166	185	185	142	164	185	146	173	159	169	202	188	127	241	260	186	147	186	170	143	218	184	165	152	156	195	153	160	82	151	189	207	193	102	176	199	153	181	193	215	171	161	126	175	185	213	165	205	169	130	179	123	138	155	109	132	158	122	235	162	180	176	171	198	138	132	123	200	153	157	173	103	169	147	143	166	146	144	139	216	107	185	137	198	169	116	220	131	130	161	125	154	161	147	153	162	119	132	132	117	143	147	146	145	169	129	158	230	148	118	157	208	97	165	99	108	116	137	157	130	124	118	131	148	140	147	167	120	136	139	192	154	117	124	138	118	122	110	115	146	248	198	94	204	178	130	117	142	150	142	148	131	155	114	119	129	203	113	157	130	125	135	132	109	116	101	108	173	128	169	104	151	80	109	164	150	103	118	160	130	124	132	134	117	155	108	154	163	143	160	164	170	126	136	142	150	123	124	139	93	102	102	97	133	128	111	125	163	128	102	159	102	109	105	126	136	139	115	125	119	129	120	104	121	91	97	140	160	100	80	105	134	86	227	97	126	99	109	121	149	120	109	131	115	163	121	115	101	131	93	178	65	118	111	119	142	91	126	102	130	115	141	110	129	113	134	111	109	125	82	84	108	109	80	99	120	120	110	118	119	171	79	108	126	100	84	124	86	100	127	109	89	120	89	220	149	44	102	96	122	107	105	69	74	86	224	95	133	93	97	108	89	83	102	84	98	121	80	106	103	106	68	101	99	91	170	73	110	180	87	79	115	86	80	68	134	106	61	74	102	82	83	101	103	75	113	66	128	100	108	76	99	104	66	82	124	117	122	62	112	78	66	118	79	63	112	97	91	127	128	88	50	106	93	92	116	94	81	108	124	102	88	119	111	100	88	83	76	125	128	105	44	81	67	99	103	81	100	87	80	106	106	87	108	95	81	89	70	97	88	121	99	83	76	101	79	75	89	102	96	96	57	102	75	81	72	115	63	90	103	97	72	74	124	91	74	51	55	149	42	128	81	46	116	90	79	102	78	95	80	93	69	105	79	96	108	105	74	66	78	73	96	149	108	96	57	66	83	83	108	101	81	95	67	72	60	85	45	81	85	87	83	62	78	79	85	76	61	79	75	75	93	70	76	94	84	51	78	68	64	84	91	95	95	92	67	67	65	96	52	66	93	76	67	57	117	89	106	69	65	57	101	92	69	70	81	85	62	47	97	75	93	79	67	77	75	87	68	67	83	58	60	69	124	63	72	51	130	95	62	76	57	77	49	86	61	82	73	81	72	80	58	61	83	69	77	73	58	78	53	66	83	55	83	66	59	86	92	69	43	66	57	36	76	85	115	63	52	75	76	81	72	85	54	87	34	84	72	43	52	58	57	63	65	49	65	74	49	54	81	71	53	101	70	47	65	92	85	55	78	54	57	81	58	30	59	56	63	29	79	47	52	86	57	46	55	42	35	81	66	79	48	67	56	55	42	72	27	49	45	49	69	60	53	84	44	52	92	56	54	114	48	49	78	68	78	42	38	58	65	86	52	35	71	44	62	88	69	101	48	75	54	86	81	58	42	82	65	45	65	56	28	74	42	59	80	62	75	49	56	41	61	46	63	47	78	61	55	48	48	66	44	58	58	31	69	58	44	38	59	38	59	66	74	51	64	49	46	23	61	49	49	27	61	48	46	50	67	65	21	58	54	33	52	44	56	52	62	41	41	50	83	46	42	64	37	49	96	64	34	42	39	62	28	40	59	71	56	45	40	38	56	43	43	31	56	54	43	17	49	43	52	55	52	42	44	52	33	39	45	61	61	55	35	66	24	18	33	48	60	37	50	54	36	37	63	24	25	25	50	34	62	52	37	32	61	43	38	33	20	30	42	102	49	36	43	59	36	41	36	27	22	43	35	45	25	50	43	57	27	34	37	44	53	44	53	28	81	28	58	44	49	83	57	44	54	33	35	54	45	41	36	36	40	44	47	38	30	40	41	36	34	44	46	28	29	19	26	21	22	48	32	25	41	31	42	33	24	55	35	39	39	65	36	54	40	45	43	71	33	49	36	62	37	43	28	40	33	31	18	32	38	8	46	52	28	34	32	53	49	31	35	31	45	42	28	27	51	40	53	34	35	42	48	23	38	34	19	30	38	27	19	30	13	35	20	30	23	39	40	31	26	22	29	27	41	20	36	66	12	44	17	21	49	36	43	30	33	30	18	31	50	43	36	29	38	32	39	29	29	20	26	37	19	23	36	28	17	23	48	30	31	21	47	43	20	30	25	21	29	47	24	31	28	25	20	35	17	34	33	37	38	20	26	36	26	23	15	24	16	28	30	33	39	18	27	29	37	38	29	10	24	24	22	12	29	20	8	21	50	45	21	19	18	47	28	15	25	18	22	12	18	15	24	51	12	9	33	17	19	21	23	36	23	17	23	22	20	15	12	34	22	30	24	19	25	34	9	26	26	19	12	21	26	37	19	21	12	12	10	13	6	15	28	26	23	19	44	20	10	29	11	16	19	22	15	16	31	15	8	13	10	18	14	8	12	13	9	25	22	22	14	11	28	19	19	16	22	16	18	9	22	21	17	11	36	15	17	24	4	18	34	25	25	14	9	17	18	15	8	9	14	6	13	12	9	12	11	15	12	18	10	12	20	9	17	10	9	18	11	10	5	20	20	18	19	10	17	8	4	22	8	9	5	21	10	13	9	14	22	6	10	13	9	12	9	8	13	11	6	15	11	15	15	18	16	5	8	3	7	9	5	9	6	10	14	4	7	2	27	10	4	12	11	1	6	5	7	1	11	2	14	6	12	11	8	4	4	3	5	13	8	5	14	3	23	7	11	4	5	27	6	3	4	6	5	11	6	5	6	3	0	6	8	10	8	9	7	1	3	4	0	2	5	3	7	6	3	1	4	3	3	3	2	0	0	15	4	4	3	0	1	1	1	2	2	2	0	2	5	2	4	2	3	0	3	4	0	0	1	0
ne0081	2391	2490	1234	1280	1112	1357	1462	1154	887	1047	999	1006	970	882	894	777	930	683	804	744	751	906	698	752	650	703	728	794	783	876	483	704	576	624	829	665	657	600	534	658	597	615	494	573	667	527	517	860	739	553	544	544	456	623	507	627	370	459	534	476	522	475	543	481	488	563	616	556	524	500	388	484	488	417	541	493	425	412	517	384	476	502	712	430	528	349	382	360	468	557	512	435	799	366	352	439	377	354	476	445	465	454	469	404	471	364	366	387	385	438	475	426	377	446	364	463	345	428	341	321	386	381	321	454	387	447	422	302	330	335	369	421	282	303	418	333	356	246	337	322	308	435	353	346	293	479	430	272	389	428	396	267	393	287	373	308	444	293	298	352	353	372	329	381	417	247	269	347	215	296	460	297	388	355	272	285	360	282	292	246	385	439	281	359	242	269	271	352	250	342	249	440	312	284	255	307	255	263	333	334	356	219	208	348	185	386	294	410	349	344	252	384	367	331	387	350	249	246	347	283	278	292	293	370	352	340	282	342	310	263	272	289	301	221	348	360	311	245	257	256	405	291	292	248	190	275	331	285	279	287	233	250	280	216	272	217	211	247	287	281	188	284	190	365	268	308	446	223	201	253	253	226	338	246	276	197	200	317	293	240	172	235	223	155	230	157	287	244	223	330	280	335	166	269	291	198	249	232	252	211	616	209	219	288	287	211	193	282	280	261	213	164	170	241	230	149	251	144	271	258	257	285	181	189	232	234	228	254	286	184	257	305	269	203	241	261	286	251	265	205	206	269	326	310	285	212	249	208	195	155	206	256	212	264	168	302	221	260	185	181	220	154	172	214	230	178	219	208	260	247	136	188	226	265	196	145	169	135	230	189	257	221	225	248	295	277	172	206	215	237	254	174	238	150	199	209	158	162	124	170	235	206	220	247	285	173	175	196	199	201	147	153	229	231	134	157	193	231	226	224	228	141	214	305	233	264	185	220	186	208	162	196	112	275	195	247	183	155	186	165	196	178	173	187	213	140	169	139	196	211	192	164	155	146	146	157	176	213	158	203	200	173	147	168	169	156	158	206	187	185	200	268	198	135	159	158	224	221	127	126	191	220	198	131	188	111	181	200	152	204	129	109	152	106	138	110	195	156	163	178	98	170	221	106	171	171	115	148	202	229	149	177	193	128	132	162	166	128	159	160	126	152	143	185	154	115	181	188	191	179	169	188	213	127	144	134	129	214	118	162	139	154	146	159	104	102	140	109	143	168	123	169	145	130	191	195	173	124	137	90	156	196	182	138	142	196	103	192	105	112	122	125	92	132	80	98	235	138	138	183	164	134	122	103	176	146	151	172	129	163	140	138	155	108	139	166	163	97	161	136	171	153	102	151	107	124	104	127	123	125	111	161	125	91	128	85	77	119	128	117	99	99	128	135	158	126	126	195	144	80	133	98	125	113	111	136	95	176	86	114	151	114	118	136	90	142	117	174	111	101	121	123	119	105	83	91	133	94	139	98	185	175	124	116	149	150	163	118	141	128	80	94	182	85	127	145	89	127	157	153	96	143	105	92	98	125	141	77	141	101	90	145	149	104	83	121	151	123	134	142	117	151	82	115	137	144	128	127	117	111	139	158	104	110	117	111	101	95	122	99	116	86	130	95	101	66	129	103	79	124	118	109	137	117	92	133	71	123	112	85	98	93	101	144	145	71	63	80	140	57	143	73	97	102	95	98	155	101	60	109	143	198	128	92	91	172	69	143	73	97	84	120	134	109	93	110	146	95	122	99	114	97	109	115	107	95	89	92	91	85	482	127	171	63	58	124	107	134	112	77	116	90	73	78	81	100	87	100	97	126	50	138	148	76	107	122	78	95	87	44	151	85	127	93	98	86	113	91	79	66	65	90	67	76	69	101	81	85	68	87	107	115	62	61	78	112	70	64	118	73	62	85	96	114	50	85	109	111	61	57	86	90	110	62	106	80	83	41	79	55	90	90	76	126	108	47	101	52	52	73	78	88	87	91	73	84	109	69	69	67	91	67	162	57	94	119	109	111	85	110	109	88	70	69	84	70	142	94	47	85	60	89	95	78	74	73	63	98	124	61	121	92	71	91	72	52	83	112	78	46	62	70	80	42	109	56	83	104	88	110	67	120	61	107	79	87	67	113	54	77	96	75	44	74	25	107	55	83	59	72	97	78	86	79	44	82	85	61	80	49	64	79	96	89	50	55	85	90	109	98	100	70	64	75	70	93	98	93	75	83	71	83	32	61	33	79	80	74	73	63	54	71	38	112	55	68	84	51	70	71	96	76	64	50	98	62	61	54	72	88	95	86	73	47	70	71	76	60	95	61	69	53	97	112	97	73	74	33	96	91	83	86	61	68	40	40	100	40	90	94	86	61	114	81	70	69	80	70	42	41	82	69	68	97	108	114	68	62	51	58	60	82	72	61	62	67	59	136	46	58	59	68	40	70	62	70	41	61	81	56	76	90	71	63	120	73	33	64	54	56	86	68	92	86	40	56	62	60	62	61	47	92	24	78	88	35	56	87	58	47	48	53	44	75	38	65	78	62	36	81	60	49	51	63	55	55	69	41	55	69	65	39	72	65	53	39	68	23	52	61	88	33	49	36	59	89	64	74	57	88	57	53	26	55	27	43	19	96	38	51	36	45	30	62	60	45	67	60	48	44	78	61	73	40	48	28	42	67	56	31	67	73	51	65	66	70	74	82	47	75	111	70	41	76	40	30	63	71	28	53	42	54	129	81	68	38	55	37	27	63	58	39	74	32	46	34	49	76	38	67	50	37	56	52	50	33	73	34	35	46	56	45	48	34	53	24	27	56	54	23	76	25	69	54	22	40	32	53	34	55	47	50	40	72	29	44	52	66	60	31	45	66	55	43	87	84	47	33	32	61	24	25	45	45	32	23	48	30	55	36	71	45	38	36	38	25	50	35	49	32	48	40	45	50	27	22	40	49	55	45	24	44	15	19	33	31	37	27	52	46	33	45	40	26	37	21	29	32	45	44	38	44	57	48	33	36	27	27	36	150	18	37	49	49	33	45	27	22	31	18	33	44	25	42	57	33	15	41	21	32	40	36	55	15	38	42	44	44	19	31	66	37	63	28	47	52	51	42	31	37	27	19	31	37	29	33	35	29	53	44	37	40	25	15	35	31	16	46	36	37	47	28	47	24	33	35	30	35	32	65	36	32	33	25	27	31	56	54	43	28	43	32	26	44	38	28	17	30	39	41	18	51	36	29	17	26	29	28	30	32	38	45	27	26	37	22	37	31	14	20	16	27	33	51	25	36	48	21	17	25	17	36	27	35	23	39	30	22	27	33	27	33	28	28	20	29	20	52	12	24	33	30	23	14	24	25	11	31	28	47	30	23	29	21	41	41	29	19	18	34	27	35	54	26	10	27	35	33	32	25	21	39	18	23	23	21	29	29	21	32	22	31	22	37	20	37	28	29	20	20	13	36	22	28	18	10	13	22	22	26	39	15	31	20	399	18	19	12	38	19	52	14	25	31	8	22	27	33	13	26	15	26	26	17	19	16	26	22	36	14	12	37	8	14	14	23	28	27	31	32	28	13	19	27	21	14	14	39	7	22	12	15	26	29	15	25	27	23	18	31	24	20	16	11	13	25	27	22	11	9	41	29	28	5	33	19	15	32	11	18	19	22	9	10	15	13	6	22	22	10	16	4	3	10	9	20	17	17	19	14	10	15	11	15	8	18	8	12	14	21	31	8	18	5	8	24	8	8	23	22	24	8	16	14	10	8	7	7	27	6	8	15	9	9	11	19	9	11	5	5	7	8	17	9	10	14	9	6	9	24	10	18	11	5	14	9	6	7	10	3	4	17	7	19	10	6	14	12	15	8	12	9	9	13	17	11	11	6	4	7	7	9	9	7	4	14	9	8	10	9	8	7	5	6	9	7	13	6	7	4	6	2	6	3	14	4	15	1	3	2	10	14	13	8	5	5	14	25	3	10	13	12	5	7	2	6	2	3	5	3	8	3	3	8	5	5	4	2	2	6	12	11	3	6	4	2	1	3	3	2	20	5	6	6	3	0	3	3	2	7	3	12	2	1	0	4	3	3	5	0	1	2	1	0	1	1	2	3	0	5	3	0	0	3	0	1	1	0
ne0082	1805	2114	1089	1420	1184	1195	982	1074	912	996	839	960	874	761	574	742	802	709	758	686	719	944	645	568	643	646	694	721	775	686	699	673	610	518	616	515	515	588	539	485	437	560	548	518	518	351	452	538	579	543	475	518	482	414	590	495	451	549	444	465	454	414	622	466	432	523	469	454	430	495	411	490	470	501	526	530	437	398	442	482	415	460	391	454	387	350	466	440	381	397	390	368	381	418	418	441	349	311	435	348	344	409	416	331	370	384	545	342	277	425	376	414	328	362	297	371	326	325	383	385	355	332	399	399	397	353	329	345	279	334	350	393	310	327	407	361	414	325	298	310	361	355	424	308	346	324	255	304	360	354	383	241	311	303	307	376	301	354	277	405	320	328	331	269	372	315	277	325	277	233	321	268	334	255	255	213	316	280	387	278	294	220	324	319	281	386	267	292	313	317	230	274	342	294	263	278	309	259	325	270	264	332	238	293	249	328	238	242	288	292	253	324	309	311	287	278	262	267	244	280	290	209	289	277	241	286	239	233	245	208	291	221	263	256	398	191	227	290	275	229	417	283	232	293	233	230	277	252	217	263	262	239	278	219	206	214	205	204	241	258	213	286	205	240	311	236	257	209	251	230	218	187	294	201	276	191	228	232	291	281	216	237	272	237	270	239	197	183	233	275	217	188	240	311	224	195	232	238	172	202	201	217	199	244	223	177	245	257	217	251	204	198	239	211	224	176	209	264	166	179	237	245	169	211	359	206	191	274	202	220	313	223	259	125	213	193	224	195	155	151	240	221	152	246	205	191	198	123	205	190	165	218	205	204	176	239	136	257	215	200	202	169	208	180	204	158	205	158	167	195	200	194	160	212	169	148	208	89	203	161	168	184	168	178	218	205	212	188	145	182	218	128	207	173	129	142	178	140	164	127	168	88	172	201	236	179	192	137	157	188	217	159	223	152	119	187	178	188	198	245	153	206	161	136	242	176	121	161	167	223	165	123	133	181	162	179	178	179	220	152	159	140	198	151	193	116	209	160	163	196	151	115	177	118	179	163	172	198	178	184	169	266	141	147	164	144	140	186	159	189	155	162	158	127	100	181	148	196	171	161	198	170	131	146	160	126	197	110	140	186	156	116	169	169	195	125	159	147	157	139	170	140	184	203	127	197	190	163	137	160	172	141	158	141	102	165	96	300	150	164	119	152	150	176	115	100	180	184	151	165	189	162	149	126	97	145	147	149	132	147	162	156	157	162	157	158	146	139	139	122	135	158	129	133	139	141	152	127	332	111	149	116	168	173	168	164	88	164	113	130	125	134	146	162	72	142	134	106	138	108	120	111	124	129	143	87	192	138	101	126	146	96	116	116	106	111	153	104	140	108	147	155	124	123	80	161	120	103	116	96	122	135	141	132	107	121	106	94	100	111	92	122	126	73	137	107	98	127	168	107	149	97	100	90	125	121	109	151	150	155	116	125	89	119	125	116	93	152	123	117	159	118	103	110	75	60	113	130	122	93	123	105	127	144	106	141	130	61	89	120	81	253	117	117	116	111	105	110	86	107	114	112	92	101	87	266	95	105	104	95	114	164	103	119	97	122	90	74	129	105	82	130	82	95	137	117	147	119	117	70	124	108	79	86	98	120	59	85	84	62	74	106	95	98	148	95	124	105	61	123	115	123	92	85	102	102	98	94	84	104	86	109	88	75	107	78	102	95	91	89	141	61	144	80	131	76	108	87	85	119	126	146	93	79	150	106	77	88	78	91	63	85	89	89	67	93	103	80	85	105	101	86	94	97	95	76	155	54	129	82	73	97	144	110	95	101	117	110	108	85	97	120	78	106	52	85	86	54	100	98	51	128	104	67	83	48	99	77	71	68	42	49	94	82	121	72	66	65	94	74	69	104	94	65	62	82	88	68	86	48	90	94	89	79	65	145	54	61	105	100	95	64	104	95	66	71	103	89	68	81	71	57	88	56	103	74	105	70	80	79	60	91	135	77	59	54	83	51	70	86	58	61	96	59	114	106	94	72	61	86	81	88	92	67	85	80	70	49	43	87	90	81	80	91	61	102	95	56	77	53	69	90	121	59	89	40	139	53	55	90	46	65	73	116	42	57	69	81	62	70	56	80	81	38	79	65	70	61	66	78	125	93	52	65	51	49	46	60	58	56	78	68	61	79	42	68	68	58	60	52	107	53	78	54	60	110	89	63	65	68	69	62	63	60	85	78	75	86	75	59	60	71	50	61	89	59	73	114	43	47	68	43	67	94	55	58	36	62	81	48	62	69	54	81	53	56	94	64	104	74	71	62	93	67	69	59	84	89	69	48	89	87	73	60	59	75	53	51	84	92	59	63	82	69	84	50	59	38	58	55	73	57	69	141	53	41	76	32	71	75	78	38	42	60	59	98	77	70	38	49	84	47	83	39	123	61	36	75	42	79	45	57	43	46	51	64	53	55	34	42	56	42	75	50	43	62	60	56	74	62	56	72	63	82	57	74	47	51	55	33	81	66	55	33	71	53	47	79	40	59	79	73	52	67	46	43	46	47	48	52	47	61	63	83	26	33	48	61	44	43	57	33	57	54	41	58	54	44	43	49	51	44	77	61	54	69	49	50	69	65	68	48	72	50	41	79	50	50	58	59	42	54	65	51	53	59	25	28	74	40	50	66	43	51	78	57	40	103	47	64	61	57	58	36	32	44	47	62	50	56	45	41	28	38	54	73	44	66	60	61	78	42	40	36	46	50	31	35	35	73	34	56	47	37	78	61	52	25	19	30	38	19	41	32	49	63	45	52	57	48	47	33	37	52	70	45	46	23	48	38	63	39	53	36	41	26	50	38	55	27	34	54	40	34	47	54	24	44	32	72	37	49	41	30	47	33	39	50	50	41	47	34	32	44	40	31	38	35	32	59	33	30	37	43	40	32	36	55	43	42	58	66	71	34	44	181	40	34	55	61	38	31	44	44	31	39	25	45	28	37	11	26	48	31	23	40	42	35	40	17	30	28	34	31	22	29	26	35	23	25	70	29	25	34	38	38	18	31	60	47	32	24	29	50	29	40	38	27	20	42	36	28	15	48	40	22	38	25	50	50	35	30	33	18	33	28	27	34	37	30	70	37	41	36	30	45	34	27	33	29	31	41	24	23	12	39	58	33	39	52	24	40	25	30	21	34	29	35	21	19	19	26	28	26	26	38	34	21	25	40	37	34	29	29	27	30	33	40	20	49	23	38	49	41	33	26	20	64	28	31	29	26	33	29	23	34	56	37	15	107	35	51	24	27	30	32	16	35	33	27	20	37	23	34	26	45	22	36	24	21	26	32	35	9	23	37	24	28	19	22	26	16	30	33	18	21	27	24	13	44	36	23	24	19	36	31	29	29	31	29	19	31	33	31	20	28	28	11	30	15	24	25	27	26	19	19	39	40	11	7	30	25	32	23	19	21	50	41	25	21	29	19	19	38	46	18	25	21	17	17	42	22	31	16	12	19	32	23	25	22	29	22	30	21	17	19	22	22	35	12	18	24	24	34	22	19	18	17	24	13	20	15	22	18	29	19	43	13	24	17	9	15	18	10	22	14	14	28	32	12	24	28	25	17	13	17	24	13	8	11	21	20	12	18	20	20	23	25	31	19	11	26	26	17	19	12	9	15	8	13	38	20	24	11	18	43	13	17	26	11	25	12	10	24	14	26	10	16	21	27	13	7	11	17	18	18	11	15	9	25	19	13	16	14	9	12	14	34	4	9	14	9	8	11	14	17	12	4	42	20	16	16	11	36	8	20	15	5	20	12	12	15	6	22	14	14	15	12	8	2	8	13	22	14	6	12	19	7	8	10	8	4	22	12	10	9	13	7	3	19	2	9	6	5	11	8	24	7	11	6	12	45	9	9	7	9	10	6	6	9	8	4	6	19	14	7	7	16	8	16	5	10	5	11	8	12	1	12	3	9	12	7	8	3	6	7	4	36	5	20	16	23	11	4	7	5	6	9	7	7	4	1	6	7	3	6	6	3	18	2	3	4	6	2	11	7	1	5	3	10	4	5	7	0	6	7	3	5	2	4	5	6	1	4	0	2	0	0	5	2	5	3	1	2	2	21	4	1	3	1	1	2	4	1	0	4	1	3	4	5	2	0	0	1	2	0	0	0
ne0083	2610	2388	1484	1569	1212	1754	1601	1449	994	1372	1044	1245	1150	1064	929	948	1046	823	975	977	919	1017	854	810	789	774	1015	947	888	939	709	692	792	792	776	746	836	648	662	692	677	763	486	675	691	615	653	809	782	797	718	741	546	604	587	691	470	579	629	584	672	573	504	475	622	634	653	549	538	564	524	534	548	673	522	661	608	466	561	399	636	542	502	519	487	490	454	563	454	550	521	501	557	438	438	468	504	471	487	456	504	462	431	489	521	522	637	526	499	457	431	449	527	543	455	508	525	492	372	530	390	475	400	482	467	413	491	373	462	468	500	476	387	411	464	374	364	371	411	386	395	539	334	378	380	515	388	299	415	421	531	306	443	386	478	296	420	422	436	582	400	338	422	410	479	360	394	324	303	350	487	346	505	386	401	281	430	379	361	270	612	387	317	409	287	324	328	412	305	423	249	449	297	439	284	352	340	384	301	350	422	336	224	378	245	456	299	397	422	333	386	460	376	397	399	366	342	269	350	285	395	288	331	365	383	340	322	296	295	301	324	324	276	220	408	301	297	293	341	277	323	339	272	351	172	276	409	305	308	313	344	280	331	282	299	337	312	299	347	261	233	287	253	344	290	277	351	292	225	316	323	273	409	312	324	239	269	319	316	267	189	310	278	185	321	160	332	202	281	326	346	309	222	377	356	217	300	207	239	246	248	175	266	320	292	225	236	292	253	265	229	215	233	279	229	131	279	189	280	320	290	278	250	282	224	237	295	237	302	228	269	363	277	223	246	255	317	295	245	285	250	285	287	223	354	222	250	231	226	171	238	243	233	224	232	344	368	207	213	195	265	211	213	219	242	159	266	204	268	244	191	198	289	308	233	167	186	198	304	225	279	259	215	275	289	209	206	268	257	198	283	267	231	172	261	228	201	191	139	206	245	217	237	261	260	206	166	281	248	226	226	218	241	258	158	187	237	247	214	222	229	134	266	274	238	374	210	198	193	222	191	191	140	255	222	249	224	191	256	157	263	195	231	187	200	178	222	119	254	221	224	215	198	174	204	159	222	236	162	247	233	187	190	158	160	179	137	170	196	195	215	268	199	209	199	220	214	180	190	152	139	168	218	143	195	149	175	209	167	215	171	144	181	135	156	150	199	160	166	210	146	201	250	152	176	167	147	192	187	224	173	202	203	153	161	142	162	154	208	190	146	160	154	198	179	167	169	212	197	174	209	231	194	127	173	194	161	249	158	162	140	189	170	184	136	92	147	108	148	207	146	167	185	156	170	186	209	213	157	120	140	185	198	140	149	165	125	189	139	118	145	108	117	171	124	144	121	144	147	161	186	147	133	134	189	131	164	188	129	201	153	195	156	136	162	149	178	153	196	174	174	203	132	152	143	133	153	138	140	130	186	166	152	109	129	96	108	141	130	145	86	136	155	145	183	148	107	161	163	111	162	137	101	114	126	156	77	145	100	148	134	168	96	153	156	103	135	157	130	133	99	155	146	93	128	106	154	133	191	115	173	134	133	138	135	167	159	109	118	156	139	122	139	117	135	112	89	135	92	159	142	108	110	97	142	121	162	131	174	126	140	160	138	111	82	128	177	91	169	83	114	159	134	121	150	182	263	201	157	121	127	141	140	126	122	124	125	106	127	85	101	104	122	124	132	102	126	149	106	111	136	125	123	151	146	148	92	125	125	97	117	103	113	116	122	116	63	66	127	79	98	103	113	82	107	97	154	135	66	104	87	176	115	125	134	78	61	154	96	136	96	105	168	106	109	123	141	95	119	116	154	123	131	111	115	107	75	111	109	72	118	131	168	92	114	145	143	169	114	79	135	124	95	104	121	105	110	93	101	126	54	83	138	98	90	113	86	129	97	56	101	103	69	83	120	81	120	79	96	87	109	98	65	98	93	90	129	123	62	104	104	88	106	83	96	63	261	93	124	82	84	91	151	108	66	86	116	107	82	109	85	78	126	70	123	80	115	79	80	62	119	108	79	167	90	64	131	77	55	106	87	93	97	97	155	87	125	86	55	84	88	78	77	72	95	84	129	72	75	119	90	120	91	100	73	101	136	85	63	75	76	110	97	58	96	93	64	99	107	71	79	101	74	114	73	79	85	117	75	70	55	83	73	64	86	85	67	105	65	114	57	102	59	90	106	99	85	103	57	109	99	71	48	73	56	105	56	97	56	58	109	130	82	109	47	105	111	70	60	148	78	91	94	89	62	70	94	96	102	116	119	64	65	80	76	103	109	71	83	77	78	66	69	77	38	90	66	111	82	94	49	99	65	81	87	70	109	55	75	73	82	123	107	64	81	83	67	77	84	97	92	78	104	55	81	76	40	65	127	92	50	58	109	105	94	77	62	51	88	67	94	60	71	91	38	47	76	77	84	101	83	56	94	63	86	64	113	78	75	51	106	74	107	70	161	103	68	61	53	83	72	63	50	60	38	72	83	51	56	53	81	61	51	69	99	70	37	73	81	49	88	72	57	65	82	71	24	72	64	75	66	82	102	63	75	55	65	66	41	83	43	86	31	97	91	72	71	78	87	43	44	54	54	65	23	51	64	57	67	64	59	49	42	76	49	52	83	37	53	72	70	89	49	58	72	36	50	50	52	60	71	30	37	36	55	80	49	78	93	75	58	63	40	60	37	38	21	83	74	58	50	67	27	89	82	40	62	70	37	65	50	71	74	43	61	36	38	86	55	45	54	45	48	85	66	48	71	69	44	71	86	55	36	72	41	32	76	37	28	84	51	64	57	56	91	72	37	22	48	56	69	44	74	64	29	64	42	65	38	51	50	33	66	74	54	33	74	56	42	82	76	36	76	49	48	32	30	63	32	22	47	39	61	66	38	43	29	49	42	41	58	44	37	51	72	42	58	56	71	47	43	43	39	52	69	52	46	52	36	56	32	48	43	84	37	25	53	44	57	40	71	52	58	44	35	23	38	48	60	65	42	35	47	59	30	38	44	44	49	41	37	82	75	24	27	27	56	21	79	37	33	53	42	29	25	34	26	30	49	38	27	55	36	48	46	37	27	31	28	54	47	43	61	44	34	39	39	24	33	47	31	48	38	58	39	33	20	34	30	46	64	60	48	26	36	34	42	37	33	24	53	38	51	27	33	31	34	25	40	47	33	44	32	28	30	45	54	21	44	60	39	55	24	20	37	48	7	48	30	32	40	36	39	31	45	59	21	36	29	52	38	45	38	45	41	24	32	57	21	42	46	50	19	28	49	24	69	42	34	12	29	47	26	34	38	35	34	29	31	21	23	29	22	24	44	39	26	27	24	114	209	31	35	42	31	35	34	25	19	25	20	30	29	36	33	35	29	31	69	15	21	31	35	35	21	48	12	41	61	14	27	30	22	36	28	40	28	29	42	65	33	30	27	37	33	52	23	26	21	28	22	24	50	23	12	26	34	37	27	21	49	36	4	19	14	22	41	32	26	43	25	39	27	54	22	38	23	38	20	20	13	31	37	29	14	37	19	27	33	27	25	29	33	18	29	30	25	14	32	26	18	26	39	30	11	30	20	22	18	16	18	35	31	20	14	19	31	20	29	24	13	30	11	8	13	22	15	38	39	29	20	15	19	18	17	23	11	42	10	21	21	10	15	35	15	24	26	12	18	26	18	32	16	13	9	20	14	11	16	16	32	15	40	25	30	9	20	29	15	16	22	21	14	23	23	26	9	16	12	19	8	12	9	19	26	25	17	16	14	15	16	22	14	16	15	12	9	4	18	26	23	47	17	10	13	26	13	24	14	13	13	13	20	14	12	20	12	14	27	10	16	8	9	22	11	20	11	11	5	5	15	9	17	12	15	15	17	9	10	23	12	23	13	15	17	11	8	16	18	9	14	7	14	8	13	9	26	8	9	30	10	11	9	6	12	11	7	11	4	10	6	17	9	7	11	10	11	8	3	9	4	5	14	6	3	9	5	17	3	5	7	4	12	3	10	7	13	3	11	8	6	1	13	4	3	1	7	9	8	13	8	3	4	0	7	8	5	10	0	13	2	8	5	4	10	2	5	2	20	10	1	5	9	26	2	4	6	8	3	6	5	5	5	2	11	3	1	1	4	0	3	6	2	9	2	1	6	0	1	0	0	0	7	3	0	2	2	2	0	5	10	0	1	3	0	0	0	0
ne0084	3520	3823	1919	1605	2066	1778	1436	1532	1311	1552	1506	1215	1217	1129	1214	1254	1201	1090	1230	953	846	1064	1103	884	1084	869	1198	1101	956	1244	917	1093	783	789	1140	994	873	1039	828	802	814	862	693	762	752	572	671	896	1247	894	675	764	681	649	613	931	635	722	674	619	623	728	1067	767	773	625	654	752	623	760	675	833	790	535	879	856	523	691	633	633	688	658	495	600	788	439	598	606	734	631	793	618	450	436	546	697	477	639	590	493	554	696	545	475	559	520	628	473	578	441	609	498	442	446	445	649	418	662	541	375	448	435	548	573	662	508	550	338	360	416	511	555	461	584	525	820	535	384	367	441	383	586	488	411	1156	697	512	549	477	529	556	418	535	425	686	448	553	523	359	323	515	517	464	623	560	507	489	412	419	434	590	424	548	468	312	407	480	319	489	385	323	751	447	356	397	503	461	646	395	477	351	591	344	466	422	423	399	294	468	410	488	387	344	456	382	467	403	435	559	418	297	530	386	416	534	484	367	521	618	432	498	326	489	398	532	412	321	482	452	372	407	312	434	415	422	480	697	405	356	375	444	451	452	455	324	358	458	314	418	544	324	335	371	382	397	238	447	436	378	376	337	425	299	432	502	375	409	336	417	320	325	278	466	349	417	332	266	382	433	332	346	394	324	440	354	421	419	351	751	404	320	309	330	362	380	308	356	236	384	282	414	243	458	327	325	380	358	496	253	294	332	290	311	335	380	228	291	328	316	320	385	444	286	314	257	336	350	283	358	346	326	373	378	299	345	250	404	347	381	255	360	270	446	262	356	312	268	298	350	275	284	350	299	351	283	369	243	307	332	249	297	297	331	371	343	338	307	351	316	250	300	320	309	326	240	323	215	194	347	235	204	325	232	315	340	255	222	297	258	282	263	250	301	295	197	274	270	283	300	277	384	238	314	335	309	251	304	372	270	284	254	236	276	281	192	141	261	301	326	223	306	440	287	372	296	207	245	261	387	258	319	318	227	325	265	288	296	278	362	201	260	303	246	257	308	180	346	141	333	222	255	195	273	219	223	259	203	271	311	330	199	174	270	257	215	168	233	179	283	246	187	250	233	203	227	236	272	251	346	218	162	176	269	242	205	236	286	203	294	279	228	172	345	255	236	197	247	205	190	231	162	270	271	197	288	250	210	227	255	255	199	291	253	189	213	243	175	198	237	216	199	251	210	626	241	158	209	235	304	254	251	339	219	222	558	177	218	230	184	235	201	303	247	200	319	131	609	134	192	245	190	260	205	207	300	304	231	214	153	147	217	274	277	151	215	198	159	200	185	178	130	115	146	244	131	198	228	142	164	225	197	160	170	161	234	210	284	238	150	250	201	194	208	239	196	250	191	178	228	222	226	222	202	191	145	190	278	238	204	191	144	235	222	228	222	230	206	161	152	215	171	188	201	206	186	211	181	258	217	140	195	171	167	171	221	211	154	283	158	190	204	230	165	215	182	169	185	174	213	155	189	183	138	154	144	308	209	156	198	129	254	217	118	131	206	191	170	202	186	212	309	175	196	159	162	145	187	188	151	323	232	177	153	148	111	108	160	131	130	172	185	205	164	162	194	165	167	212	193	211	161	193	109	175	151	227	213	196	166	162	219	183	196	160	182	153	109	178	207	135	130	191	145	171	128	142	175	194	103	159	173	159	281	203	178	234	162	164	131	169	116	125	150	195	160	125	191	123	190	116	83	121	167	126	196	122	157	250	141	138	127	167	267	154	147	225	108	141	137	190	126	152	162	134	168	130	161	134	157	120	154	154	157	160	121	149	131	85	128	137	111	111	152	150	124	158	163	165	139	159	115	145	122	116	86	130	125	126	132	150	117	73	136	103	151	125	131	115	109	107	128	133	54	105	134	127	134	171	398	129	141	114	114	149	147	158	118	127	133	81	145	157	111	108	138	93	104	89	158	190	118	154	124	101	151	118	101	163	102	105	183	128	134	121	129	128	154	76	234	177	116	154	141	147	165	180	126	99	99	96	128	116	129	146	95	191	128	126	111	78	164	199	148	120	171	122	163	158	123	119	158	338	121	111	143	138	96	139	88	111	117	111	122	116	101	136	104	110	141	111	165	124	114	117	112	108	117	173	104	140	120	88	121	104	125	116	107	156	114	141	113	128	67	132	133	125	104	154	115	130	110	79	113	78	67	148	89	184	100	131	99	123	103	100	143	123	97	90	107	104	92	133	112	133	80	89	79	121	108	102	135	143	129	88	115	160	110	144	135	128	92	125	93	101	103	135	158	105	100	123	94	89	157	81	80	102	108	89	124	84	83	97	89	86	93	92	122	85	83	97	129	108	98	94	90	96	105	72	156	83	121	63	111	127	151	111	83	90	147	88	88	88	73	98	116	176	112	75	90	119	48	98	116	96	72	118	93	111	103	96	144	77	94	84	139	161	419	75	99	103	101	87	89	63	110	86	75	92	90	77	111	95	78	126	124	113	101	80	124	125	130	114	85	98	106	99	86	126	64	160	114	99	101	129	85	87	140	83	92	87	83	111	90	107	100	92	59	77	196	80	100	81	78	120	81	74	88	113	99	89	96	63	79	62	75	69	88	52	84	100	100	157	171	93	57	154	114	50	96	90	90	53	69	91	49	73	90	83	81	67	102	89	92	92	50	151	52	78	77	77	77	80	66	106	109	110	73	108	176	91	67	79	100	106	86	76	141	74	79	68	72	70	73	97	91	85	128	74	100	68	89	97	68	85	65	83	161	124	78	82	62	63	124	68	119	63	94	78	60	108	112	78	83	105	62	71	68	100	83	62	101	54	103	48	73	66	67	55	63	66	97	76	70	92	60	49	70	89	63	65	60	69	54	74	121	63	41	58	97	58	70	101	85	50	41	40	65	96	88	49	88	79	69	76	107	109	53	76	93	70	47	69	96	119	53	84	74	69	82	40	47	72	58	57	55	50	73	55	145	43	53	59	48	64	82	85	60	58	73	55	58	42	57	52	43	155	81	59	60	66	53	76	66	103	92	38	65	55	104	56	36	69	56	65	84	25	48	59	52	79	40	114	81	89	55	79	87	40	69	64	49	67	69	92	87	60	20	41	51	31	66	106	46	55	81	52	60	65	37	63	48	50	60	42	68	58	63	47	50	57	55	179	55	110	64	66	75	44	72	40	74	61	57	45	42	79	48	52	45	57	76	47	63	51	51	46	50	59	47	50	45	84	60	42	44	85	49	66	47	44	36	48	52	65	51	47	90	23	46	96	57	38	52	51	57	53	45	59	34	28	33	40	37	46	105	63	52	76	25	36	30	44	42	43	53	73	59	37	69	48	52	34	29	65	50	37	48	38	50	42	28	55	52	57	34	35	32	55	38	53	48	56	41	73	40	39	31	69	64	54	69	41	43	36	102	57	57	49	45	42	34	44	70	69	43	52	86	41	73	25	71	55	21	49	36	48	43	44	51	55	53	37	44	36	23	56	38	48	30	30	27	61	21	33	43	29	17	62	31	31	43	22	47	56	29	37	40	31	57	30	58	22	26	36	36	31	32	47	27	28	17	21	35	44	38	57	55	33	38	38	28	38	38	37	52	47	42	47	29	35	29	36	30	45	23	23	35	50	29	36	41	43	26	22	30	33	22	25	24	47	36	39	14	18	14	17	20	18	15	22	36	44	35	60	34	37	24	27	6	36	29	31	21	23	32	34	20	12	18	38	32	21	19	18	14	18	20	31	26	21	17	30	23	20	56	26	30	18	32	30	37	20	60	18	14	14	32	17	33	21	35	22	22	11	14	26	18	17	16	26	20	31	23	19	21	39	21	23	17	12	19	12	21	17	14	16	27	12	10	28	19	42	29	19	26	20	20	8	14	2	9	11	18	22	8	17	37	13	14	17	17	27	17	11	13	12	22	11	16	9	18	18	15	10	14	5	27	10	6	16	12	13	14	12	14	12	13	26	9	11	7	12	13	15	12	45	19	15	6	18	25	21	11	11	11	5	5	11	8	14	10	15	21	16	17	10	5	13	48	5	7	3	8	12	10	11	7	8	7	9	5	5	13	5	7	10	11	4	10	26	5	6	35	6	3	3	12	16	8	1	6	7	1	3	3	4	4	7	3	1	3	3	1	1	3	0	4	36	2	5	0	0	0	4	1	1	0	0
ne0085	1736	1782	967	783	768	888	728	758	611	649	693	561	635	550	577	510	567	541	619	525	528	550	485	441	521	442	565	613	574	610	402	432	397	380	533	408	385	539	433	460	365	439	311	347	379	313	311	463	528	396	308	393	312	349	283	436	332	311	348	288	296	287	405	316	333	322	334	343	311	415	340	355	402	412	443	442	363	317	307	280	331	347	185	329	321	199	308	285	311	332	286	340	260	322	232	308	189	275	288	251	268	273	210	184	302	253	344	212	264	199	283	244	214	223	197	294	185	246	265	168	200	177	240	265	247	336	304	139	156	204	268	269	253	239	301	302	226	200	158	251	266	297	204	211	278	295	248	252	243	339	286	189	265	226	246	279	299	245	152	261	250	263	216	272	261	212	204	222	203	147	260	199	302	233	149	208	234	150	222	196	186	282	191	210	180	268	220	256	191	226	92	265	181	214	179	204	190	155	191	187	227	170	124	245	153	227	180	227	288	164	137	242	215	202	223	216	182	222	238	225	266	154	198	187	243	201	155	238	215	142	182	158	176	195	257	255	200	179	180	180	227	169	176	177	169	171	225	197	183	213	157	199	212	213	179	113	156	185	224	161	138	225	142	237	282	198	235	187	171	195	162	161	236	163	224	139	146	189	214	202	144	180	164	164	213	162	215	200	186	191	166	156	140	225	190	134	152	204	165	126	189	204	157	164	134	200	196	206	163	162	141	149	142	125	147	99	144	196	140	167	166	221	136	187	136	139	160	174	172	135	166	180	197	113	181	126	179	169	199	137	133	128	234	167	163	142	123	150	159	130	125	126	143	135	138	161	120	131	133	128	144	113	112	176	193	142	183	128	143	122	118	167	135	167	122	119	133	86	186	97	140	149	115	147	178	165	103	135	128	164	134	149	156	165	112	124	132	119	121	108	163	117	139	166	143	106	122	145	128	132	143	100	137	143	89	86	117	155	160	112	153	165	175	184	181	123	138	152	146	119	94	159	98	177	125	150	133	124	229	99	114	155	143	111	174	97	132	73	180	137	123	98	138	115	111	127	105	142	145	162	115	117	121	124	110	119	101	165	128	119	115	148	132	95	86	113	120	123	134	80	88	138	107	116	117	116	124	127	97	176	127	99	185	122	103	107	105	119	114	111	73	138	134	62	86	115	116	139	118	123	117	130	113	88	109	132	108	134	102	94	111	139	91	122	98	86	102	147	138	104	159	175	112	91	111	97	85	124	74	108	108	146	113	97	155	67	107	139	119	112	81	118	121	98	123	142	121	106	89	62	122	106	149	93	97	95	78	108	58	92	66	64	67	111	66	96	89	78	79	107	87	93	73	72	110	67	105	104	101	112	108	75	143	121	86	100	127	73	117	89	117	113	86	172	82	139	87	100	110	99	62	126	94	153	83	50	78	82	57	102	53	113	97	102	91	88	81	107	112	74	91	95	74	89	100	83	68	101	88	113	104	146	92	104	77	59	140	87	97	79	107	100	77	92	56	65	67	63	101	53	110	121	79	60	104	101	89	67	112	83	124	88	94	82	96	76	90	107	67	121	81	91	60	67	82	69	82	92	73	90	80	116	96	67	107	93	94	80	116	76	66	93	69	88	74	91	88	104	86	85	116	94	91	66	83	83	34	124	114	84	65	71	81	86	48	69	82	99	58	123	88	69	102	93	76	113	63	90	60	60	62	71	52	84	89	54	60	70	80	50	67	60	101	54	62	68	91	92	77	67	58	95	80	74	69	108	25	95	54	97	66	78	82	82	84	60	105	64	102	70	77	81	71	68	74	76	55	33	93	60	62	71	72	101	80	92	101	78	67	67	60	68	71	41	35	60	63	57	68	79	54	56	96	66	62	61	84	54	61	48	52	67	58	44	93	85	88	65	57	58	56	62	56	49	72	72	54	57	66	42	59	59	66	51	55	121	68	45	76	57	66	79	45	54	62	61	80	91	47	72	111	62	59	37	74	66	72	49	82	60	52	69	50	67	52	55	60	48	54	76	58	52	69	63	42	80	78	57	42	39	82	59	92	56	67	69	66	58	50	65	66	70	61	55	68	81	54	57	44	32	67	46	59	52	64	54	56	58	84	59	81	53	41	54	49	64	73	84	47	50	58	65	49	43	51	47	51	59	40	66	53	66	37	66	68	50	55	60	66	58	66	34	49	35	30	79	19	51	40	47	68	75	61	53	46	67	49	52	41	47	57	69	67	58	46	58	45	53	68	43	51	41	46	51	49	78	51	74	68	50	34	37	58	47	41	50	58	39	47	55	47	43	93	53	39	43	49	57	69	49	46	42	57	40	52	60	51	57	38	53	69	48	49	47	36	41	28	47	57	22	54	43	39	42	68	35	45	43	68	41	33	59	56	54	71	62	66	33	51	60	28	30	58	55	56	48	60	58	39	43	70	39	45	51	60	67	34	48	46	38	29	59	62	30	55	57	41	60	36	33	49	39	43	75	48	66	38	40	51	48	60	68	46	50	58	58	39	60	38	58	65	44	43	47	36	46	30	49	57	60	35	49	29	44	43	38	30	45	45	32	30	48	46	49	39	43	49	58	33	46	41	21	34	22	35	53	33	38	41	51	52	37	58	54	40	21	48	26	51	53	47	34	32	42	24	40	34	45	39	40	50	50	23	45	30	41	19	39	36	45	40	35	28	64	53	31	45	61	26	55	40	43	60	35	35	55	37	36	50	35	40	54	48	47	39	36	42	41	62	44	52	43	31	43	29	27	49	47	26	41	27	20	50	30	49	37	33	28	43	47	37	42	34	18	15	26	29	45	42	32	52	27	31	23	25	42	23	15	38	25	46	47	31	36	23	26	35	39	40	23	34	33	37	30	73	40	16	26	42	36	25	42	32	24	24	27	23	55	50	24	33	49	25	35	30	48	28	47	30	49	22	40	28	49	17	21	31	36	29	32	28	25	21	37	35	16	29	40	19	30	39	27	18	34	27	60	26	29	38	28	31	30	21	19	14	28	50	12	29	28	25	36	26	25	20	20	22	30	41	38	25	35	47	29	30	20	21	28	24	30	26	19	29	34	13	29	29	27	33	26	26	29	19	45	37	32	7	25	23	33	32	57	28	19	35	29	26	27	36	22	18	28	29	28	25	22	29	30	16	35	20	30	25	16	34	42	31	27	30	31	35	25	20	16	13	33	17	39	38	26	19	30	15	28	15	24	42	49	18	30	19	36	29	16	19	25	31	43	22	21	24	17	25	27	18	28	15	19	37	8	23	19	31	9	21	33	16	34	17	17	21	24	16	32	29	37	26	41	17	13	13	23	12	27	30	30	26	25	24	18	19	18	10	18	29	23	22	15	31	20	12	32	32	40	10	24	19	21	31	13	19	29	14	27	17	24	10	19	35	24	18	14	25	12	33	24	26	9	33	30	22	19	33	19	17	23	31	21	26	15	16	36	13	14	10	19	16	28	12	16	16	31	10	15	6	22	14	23	11	12	16	19	14	12	10	16	24	19	25	16	20	19	24	27	54	25	15	7	15	10	20	22	15	24	18	13	10	28	17	20	8	50	14	9	8	14	27	25	12	18	1	16	22	8	17	23	15	14	12	18	15	19	16	26	19	12	21	25	13	14	22	15	12	16	11	12	13	15	8	26	20	16	5	8	14	20	16	23	12	10	24	13	23	12	22	15	10	20	9	18	25	23	22	15	18	16	11	12	5	12	16	11	3	6	14	9	14	16	19	9	6	22	8	5	4	20	10	12	17	24	19	17	16	6	11	10	5	10	27	15	18	7	18	18	7	21	16	10	6	8	6	7	9	5	5	6	13	18	5	6	4	2	4	11	6	4	10	10	8	20	13	14	10	7	18	6	7	12	14	4	7	9	6	3	4	3	16	5	7	8	6	8	12	9	8	8	4	16	13	13	12	8	8	7	8	8	13	1	2	8	6	2	9	6	5	6	28	7	2	4	4	9	8	8	4	1	9	8	2	8	8	6	2	2	6	0	4	8	4	3	7	4	5	5	3	1	4	10	4	0	1	3	3	2	5	4	4	14	2	6	6	3	7	4	0	5	4	2	4	7	0	4	5	1	2	3	2	1	2	1	3	3	0	4	2	2	1	1	3	0	1	2	1	0	3	1	2	11	6	12	1	0	0	1	0	2	0	0
ne0086	2971	2870	1488	1453	1346	1349	1300	1139	916	1077	1237	892	913	845	1131	790	1021	776	890	726	675	871	789	686	867	654	845	984	784	927	686	674	645	614	878	696	728	815	611	779	595	687	525	593	627	566	483	856	909	682	458	592	500	553	624	742	498	503	579	452	473	579	747	491	568	523	470	542	458	513	483	558	587	518	720	719	459	527	506	469	578	559	326	520	531	302	487	431	471	554	563	500	323	397	378	532	315	454	453	351	442	506	508	351	510	385	507	314	508	473	482	412	317	320	273	474	284	578	405	286	319	281	384	433	440	473	449	238	243	277	389	433	368	371	393	482	417	299	251	365	310	586	374	360	450	510	392	346	415	410	423	286	454	357	443	355	464	406	246	403	360	367	373	472	369	343	351	360	271	277	474	308	414	482	211	343	358	221	409	320	384	541	291	285	306	358	316	433	308	393	222	392	318	297	332	362	337	202	275	305	381	281	266	345	274	401	273	357	445	336	206	404	347	312	421	353	291	332	394	330	396	232	361	325	417	343	279	290	331	252	335	306	332	284	390	381	439	311	304	278	356	260	274	364	226	238	332	245	266	392	232	266	297	247	307	154	251	284	316	300	274	279	245	315	410	304	379	258	268	301	285	277	340	259	298	275	221	303	271	323	276	263	255	285	341	308	359	284	345	303	290	302	227	283	429	269	302	195	261	196	348	215	268	235	293	241	238	286	264	194	228	225	220	239	280	171	274	251	231	258	270	345	232	222	262	364	255	197	271	211	275	323	296	184	252	227	271	308	295	219	218	251	343	236	339	244	245	351	255	241	219	271	254	213	205	306	232	221	266	167	207	206	320	305	283	225	226	255	272	231	258	257	235	292	197	204	175	265	261	203	255	281	184	280	229	248	141	244	237	187	227	318	239	254	158	209	207	210	272	165	245	269	272	281	257	207	234	287	256	206	205	190	205	257	192	131	191	239	223	213	259	318	197	257	229	235	250	201	226	213	242	205	180	238	224	187	223	226	326	151	176	246	227	175	252	159	231	126	231	221	211	150	227	181	178	193	178	217	223	275	143	179	218	205	146	201	168	128	190	178	240	253	189	135	247	195	196	229	267	171	163	184	172	167	144	190	179	208	218	205	165	157	271	175	187	134	157	169	159	212	113	196	197	277	202	202	228	170	259	231	124	182	169	149	164	185	166	207	158	145	174	223	178	213	140	143	231	188	202	142	194	241	174	137	248	147	129	189	112	194	148	250	164	122	254	120	242	126	154	184	165	218	184	145	176	211	201	162	185	102	141	246	194	107	139	160	126	141	157	119	90	109	117	145	114	174	221	92	165	143	161	148	99	150	195	112	137	180	226	187	189	139	168	200	151	202	215	126	171	169	197	158	211	189	110	132	151	165	156	250	99	158	176	205	163	114	131	123	179	160	118	163	169	248	194	140	149	198	168	132	126	130	113	144	152	156	85	152	135	135	139	198	121	154	114	105	89	135	179	106	124	129	134	124	97	139	142	129	133	97	165	188	122	90	168	152	124	159	158	154	185	147	157	131	157	108	107	117	131	132	142	132	121	104	102	137	155	114	115	138	138	157	140	99	174	105	141	112	187	124	108	141	88	158	196	170	165	183	151	212	163	162	146	107	176	167	87	142	150	137	138	133	128	139	94	129	157	127	101	123	157	139	258	111	127	189	148	132	102	117	89	105	76	155	112	101	98	110	149	72	113	100	141	130	118	105	131	139	106	98	111	124	129	139	93	159	86	129	126	114	113	101	138	101	116	110	121	111	144	78	112	163	103	117	87	102	120	77	112	99	128	95	115	109	96	151	108	108	94	113	109	107	102	125	73	101	92	100	101	137	97	106	106	59	85	110	101	81	106	83	95	99	85	87	136	86	130	131	112	91	63	72	91	142	134	100	88	104	92	82	100	102	103	86	104	83	141	71	97	160	84	101	89	116	100	69	86	110	80	90	89	94	126	101	136	120	121	86	160	92	81	139	161	124	102	61	135	84	66	123	81	76	118	132	91	137	88	106	79	65	107	93	96	77	90	102	114	154	101	113	135	136	76	91	117	129	113	109	77	119	91	94	110	78	84	94	93	92	103	97	135	79	67	94	99	82	78	91	91	98	99	89	103	68	92	159	85	102	65	125	88	81	56	110	94	95	107	85	87	69	99	74	88	56	50	122	58	90	75	101	90	127	98	98	70	106	99	73	80	46	84	96	81	84	64	81	64	94	116	110	95	79	68	69	90	133	96	100	92	84	78	87	89	73	61	105	107	74	68	88	83	54	120	86	55	59	74	115	74	64	77	91	84	102	48	70	99	78	56	82	112	79	69	67	93	85	60	74	96	98	105	66	78	68	115	52	69	73	76	84	81	79	72	85	99	106	103	64	64	79	75	63	82	86	48	99	94	81	41	49	91	59	48	55	63	96	94	58	55	81	73	88	72	66	88	81	65	53	56	68	70	82	78	98	74	132	71	78	87	80	94	89	62	76	93	54	52	66	48	91	67	66	93	103	60	54	67	75	81	80	81	99	76	78	79	60	66	72	68	81	84	63	65	73	67	74	54	76	75	65	81	55	67	73	60	56	72	75	55	61	84	77	57	73	49	42	56	35	63	103	63	35	55	78	25	73	88	52	68	52	67	61	42	99	43	48	60	93	60	63	98	66	50	61	79	137	55	57	70	77	55	81	69	42	86	87	57	70	101	52	65	104	57	78	66	54	73	69	50	69	55	73	65	105	77	57	69	124	53	88	57	31	95	47	72	57	66	65	49	85	61	39	72	32	32	48	83	58	63	62	68	39	74	37	59	37	56	38	59	47	77	68	84	61	43	31	35	52	34	49	64	43	62	54	102	59	50	39	89	65	64	77	45	53	26	43	59	79	93	52	53	55	42	62	75	88	38	48	41	79	50	50	64	86	48	52	56	48	43	36	40	50	65	50	50	39	44	32	50	38	44	52	35	39	77	76	47	45	36	48	103	33	27	51	42	89	72	36	58	50	31	76	43	38	48	30	46	51	49	42	46	59	57	41	42	31	29	39	39	66	72	69	60	41	44	59	52	53	54	54	42	57	46	60	58	48	17	42	34	47	67	71	38	35	51	51	39	52	40	39	61	34	46	27	42	31	47	54	45	51	47	56	28	49	39	49	47	38	53	46	44	34	40	21	19	33	33	24	37	35	51	29	31	46	53	22	44	42	22	50	34	79	28	44	49	46	32	38	44	48	32	54	39	42	34	64	30	62	51	31	39	41	39	45	31	44	38	44	73	32	30	38	27	34	62	66	30	65	16	38	73	27	44	21	35	46	44	26	75	37	35	33	27	48	31	33	38	21	36	38	24	30	30	43	21	49	29	47	29	41	37	62	26	39	24	29	26	44	69	32	28	27	41	40	47	40	43	14	31	40	19	16	27	36	19	38	43	32	30	15	39	34	18	29	20	32	53	41	38	38	35	38	38	33	25	38	24	82	17	26	15	54	21	21	26	30	20	44	26	16	30	24	29	31	27	34	28	12	78	14	32	10	24	31	29	23	29	50	20	23	11	61	36	33	15	38	44	14	25	25	29	34	30	23	39	23	33	31	38	29	34	20	27	46	23	15	46	25	18	20	26	20	13	25	14	20	8	23	20	34	41	43	15	23	19	22	41	27	22	10	32	18	14	24	36	43	34	20	11	28	21	23	27	22	15	39	22	14	12	19	21	10	8	14	14	10	44	15	29	20	19	14	7	25	13	26	19	21	15	21	27	15	19	15	13	11	13	17	31	10	16	26	21	27	14	23	22	13	23	13	31	9	20	15	12	12	15	20	12	10	9	9	21	13	5	16	10	14	9	10	14	11	17	12	19	15	13	64	54	11	12	13	18	8	8	7	23	22	5	21	9	14	6	20	19	8	7	15	10	16	18	14	10	6	17	15	25	8	6	14	4	9	10	13	9	3	14	13	10	4	6	17	12	1	10	41	7	11	10	12	62	8	6	3	13	5	3	11	1	9	12	6	7	12	27	3	9	10	41	16	9	5	13	6	7	9	5	133	3	4	5	14	14	12	1	11	8	6	3	7	2	11	30	15	16	3	5	48	9	2	2	4	1	13	4	3	2	7	1	2	3	1	3	1	2	1	2	2	7	3	14	1	0	0	0	0	0	0
ne0087	2180	3139	1710	1434	1920	1495	1326	1270	1235	1368	1559	1162	1048	1036	825	977	885	1063	802	887	874	840	997	974	916	814	1046	868	749	707	894	650	693	767	931	732	682	788	771	656	707	664	666	592	645	562	655	647	592	754	620	724	683	637	540	706	700	773	532	632	637	590	852	593	596	501	614	630	571	790	581	684	570	537	772	931	523	501	440	597	564	527	579	518	757	505	538	774	498	430	597	467	477	464	460	622	487	505	501	353	458	666	627	453	494	463	533	488	502	443	423	428	464	449	452	400	448	553	501	470	439	439	646	318	430	517	387	353	389	450	530	450	456	531	473	685	362	425	408	440	392	429	411	460	518	392	355	467	316	413	420	372	339	325	383	418	429	554	380	552	432	465	404	352	478	449	400	320	422	388	403	441	375	314	374	376	527	402	438	364	374	474	482	318	394	509	384	376	459	399	324	318	297	367	364	431	369	341	291	317	511	407	301	431	397	387	359	297	353	272	365	375	317	339	364	346	397	488	370	439	573	257	386	242	261	333	293	375	383	370	556	228	352	310	311	343	490	445	419	323	309	409	330	361	321	352	328	303	321	395	296	322	388	319	317	307	239	342	355	321	386	351	275	247	462	276	266	432	389	363	321	279	365	291	334	411	280	343	277	348	334	301	349	355	409	336	301	294	319	289	380	321	363	269	275	291	377	318	242	221	314	268	319	295	190	332	319	324	214	282	419	265	365	256	325	243	224	336	228	308	264	320	233	285	236	327	251	374	296	272	263	302	328	193	247	187	271	348	238	329	260	163	357	228	260	261	205	223	336	275	237	322	296	300	239	238	192	268	289	304	309	261	333	314	278	221	267	270	263	167	501	361	291	250	286	265	218	201	264	234	238	269	211	295	275	282	206	284	170	237	283	314	235	220	217	205	365	243	241	193	262	236	240	253	223	306	265	224	209	284	310	267	212	248	157	186	236	253	193	182	224	356	179	244	227	245	169	233	304	202	349	238	233	243	250	196	296	202	277	180	231	378	252	169	213	166	214	139	297	168	234	173	207	180	251	227	238	250	236	243	182	173	241	205	246	170	188	230	170	182	198	199	233	158	191	226	204	223	275	205	180	298	179	246	172	164	196	201	318	161	246	243	301	239	257	182	171	195	146	208	206	175	165	223	321	187	228	172	178	202	198	230	181	174	183	253	156	172	227	153	186	236	257	144	186	175	252	165	178	184	179	179	143	207	196	195	214	165	249	181	153	269	246	209	312	106	184	259	196	213	177	175	192	159	157	155	238	208	130	141	148	236	208	206	183	172	152	163	336	193	117	123	213	222	125	231	248	98	164	303	235	116	162	143	166	118	157	181	137	198	184	138	203	379	182	183	147	140	161	182	125	195	155	192	136	167	174	217	218	161	210	156	207	236	152	150	170	133	183	212	170	212	225	112	153	173	174	157	154	143	160	168	161	150	182	202	195	132	183	208	161	178	180	174	185	165	175	129	208	133	142	167	161	139	115	116	270	214	161	145	135	254	170	129	186	172	121	119	118	172	175	189	144	204	153	142	145	152	158	117	226	94	129	140	98	65	150	141	125	192	170	130	88	141	180	152	122	112	121	211	107	153	122	210	133	163	216	170	130	129	182	91	141	143	166	134	71	154	116	86	124	166	104	198	203	166	160	165	105	137	118	178	183	132	100	191	125	107	123	155	166	147	102	80	114	112	110	95	166	119	146	105	196	102	178	135	138	117	145	191	147	149	137	119	146	190	118	92	310	154	139	120	131	136	163	98	117	140	205	141	120	89	144	175	122	126	137	62	159	145	91	86	88	145	136	91	87	144	103	145	126	138	126	122	67	110	141	102	121	118	138	97	98	147	146	88	115	85	124	79	81	102	82	144	87	119	106	96	121	128	127	104	53	142	113	82	129	100	112	123	77	121	172	90	137	147	97	86	104	252	131	76	99	88	121	116	80	134	125	119	152	93	90	123	97	116	126	92	135	125	86	108	89	114	132	90	65	92	118	75	86	82	123	111	101	137	89	139	126	86	99	122	148	113	97	91	103	106	100	85	154	108	128	102	123	152	94	90	112	91	107	160	69	80	97	75	123	110	98	129	92	79	69	82	119	143	90	105	102	203	112	65	88	71	128	93	88	95	61	105	115	78	88	90	91	89	76	102	112	69	127	65	108	87	69	145	140	113	95	155	72	91	89	106	112	99	66	88	126	78	116	90	62	89	60	98	70	112	143	89	120	85	88	66	101	91	98	125	77	66	88	39	115	115	109	77	94	89	88	74	115	81	170	84	85	92	133	105	109	90	80	100	129	89	105	69	118	103	116	61	77	79	76	87	95	90	41	78	129	102	119	88	91	91	85	41	60	78	87	80	85	49	51	67	133	168	71	63	96	64	65	92	82	90	67	77	120	57	56	105	105	61	117	78	145	106	66	85	89	72	172	102	42	114	107	87	52	82	69	75	97	37	75	71	89	74	75	60	63	67	69	106	79	91	65	87	95	60	64	103	80	82	71	74	89	103	53	96	74	75	97	93	116	73	79	102	80	75	128	69	73	64	67	70	50	47	77	74	87	61	61	69	71	42	82	61	109	70	56	62	72	126	76	48	71	24	54	66	100	165	80	72	82	100	64	90	66	65	37	47	73	99	59	104	53	77	42	108	85	74	66	70	61	95	111	114	85	97	89	78	65	49	70	61	61	112	171	61	84	43	51	58	68	68	71	64	74	82	78	71	52	46	74	69	76	87	53	75	44	89	70	82	119	44	101	43	91	48	33	45	42	76	61	42	56	88	79	105	77	50	95	47	94	79	54	57	64	72	69	66	94	54	43	70	106	41	60	60	71	87	50	52	45	53	106	91	41	58	79	36	52	89	88	124	46	59	54	68	66	60	69	56	21	180	39	63	47	70	50	75	49	99	74	65	42	48	55	66	72	52	31	47	38	62	38	32	47	57	88	50	41	59	47	37	45	91	42	73	60	51	34	55	37	91	42	198	79	74	32	69	46	33	49	29	56	37	65	46	58	54	58	74	45	43	73	36	33	83	44	81	36	50	64	73	53	54	67	55	69	62	44	65	74	67	58	51	35	41	48	60	26	94	25	54	67	49	44	63	70	53	25	32	38	48	28	36	47	47	54	42	37	74	53	57	18	45	62	45	38	30	31	23	45	27	56	50	41	38	40	33	44	31	27	71	27	41	46	42	44	42	48	85	34	56	44	39	32	35	47	30	50	69	101	60	35	37	50	26	48	35	41	31	48	49	55	57	39	69	25	23	21	55	16	19	40	63	34	52	21	46	23	35	41	24	31	58	28	29	43	37	28	42	33	32	51	31	20	26	54	50	28	41	25	49	35	65	50	24	32	26	30	51	31	48	25	54	46	18	37	19	34	45	42	40	45	30	44	18	50	47	25	28	39	47	35	16	67	43	39	26	32	45	8	47	23	43	23	23	27	36	51	21	23	17	23	30	38	28	43	65	16	20	47	45	54	26	35	46	103	20	34	32	22	41	39	32	33	25	13	24	20	26	25	27	27	30	16	98	25	20	14	32	21	18	34	29	26	32	33	34	29	17	30	23	33	34	28	49	10	31	19	27	31	151	15	28	38	35	19	26	38	28	29	14	26	32	16	22	16	21	29	28	18	22	17	9	37	28	37	16	34	30	27	41	35	36	35	18	20	37	24	18	17	33	28	25	15	25	24	26	20	16	11	22	10	15	16	19	20	29	30	27	11	31	17	7	30	14	23	9	31	16	25	14	17	9	22	12	21	12	19	30	19	23	12	33	19	42	14	25	18	13	10	29	10	13	10	16	24	8	20	20	17	16	14	7	16	19	16	18	9	27	27	11	8	27	11	13	10	15	7	8	13	6	13	5	27	7	14	13	19	15	10	6	17	13	12	13	11	11	17	24	11	16	18	15	8	4	10	10	4	6	14	18	5	6	17	13	7	22	6	19	12	15	9	13	6	13	10	24	9	14	4	7	5	7	6	7	7	8	5	9	4	16	9	6	7	4	17	3	5	8	9	21	6	11	2	14	4	7	5	12	6	8	5	12	4	6	6	18	2	0	15	8	2	3	3	3	4	3	2	4	1	3	6	11	6	3	1	2	4	7	3	1	1	1	4	4	7	7	0	1	58	4	0	1	0	0
ne0088	1534	1585	1065	1009	863	1008	1052	795	654	1035	761	772	641	609	543	512	581	604	708	557	611	581	509	854	549	481	599	544	513	571	435	471	496	494	502	445	494	438	451	365	411	455	334	392	575	355	396	425	423	468	484	441	363	364	554	394	327	428	380	365	403	349	365	332	420	384	419	349	390	413	376	315	313	333	370	467	359	341	367	231	368	328	580	300	338	290	250	333	291	343	501	266	456	225	280	261	343	266	275	305	291	447	395	292	337	302	321	313	269	433	254	271	313	309	288	303	290	313	241	286	248	277	264	286	276	311	264	230	263	273	284	298	291	258	267	227	199	208	241	261	246	286	241	292	230	279	282	235	264	253	308	260	241	287	240	177	305	209	251	384	276	233	251	225	274	206	253	151	226	391	232	277	284	242	239	192	322	228	254	201	258	247	213	223	171	245	213	207	188	255	128	237	148	247	225	380	215	225	167	204	249	177	156	231	154	304	186	205	200	213	233	244	161	243	160	188	237	163	185	250	259	202	218	221	176	222	198	217	234	241	205	235	176	128	234	185	222	206	205	230	203	270	126	168	116	228	229	198	166	226	240	179	177	228	200	196	162	209	176	159	327	231	162	159	209	190	177	199	153	152	217	190	259	224	211	179	162	176	162	141	106	204	198	116	249	115	161	216	138	198	241	198	172	193	142	150	355	192	157	154	306	277	185	158	199	141	164	182	91	156	256	166	175	189	111	102	179	100	182	215	175	185	157	203	137	308	204	155	163	182	151	204	165	170	138	164	173	166	160	202	175	189	204	131	221	151	163	108	93	113	149	135	164	143	149	188	164	122	111	109	194	117	292	157	134	151	201	124	128	158	126	133	168	161	185	132	132	110	154	152	140	171	142	183	143	177	135	155	142	146	206	152	149	134	161	158	89	125	121	159	159	153	150	141	163	173	97	81	135	182	140	138	141	282	105	78	153	161	122	144	128	98	203	181	143	88	127	154	131	122	306	131	133	168	165	149	147	116	98	127	171	147	93	121	154	127	133	59	130	143	150	141	96	133	126	111	152	102	148	131	141	122	109	101	120	122	110	270	84	114	90	144	106	128	114	116	131	210	93	94	121	289	155	142	124	103	161	131	289	121	115	110	105	85	110	110	129	97	115	129	91	155	151	239	291	113	59	104	116	132	149	137	129	91	118	119	97	96	126	141	110	114	116	91	116	112	96	145	134	91	130	114	124	91	89	117	81	121	96	101	100	133	127	117	75	44	68	112	99	158	75	226	132	108	100	120	139	99	67	89	111	145	106	164	114	93	93	127	131	99	119	44	75	99	94	259	90	105	93	164	155	82	94	75	123	99	117	101	72	118	62	85	149	85	93	103	104	97	137	114	89	123	91	127	99	86	101	99	121	86	165	98	109	72	76	87	75	95	91	109	82	109	93	66	108	102	68	87	79	60	93	98	64	77	105	95	91	86	78	91	75	74	85	88	82	77	90	101	89	85	85	78	76	98	90	68	80	242	92	45	116	144	82	105	113	91	86	55	79	100	87	95	69	249	89	97	81	92	54	81	102	45	64	68	134	52	86	110	63	80	72	123	83	72	86	77	60	55	71	44	70	112	70	80	92	105	141	81	90	56	98	59	72	96	82	64	76	89	72	44	73	76	80	81	97	56	87	92	78	92	61	68	68	95	42	99	53	116	79	36	58	60	55	65	108	63	46	103	72	45	78	81	49	61	86	92	99	86	57	82	52	108	88	79	87	49	43	112	59	61	62	78	90	71	67	63	101	77	90	71	113	59	85	87	88	73	59	68	53	54	178	76	81	75	108	70	76	99	75	66	105	69	53	64	77	41	78	74	74	94	71	86	92	22	87	89	38	62	61	56	78	66	72	74	62	55	72	39	73	60	60	65	49	56	42	58	62	73	35	49	68	55	241	57	54	208	66	60	100	62	65	58	67	78	40	41	51	62	62	84	94	58	53	49	59	73	66	54	73	53	53	66	43	101	69	39	65	52	32	65	57	62	49	47	63	61	82	59	60	55	73	43	65	77	61	64	88	64	50	75	66	69	50	61	62	35	83	66	55	42	54	89	63	58	59	46	52	49	52	56	44	72	47	59	53	40	53	63	71	48	46	56	43	37	56	28	32	46	49	49	54	58	28	67	59	36	50	62	51	54	61	42	45	50	32	66	31	56	69	64	71	50	35	68	50	86	47	47	56	112	55	53	33	56	36	54	62	56	79	57	61	51	44	41	53	46	97	65	34	33	35	67	11	52	31	51	49	48	63	71	37	43	43	55	37	57	86	38	48	47	38	62	78	42	96	37	42	52	83	32	38	46	48	36	60	43	20	39	68	60	41	36	51	66	48	56	34	55	64	43	47	35	24	55	27	39	57	48	50	52	36	45	49	58	54	82	33	46	49	44	56	43	94	26	72	54	37	54	42	44	47	43	36	39	51	50	49	44	33	27	56	36	16	60	45	36	34	50	46	35	46	45	42	57	40	44	28	36	56	35	67	57	69	40	52	44	34	25	31	52	40	59	24	34	43	28	35	36	42	31	26	38	29	40	44	37	46	48	41	39	36	21	48	32	46	46	62	39	39	52	33	25	68	24	37	17	30	28	47	67	37	37	29	18	34	29	37	49	35	43	56	44	23	49	16	45	39	28	41	35	43	44	20	48	42	34	40	53	45	6	36	38	47	33	36	15	43	55	26	24	35	45	35	36	44	46	25	32	26	49	45	42	39	45	39	23	35	31	16	30	13	66	25	51	60	59	42	44	39	31	26	39	46	33	23	48	43	49	38	22	43	18	44	63	37	29	22	14	22	17	36	30	26	16	34	15	27	32	23	38	20	38	45	38	18	22	12	32	36	25	26	46	30	31	75	35	28	24	48	19	32	43	36	34	31	43	31	31	49	47	14	29	40	55	27	47	23	38	30	19	30	27	10	22	22	18	32	35	48	28	28	23	41	25	25	12	28	40	37	26	13	77	7	21	10	19	29	17	26	35	34	24	38	18	12	17	26	26	32	39	20	39	23	38	29	31	35	19	18	32	10	15	27	37	20	30	36	23	10	26	32	25	24	28	24	26	16	22	13	15	22	40	10	37	29	30	38	33	21	36	25	18	37	24	43	28	30	26	28	30	11	15	25	20	15	39	31	15	17	33	11	23	12	15	13	38	32	31	11	27	19	25	27	29	8	23	15	30	24	46	17	26	23	24	30	24	15	40	22	15	35	23	22	29	18	7	8	31	21	8	18	29	16	33	20	18	29	26	17	9	19	24	10	8	20	15	21	23	24	24	21	21	30	27	24	24	24	9	19	19	17	15	18	16	15	33	20	15	27	16	13	20	15	17	14	26	16	23	19	14	21	20	18	15	30	24	21	8	21	12	32	26	21	15	34	23	23	23	8	28	17	20	17	15	11	16	25	29	32	9	22	39	9	19	21	12	13	18	14	23	21	26	8	19	11	31	28	15	18	16	15	16	17	27	14	24	14	16	21	14	14	17	20	17	147	22	18	21	12	14	22	252	10	12	11	6	21	29	34	7	44	32	17	8	9	17	12	12	11	9	12	25	11	9	12	16	15	19	20	23	16	13	12	30	8	11	20	29	5	19	11	8	11	14	4	20	13	129	11	10	12	20	4	17	9	6	7	11	9	12	22	17	20	5	25	6	11	31	2	14	21	22	4	9	20	7	8	8	1	13	14	4	4	14	6	11	9	10	14	6	8	16	20	14	13	12	5	3	21	10	9	4	8	2	4	15	5	9	13	12	10	11	9	9	7	15	8	27	15	18	10	9	3	18	6	15	13	5	6	12	6	1	11	5	9	12	8	10	3	11	13	12	17	5	5	7	10	7	5	2	5	2	2	10	4	5	10	3	10	8	4	10	4	5	8	14	4	1	7	3	4	8	6	2	5	7	5	7	9	6	3	4	15	8	2	3	21	6	9	6	8	3	5	4	5	2	11	1	4	5	6	3	5	11	0	2	2	4	7	7	2	1	4	0	0	3	4	2	1	2	6	1	6	5	4	3	2	2	0	6	3	6	3	2	3	2	3	3	3	8	0	2	4	7	0	3	2	3	0	1	0	3	0	3	1	1	25	0	3	3	0	1	3	0	0	1	2	1	0	4	0	0	0	1	1	1	0	0
ne0089	1519	1986	1170	845	1093	651	727	519	697	984	662	580	580	364	813	691	475	730	791	537	500	475	576	335	654	536	633	581	496	618	487	461	455	369	522	315	476	609	528	553	498	367	339	356	312	294	296	424	425	299	206	353	315	304	346	379	386	306	374	278	265	336	416	362	291	464	240	376	379	499	436	553	376	258	393	621	293	473	369	369	353	428	127	339	515	188	388	419	435	348	209	419	143	301	344	368	147	317	248	242	299	277	182	214	267	250	240	180	271	297	237	445	173	145	139	319	123	367	304	150	206	113	223	312	351	267	241	228	119	176	247	255	236	257	325	423	256	280	105	207	208	244	175	190	383	268	224	332	287	176	203	266	292	305	235	239	220	295	98	131	254	307	197	254	330	294	271	310	174	103	256	257	253	352	91	352	283	109	231	298	88	235	258	212	222	229	216	251	263	294	196	147	155	202	263	143	178	115	181	213	166	172	200	263	235	234	217	189	219	332	86	171	224	169	287	190	231	271	274	228	355	135	220	213	281	191	208	248	254	229	283	227	234	209	205	238	286	280	242	174	156	210	236	161	183	194	195	96	226	164	161	162	227	177	189	68	195	219	231	267	127	149	265	105	177	188	145	181	255	255	160	203	158	195	149	174	224	174	226	260	169	204	177	197	174	235	318	207	282	245	229	171	248	280	133	163	147	148	164	215	167	169	183	148	211	207	221	167	126	172	203	202	243	142	182	110	224	250	67	152	193	138	193	159	173	99	152	228	190	179	118	146	155	97	168	190	205	258	126	189	172	190	182	109	148	227	219	292	191	142	183	152	165	92	213	169	105	168	198	170	167	204	78	157	192	139	194	115	123	190	121	131	174	129	148	216	129	264	195	106	72	86	140	178	228	180	110	222	106	150	128	111	108	173	65	111	128	171	156	108	171	214	113	161	114	182	168	336	144	218	191	152	150	119	178	109	104	130	116	158	193	144	110	154	93	91	145	134	194	161	45	180	143	165	165	83	120	148	172	146	103	202	182	134	210	110	134	146	145	113	121	72	185	113	176	131	158	121	114	143	66	136	174	121	98	90	103	92	183	113	61	73	130	129	93	138	127	110	132	109	131	126	84	132	98	127	80	88	75	130	144	202	165	138	152	106	119	163	112	134	122	130	121	74	51	124	117	185	147	99	110	90	107	130	100	145	83	142	101	82	111	88	151	127	152	98	118	142	156	148	176	96	123	147	151	155	136	200	106	94	147	144	155	89	119	90	193	88	73	128	78	136	78	94	101	142	115	129	84	84	150	119	129	62	122	57	100	96	124	157	29	100	69	140	137	65	63	37	64	94	133	61	61	102	97	67	72	84	180	96	102	69	132	150	71	123	78	103	78	98	116	98	86	70	104	74	97	145	89	81	68	169	168	104	161	78	64	56	102	106	144	157	93	204	64	114	93	68	88	139	86	98	103	132	162	132	99	96	78	110	111	91	120	96	98	78	128	113	164	111	87	121	98	99	54	143	70	39	72	94	68	81	83	58	75	57	114	54	82	51	97	108	90	40	91	94	94	105	77	74	87	105	88	57	61	71	70	53	94	81	125	169	85	99	59	61	91	97	95	97	78	98	117	60	93	42	40	72	38	162	129	96	87	34	53	72	63	147	55	130	57	97	93	124	51	89	66	90	58	109	94	128	53	87	91	65	103	52	76	115	113	56	63	64	46	88	63	67	75	40	47	87	79	74	113	87	51	124	83	71	66	41	72	88	95	101	61	55	89	110	53	81	77	60	96	50	55	65	41	82	52	81	95	45	53	49	85	52	71	78	93	94	52	77	79	41	105	47	90	75	80	60	109	83	38	75	87	96	31	52	61	47	31	71	67	43	74	83	97	96	63	78	23	48	49	93	39	117	96	76	32	74	53	58	96	113	87	70	64	38	57	76	16	58	82	61	20	71	66	62	67	67	53	52	67	64	95	58	94	51	61	79	48	49	40	47	85	106	52	64	98	74	50	41	47	68	46	112	70	51	91	40	76	62	61	88	64	94	59	37	68	71	86	69	84	50	31	71	52	39	85	55	59	27	94	92	62	59	100	42	81	53	59	64	70	51	99	57	83	46	78	68	42	63	43	88	99	40	57	51	62	45	49	101	33	43	46	71	77	65	63	52	94	41	58	54	64	75	89	29	54	79	94	46	103	116	51	50	71	27	26	31	72	56	60	55	60	57	37	23	43	45	61	44	44	45	25	37	36	33	31	35	46	52	95	49	39	103	32	42	30	37	73	60	35	43	65	32	61	34	68	66	41	57	56	46	49	78	79	44	27	39	74	44	86	78	56	59	71	59	50	28	48	50	53	40	17	73	41	19	70	67	46	37	65	53	54	47	42	33	47	33	53	35	29	73	97	31	47	42	25	81	66	63	20	28	52	37	25	75	28	96	37	20	24	46	57	35	72	24	32	75	63	50	31	47	42	51	32	36	48	84	54	43	44	37	75	21	44	44	82	106	36	45	31	37	65	36	27	43	64	34	61	44	66	57	82	65	34	32	50	39	65	29	26	68	122	22	43	28	48	43	25	42	66	63	41	40	33	37	33	41	67	24	39	42	74	53	51	67	72	40	42	27	56	30	51	31	39	37	38	29	38	67	74	33	29	20	41	25	42	28	58	88	109	52	47	12	101	35	47	51	29	47	58	37	43	27	66	62	18	30	58	52	54	22	47	20	45	55	30	37	74	57	72	38	29	27	62	39	17	45	36	27	77	35	64	60	55	38	30	39	65	66	25	30	57	33	48	37	35	23	9	19	31	43	39	34	57	43	41	68	54	48	34	34	60	40	45	35	28	49	25	65	25	56	29	57	40	52	28	34	29	25	34	31	31	26	43	51	34	40	60	25	12	56	28	56	22	20	53	45	22	36	25	32	17	43	40	36	43	32	25	61	34	28	43	25	63	27	54	36	35	30	51	34	28	45	42	42	56	38	26	47	70	18	39	48	22	26	125	21	23	13	30	38	62	29	33	39	30	26	27	35	48	41	21	25	27	49	21	24	21	31	25	13	16	33	36	17	13	61	20	13	18	38	20	19	18	73	28	29	15	43	28	33	34	16	36	22	29	13	35	27	20	33	27	38	56	43	19	17	19	59	16	20	24	22	12	33	34	43	26	44	32	50	21	32	23	24	66	18	34	24	67	9	26	19	39	41	27	46	15	26	35	11	48	43	55	14	28	23	13	6	25	41	31	28	29	13	30	23	23	44	21	34	20	24	33	16	33	32	34	4	15	41	13	20	45	34	20	27	14	36	52	25	25	50	3	31	7	32	7	10	22	15	14	43	31	24	25	24	12	12	17	31	26	16	16	38	27	31	28	18	11	28	18	39	21	26	29	37	30	37	11	33	29	32	15	21	13	9	36	8	12	12	17	10	32	18	27	19	8	17	15	28	13	7	17	22	8	28	15	12	44	43	20	25	28	2	21	21	51	13	23	32	18	18	10	27	21	22	31	22	22	19	15	32	7	18	25	16	9	36	11	23	28	10	23	2	10	12	24	33	33	11	27	23	11	11	17	6	13	29	12	20	18	42	34	25	12	6	13	7	7	27	35	11	21	10	20	25	30	22	35	18	17	13	16	15	8	27	18	12	13	17	30	17	25	17	42	35	12	14	22	22	18	33	18	12	11	12	11	8	5	22	19	5	12	10	16	9	13	8	7	6	15	9	8	13	11	14	14	5	7	12	7	3	6	11	8	2	4	14	15	3	13	16	12	29	21	9	17	7	14	4	10	27	10	6	24	14	6	11	13	4	17	1	9	10	7	9	9	9	11	15	28	3	6	9	10	1	2	24	10	2	2	10	19	17	10	13	5	12	20	5	7	5	6	20	5	8	15	5	9	8	14	19	9	8	7	13	16	16	12	16	5	4	31	10	5	5	19	8	1	11	9	9	16	8	10	24	2	13	10	5	8	11	4	2	5	2	11	7	1	6	2	1	3	6	10	3	11	6	7	2	6	7	7	1	4	2	6	4	3	3	2	3	3	1	6	5	6	2	2	6	3	1	1	5	3	2	3	2	3	1	2	0	2	0	6	2	5	6	1	3	1	2	3	7	1	6	9	7	3	4	3	8	2	4	2	0	2	2	0	0	1	2	2	0	0	2	0	0	2	0	0	0
ne0090	1140	1453	813	1138	713	532	584	429	579	630	443	456	467	290	809	377	435	484	469	341	356	336	380	337	533	515	445	405	296	483	433	339	293	246	364	248	345	407	326	450	333	308	443	210	253	260	165	345	319	195	145	276	296	303	296	372	357	330	310	262	178	300	332	317	248	301	154	247	283	323	284	284	236	196	311	407	218	401	276	210	255	341	110	294	416	131	289	291	254	264	207	257	141	208	270	277	121	181	191	120	251	205	211	215	190	202	176	126	173	257	204	227	135	94	137	214	98	294	240	106	169	120	259	200	261	211	148	79	93	125	188	152	212	242	252	517	246	150	92	204	168	148	188	174	226	255	204	236	210	174	156	165	288	201	218	290	216	209	85	166	170	233	185	267	174	217	215	235	238	149	185	186	154	355	101	262	170	81	194	155	87	252	161	141	236	229	156	177	183	194	155	140	103	141	199	173	228	127	113	191	89	279	110	175	205	172	114	147	130	223	69	162	177	94	152	154	168	209	192	183	243	80	180	191	232	113	154	225	176	132	179	164	214	136	119	184	213	196	161	132	221	185	198	177	197	194	194	65	163	170	97	166	136	136	136	57	112	164	138	232	90	159	199	127	197	136	118	148	176	199	85	124	94	115	130	195	131	88	147	129	175	115	90	250	149	308	205	135	162	145	134	97	198	141	174	157	96	134	138	123	173	141	136	59	167	252	160	121	80	178	219	133	161	113	126	109	167	143	36	128	133	90	141	209	130	129	114	164	114	141	103	104	112	150	89	135	156	219	180	135	94	137	221	108	105	186	163	268	180	87	94	98	147	44	133	171	118	163	273	92	95	162	146	143	97	101	140	121	95	133	101	98	108	73	112	196	88	211	113	81	103	121	101	104	197	93	140	132	82	112	119	101	101	153	75	114	106	112	139	64	130	237	98	91	78	99	159	200	192	126	126	125	100	73	145	88	60	130	97	50	125	169	67	111	39	54	89	78	270	96	60	108	80	147	86	34	118	119	162	105	66	161	129	92	168	69	130	88	84	81	101	77	94	83	126	102	90	95	109	99	25	47	123	92	59	67	85	141	115	128	102	60	71	104	65	87	87	97	117	122	120	143	67	92	56	115	51	78	67	112	81	144	150	167	148	80	95	113	57	76	78	84	74	140	73	96	99	77	100	44	59	67	64	79	61	74	51	92	62	55	74	90	125	88	79	75	80	90	92	38	104	83	84	101	108	109	54	48	78	99	53	140	109	59	122	65	130	104	71	86	100	97	80	48	76	89	66	101	58	57	96	82	76	102	80	55	75	39	50	120	14	52	156	95	97	77	46	13	47	52	88	53	32	92	61	78	75	62	160	70	82	83	90	135	56	86	50	76	31	51	67	102	81	79	64	91	91	82	72	101	61	133	108	118	103	41	83	46	86	91	89	106	78	217	52	85	83	36	67	93	50	94	86	69	115	94	56	53	133	99	61	74	66	63	57	81	120	62	140	71	110	65	54	101	43	90	54	31	60	71	48	64	37	35	64	41	49	88	42	54	115	114	39	43	57	47	63	87	25	71	74	86	70	61	60	42	89	55	49	52	75	90	57	62	98	44	56	78	46	76	78	54	70	42	63	29	39	61	52	154	93	78	98	32	90	64	41	110	52	97	58	102	82	86	82	51	44	73	47	69	76	84	83	71	58	70	55	34	53	112	66	55	55	77	37	57	47	38	69	52	93	49	93	55	67	76	47	71	84	52	35	33	39	48	73	83	186	48	61	40	60	59	47	24	59	39	53	81	38	38	30	78	70	26	32	43	21	26	52	59	44	38	58	70	79	39	69	38	61	82	47	48	99	41	26	49	51	49	34	37	55	46	36	17	67	27	45	31	57	48	73	70	47	29	32	61	41	82	49	42	29	48	38	126	39	65	51	49	58	57	59	69	27	20	55	51	31	45	54	53	54	30	26	36	66	43	66	51	66	39	67	80	59	33	45	48	55	87	51	63	59	55	63	25	53	41	26	81	51	32	56	51	73	49	30	52	80	62	36	51	39	64	58	53	63	23	28	64	46	17	77	32	48	20	82	87	72	54	19	39	54	30	46	23	29	49	49	50	55	36	204	37	32	34	31	92	48	27	45	53	63	36	35	73	29	49	53	47	44	63	57	33	36	40	41	58	55	38	55	31	28	59	54	20	68	89	58	71	54	42	19	25	52	48	73	51	33	35	35	23	37	37	45	44	56	26	5	24	23	62	18	31	21	45	49	46	23	64	39	200	50	48	86	38	36	18	72	33	59	29	34	30	68	79	34	28	22	42	334	35	12	40	37	139	21	45	33	32	49	63	44	52	22	41	36	18	6	47	17	22	47	40	31	23	19	37	23	35	45	34	67	23	49	19	49	112	50	24	20	31	12	42	34	32	14	40	33	41	23	51	17	35	26	7	16	26	32	17	41	20	11	52	49	25	24	28	29	25	26	53	31	74	56	46	42	23	57	22	19	37	78	47	33	34	14	29	47	46	10	45	40	23	63	62	45	39	42	72	26	19	73	47	140	35	12	45	56	23	21	40	39	32	19	18	52	68	32	22	22	60	18	32	60	12	38	37	46	38	35	31	67	27	55	19	34	19	25	27	26	28	25	24	42	52	11	24	15	11	42	11	27	42	44	51	23	35	37	14	36	28	44	29	24	18	59	24	16	28	65	54	15	19	34	33	19	36	40	19	29	31	5	28	72	61	28	22	46	4	55	16	17	30	29	37	43	87	29	53	85	47	36	17	64	35	14	13	48	35	47	21	37	21	16	19	14	26	24	18	42	36	30	50	59	22	27	18	26	38	53	44	54	41	12	37	12	21	34	43	26	32	12	28	21	22	48	48	17	18	50	21	14	21	40	36	16	30	25	20	12	23	18	23	32	42	16	69	10	27	12	32	15	52	11	54	62	52	27	18	14	18	18	16	28	44	32	25	13	56	33	20	29	20	17	23	60	38	19	24	18	24	98	10	24	21	23	30	42	39	27	25	28	16	31	27	20	30	21	27	48	45	46	23	23	43	20	8	64	20	33	12	28	42	13	6	14	28	8	29	15	32	12	21	11	63	18	41	23	12	34	10	12	31	43	27	25	24	12	43	35	33	15	29	11	23	11	35	13	7	10	10	19	22	25	35	10	21	16	10	33	5	124	22	34	11	2	11	20	2	14	20	14	19	25	45	9	31	36	16	44	7	13	22	9	10	22	21	14	12	23	15	27	24	41	27	11	17	7	27	20	19	27	7	34	13	17	21	12	16	39	26	19	14	23	77	17	30	18	52	4	13	4	27	11	9	13	10	16	20	24	7	31	13	7	8	15	6	11	9	15	26	21	17	18	10	10	50	16	66	19	35	17	37	14	21	15	23	33	69	7	6	13	5	23	8	19	6	9	10	27	12	9	27	9	17	12	15	9	7	20	10	19	12	19	10	24	23	14	13	13	1	16	22	19	5	13	9	4	14	9	5	25	12	13	12	35	45	26	29	14	68	14	16	16	36	5	14	13	12	8	2	34	40	13	12	32	8	10	17	14	19	15	3	9	27	20	17	22	19	10	23	10	7	13	36	12	11	9	11	8	8	4	21	17	15	20	8	21	6	50	9	5	9	18	11	5	4	24	18	11	14	28	14	3	6	10	22	4	26	35	12	5	10	5	22	0	28	14	8	10	5	18	6	9	6	6	8	4	16	6	11	7	58	18	17	8	7	17	2	6	21	5	1	0	3	0	3	16	28	11	13	22	7	10	6	8	7	12	15	10	10	9	8	5	6	11	7	12	3	5	9	14	6	6	3	8	4	5	10	12	10	14	3	2	9	5	3	19	2	7	11	1	6	4	14	5	10	12	6	6	12	24	12	19	8	11	4	8	7	6	17	14	10	2	6	31	10	4	23	26	3	10	5	11	4	2	8	2	7	7	6	10	20	5	7	10	2	4	7	2	2	1	16	0	1	2	26	0	3	5	2	9	71	3	7	3	7	2	5	6	1	9	0	7	13	1	0	2	0	21	4	17	3	1	0	0	3	8	7	4	13	2	1	2	4	1	2	0	1	14	2	6	1	6	3	0	2	1	0	0	2	1	2	0	4	2	0	7	23	0	1	0	1	3	1	1	1	2	0	1	0	0	2	0	0	1	1	9	0
ne0091	1831	2213	958	866	668	1233	1504	552	615	829	415	599	669	426	718	585	569	461	828	644	531	470	625	221	437	429	339	538	441	635	371	592	347	347	1089	448	502	352	396	509	508	365	334	296	345	843	244	444	671	327	301	290	251	330	408	428	214	303	475	221	246	228	280	382	223	463	279	238	334	376	276	358	422	361	308	220	326	336	370	293	340	422	156	357	284	198	274	284	538	427	360	541	698	381	286	288	199	292	256	223	263	273	194	258	763	196	251	207	325	321	344	386	721	189	190	294	206	943	204	147	341	183	225	460	419	222	254	80	197	186	166	272	173	200	313	325	228	168	158	137	312	289	160	130	294	254	220	262	361	282	188	188	303	180	222	164	287	188	162	178	216	288	219	207	311	183	243	306	206	86	250	195	247	314	115	317	135	148	172	163	141	918	199	277	153	160	224	292	186	205	317	156	254	149	159	148	201	167	286	173	214	112	130	223	168	245	186	149	296	336	118	148	267	183	434	203	190	158	273	134	157	139	244	285	212	107	178	351	247	170	170	266	146	135	304	334	199	135	160	109	147	206	304	722	271	131	186	122	200	320	104	161	184	148	303	109	265	166	232	162	136	117	158	132	118	260	194	119	152	257	93	212	154	122	119	158	151	186	328	195	165	160	122	163	106	265	243	180	203	261	103	178	182	189	261	212	86	737	181	127	148	131	182	133	325	194	145	145	224	192	205	121	130	125	164	205	247	154	58	192	135	203	114	144	103	124	186	146	203	87	220	197	153	77	116	250	129	179	701	89	192	236	857	280	125	187	275	140	127	123	84	127	147	122	124	142	124	157	113	157	135	241	104	89	156	204	160	148	133	254	101	79	117	112	99	247	199	157	94	92	84	110	88	178	186	135	84	150	113	120	102	93	117	229	53	82	117	151	221	78	138	132	126	114	234	112	102	304	643	123	79	86	117	117	157	680	178	120	116	110	175	114	194	161	156	68	134	117	179	114	82	165	94	126	95	101	81	143	193	91	122	116	152	168	174	88	111	201	241	102	107	57	113	74	90	131	98	118	108	154	87	117	111	139	76	90	80	619	116	91	41	80	102	107	110	93	179	62	75	154	105	78	111	126	85	202	82	581	104	204	86	124	142	100	66	54	99	99	101	637	108	74	140	65	557	80	87	175	126	99	84	96	104	106	55	101	59	77	97	79	53	56	119	355	115	61	90	197	78	71	181	143	81	80	141	74	114	116	83	121	129	99	66	71	70	102	239	79	71	112	109	103	588	70	68	93	113	54	173	53	99	105	126	65	78	89	60	59	73	104	24	169	42	72	52	57	60	47	83	75	64	122	72	57	112	102	83	70	99	111	97	116	91	93	59	90	103	91	94	67	124	66	57	110	51	57	78	57	36	60	53	254	94	70	76	55	77	50	122	64	190	60	91	112	76	126	87	112	60	64	71	86	73	162	93	109	74	138	76	58	119	207	45	69	37	67	184	169	117	48	66	53	53	76	31	132	58	30	142	57	125	74	36	56	56	93	58	82	51	60	65	59	81	24	61	81	71	55	57	62	46	105	114	83	37	103	59	44	67	38	39	157	66	63	77	31	110	108	93	63	59	93	73	49	87	80	36	85	71	107	63	54	104	57	53	55	106	80	72	149	63	76	117	55	31	46	65	54	32	64	110	54	113	75	61	50	59	62	62	94	92	40	56	102	71	51	74	40	65	48	44	36	64	81	39	70	67	120	562	31	58	49	45	102	19	84	62	65	72	82	25	102	75	51	53	44	104	573	65	53	26	94	94	58	38	77	38	91	40	46	47	49	88	25	62	126	111	68	107	59	47	26	51	59	84	79	47	36	62	63	29	49	55	48	26	61	45	61	33	41	73	69	28	40	140	80	63	113	96	48	20	62	44	87	46	99	37	67	67	38	53	83	7	33	55	72	31	50	37	73	42	81	68	44	52	56	127	56	40	30	34	67	568	37	86	40	47	54	30	52	67	40	35	39	52	30	58	45	52	66	72	57	46	98	30	38	67	42	75	35	77	63	55	35	30	42	83	44	54	26	98	56	47	23	57	49	38	79	58	42	89	47	52	66	31	56	44	64	71	56	672	41	76	51	16	27	67	52	38	52	63	52	53	84	37	40	25	119	59	49	28	64	43	41	56	35	577	127	51	47	51	54	36	23	33	44	33	106	49	30	34	18	29	47	34	33	45	44	30	19	43	101	18	28	64	25	35	40	41	539	47	55	56	46	39	23	19	65	42	78	47	39	50	50	17	35	66	52	32	64	37	45	43	65	36	28	21	49	34	39	35	34	25	29	35	62	46	28	32	48	108	29	49	30	26	27	41	25	23	105	37	37	65	51	79	39	41	23	101	38	110	40	33	37	17	53	97	17	38	35	15	118	45	52	25	18	40	28	27	39	35	37	20	31	14	81	73	13	49	31	27	36	28	28	15	49	22	30	14	45	36	67	66	36	26	61	41	37	48	52	64	76	36	49	24	28	45	41	27	94	39	45	39	70	18	34	127	51	22	20	28	46	44	46	28	98	59	17	40	39	66	44	31	53	39	66	36	55	29	639	29	24	82	26	42	50	42	37	30	24	47	58	29	17	59	82	23	52	45	26	62	14	30	44	25	43	24	24	55	35	28	13	38	51	34	42	27	7	54	32	22	31	28	37	44	17	49	11	50	65	36	32	76	86	34	15	27	28	33	44	29	35	53	38	24	19	50	25	30	59	27	37	29	534	29	15	60	36	48	39	33	13	34	55	26	36	25	49	22	25	52	29	27	26	31	6	12	33	17	44	26	42	37	16	21	11	28	17	34	19	22	31	36	36	26	40	9	36	33	62	26	21	19	38	22	19	18	9	21	54	28	34	53	539	9	26	42	43	12	31	36	34	27	16	22	40	16	18	20	40	14	15	18	24	23	26	41	15	46	17	26	49	23	21	30	38	10	74	18	33	54	30	15	27	28	18	37	12	26	18	36	13	16	16	18	12	21	18	21	33	23	25	5	67	54	21	28	47	36	78	64	15	33	20	17	15	8	39	24	14	24	105	33	5	20	24	14	10	25	40	26	10	27	19	31	10	16	13	11	14	27	41	39	43	13	34	12	32	14	7	97	12	11	26	7	26	27	31	13	31	53	16	9	33	24	31	18	26	14	14	81	30	14	30	5	4	39	25	39	36	35	14	37	11	25	10	30	27	32	13	20	24	8	17	24	35	27	18	15	35	23	52	19	25	14	24	19	99	40	31	11	16	19	7	14	12	13	6	53	7	14	25	19	23	40	17	25	47	3	8	3	42	6	24	25	11	20	27	19	12	20	24	37	24	16	34	50	5	6	30	18	40	46	26	13	9	26	39	3	20	13	17	57	17	3	17	9	46	10	20	12	10	15	11	15	12	20	5	17	4	28	11	18	18	18	31	23	11	9	23	4	26	23	21	15	4	10	20	35	16	11	25	23	8	12	21	4	22	5	22	6	19	20	9	17	5	16	20	10	31	15	11	13	18	12	16	12	13	20	3	16	2	7	16	19	17	14	7	5	17	29	8	16	24	13	6	15	32	10	8	5	18	12	7	21	32	8	18	8	2	22	24	32	6	37	3	8	4	10	1	3	10	12	4	10	10	18	14	23	17	18	7	5	7	16	33	17	23	14	11	10	7	17	10	5	10	9	14	2	5	21	10	5	9	4	14	9	12	1	5	14	11	10	5	24	14	12	7	10	2	7	8	0	2	14	4	2	10	12	30	4	3	5	17	9	1	8	7	20	10	8	13	13	5	7	8	15	7	4	9	0	5	6	4	8	9	16	7	19	9	11	2	3	15	5	5	0	5	10	8	16	9	1	6	10	13	0	9	3	1	0	16	4	6	5	6	7	11	12	3	1	11	13	4	3	5	0	0	20	1	2	2	8	0	3	8	3	23	7	3	6	30	8	6	6	0	5	6	0	2	2	3	0	2	8	5	5	4	3	3	10	6	3	5	3	16	1	4	4	2	14	1	10	1	6	0	3	1	4	2	3	1	5	1	0	2	5	2	2	6	0	3	1	3	0	3	1	1	1	0	10	3	2	3	0	3	0	0	2	7	2	4	1	1	0	3	3	2	0	1	0	0	3	2	1	0	0	0	1	1	0	0	0	1	4	0	0	0
ne0092	3501	3492	1612	1410	1101	1716	1596	1284	994	1409	865	1072	1120	1186	879	1326	1464	739	1230	1001	786	1100	1109	677	707	656	725	1071	1048	761	712	916	829	839	1027	632	805	519	654	887	774	683	690	717	852	683	707	937	1339	712	597	560	483	669	784	908	520	549	657	467	715	607	661	711	452	531	640	492	694	482	592	716	735	589	607	565	377	475	567	725	706	677	537	655	571	518	673	489	587	506	617	619	503	678	546	688	534	432	631	514	497	681	501	647	481	377	525	488	552	666	571	514	542	528	431	722	428	677	443	451	330	469	401	612	484	369	483	315	429	410	301	630	359	338	344	427	429	390	420	415	360	738	653	409	451	368	305	296	411	498	404	268	503	561	458	380	614	422	428	371	328	356	363	289	627	403	392	320	368	287	567	288	456	291	324	390	347	359	254	270	348	433	367	316	286	318	376	661	312	404	427	349	591	284	212	337	462	452	348	281	358	255	365	426	240	393	370	289	646	349	355	325	435	430	644	209	281	391	454	215	391	304	272	397	268	267	330	272	399	257	458	349	268	348	440	256	301	308	402	225	217	253	296	344	234	281	302	275	307	409	247	282	481	272	361	318	336	336	363	243	315	201	248	308	216	387	468	294	375	383	269	239	329	252	214	373	385	457	354	343	291	301	208	215	210	329	477	365	323	570	269	367	231	251	272	317	324	202	411	267	223	275	294	345	358	241	201	173	299	174	196	266	251	197	363	266	250	164	189	193	219	366	244	242	174	231	331	262	263	147	397	444	335	241	246	289	190	268	227	155	333	254	275	271	326	385	278	211	177	233	232	306	257	403	268	298	201	284	315	159	153	370	349	161	287	207	270	261	260	286	322	182	299	291	201	262	287	197	203	270	278	196	248	414	255	257	112	268	240	164	242	222	247	212	205	172	363	236	251	193	247	213	336	218	302	205	153	254	236	212	188	284	261	321	262	167	254	233	187	432	305	156	304	227	336	369	284	181	213	224	178	169	171	189	187	328	184	292	310	150	173	151	383	167	213	168	209	149	246	203	172	194	238	217	192	145	284	264	181	391	241	377	188	288	168	152	139	71	202	267	116	173	191	220	202	177	232	140	215	345	126	152	155	162	189	203	215	197	165	211	189	137	157	176	165	146	195	200	145	276	87	152	195	232	192	104	141	332	225	217	181	181	238	183	144	116	199	116	206	109	142	119	166	327	193	191	203	208	104	193	184	207	171	100	147	131	203	274	155	163	298	174	188	179	259	205	176	171	124	275	234	186	166	105	130	88	275	173	409	123	86	190	353	102	196	224	123	140	57	120	83	167	126	140	134	121	167	155	106	147	162	132	148	74	275	105	124	195	164	164	195	159	144	163	106	183	266	142	229	205	231	120	150	130	116	142	151	136	118	119	147	128	164	128	109	94	141	137	133	152	172	102	182	111	291	205	170	240	112	169	180	136	144	176	109	135	122	214	99	96	228	207	72	214	106	93	79	294	127	98	106	115	140	120	105	144	227	112	160	89	244	117	86	110	106	200	179	144	89	176	73	83	150	80	114	186	79	75	123	111	142	131	152	113	89	104	93	124	212	112	107	130	127	105	135	74	207	93	242	109	79	231	78	93	193	150	97	143	124	125	96	129	96	109	101	100	180	109	129	189	165	138	139	109	105	106	116	109	101	99	150	133	204	122	115	108	169	104	63	158	204	195	57	127	199	125	117	74	136	92	83	105	152	223	140	73	138	146	99	67	161	149	144	101	84	89	67	187	112	156	213	145	147	121	169	72	114	68	114	99	87	111	116	94	103	121	252	148	118	104	137	123	116	100	125	146	155	113	90	104	87	109	67	154	112	143	75	80	119	173	37	76	141	87	71	101	72	134	85	41	121	85	66	92	149	82	116	114	110	124	81	77	48	73	137	105	92	85	181	124	97	113	70	61	77	36	85	117	47	102	101	158	181	140	107	82	135	64	69	89	112	81	104	90	221	85	56	85	52	120	69	67	199	104	94	61	157	58	73	139	148	112	104	86	101	113	44	76	102	63	98	108	67	55	75	92	175	111	157	137	93	177	107	135	119	84	161	110	64	86	67	70	59	99	107	121	74	105	88	115	74	83	168	131	97	87	62	132	88	65	78	91	125	67	123	44	152	118	91	55	83	119	67	122	107	55	100	117	58	99	72	79	88	89	76	55	26	77	89	65	83	58	81	69	72	93	51	80	43	66	79	128	33	96	60	63	84	107	113	75	128	101	154	87	55	46	113	63	51	95	189	43	58	69	56	47	57	95	38	87	81	64	53	83	49	60	58	115	43	77	90	124	52	122	90	45	45	73	50	54	95	78	80	30	65	110	136	86	167	86	55	94	81	78	153	47	77	24	86	79	67	97	45	175	54	60	154	36	111	109	66	72	95	70	67	58	86	28	34	43	59	70	47	77	33	77	87	68	79	49	52	74	47	46	27	96	64	39	77	69	93	63	42	48	78	87	75	89	137	37	49	105	34	57	94	49	61	41	53	52	52	67	115	65	58	60	101	79	41	56	62	70	89	48	103	72	59	50	27	92	68	68	159	87	29	51	30	92	83	56	73	36	46	133	40	107	63	81	32	51	93	32	65	55	36	64	61	54	51	61	107	29	45	64	29	85	83	79	146	54	29	82	38	26	43	29	48	93	126	81	55	87	64	59	58	46	67	54	62	73	56	82	57	88	67	40	60	66	72	38	91	67	60	47	40	51	25	84	32	102	48	62	22	49	62	36	64	57	45	105	61	34	50	87	39	120	73	31	22	57	22	35	71	51	70	50	61	61	34	48	33	69	40	42	23	67	59	19	62	51	44	64	70	52	34	44	40	38	39	57	78	20	36	74	28	39	32	43	40	71	68	43	68	85	46	56	37	60	40	92	26	46	16	39	80	58	25	20	39	35	33	62	37	34	22	32	37	39	51	41	72	117	33	53	35	80	38	41	48	44	74	47	15	29	40	33	56	45	109	17	81	70	21	20	32	66	22	18	29	36	22	54	19	58	88	22	46	31	68	20	49	17	45	32	42	29	35	58	30	37	55	75	77	23	40	42	31	54	87	61	30	20	26	44	62	9	74	35	17	75	80	38	66	24	23	45	28	22	37	24	51	22	42	21	26	29	52	43	35	20	61	85	19	102	52	47	29	36	34	35	64	60	26	31	14	50	24	38	53	56	58	65	14	46	50	19	29	30	44	82	21	23	19	51	22	27	61	34	26	78	27	57	33	37	34	48	23	45	33	30	23	55	33	34	56	19	23	16	54	15	27	21	46	27	74	25	10	43	16	51	3	12	35	67	16	38	46	28	62	27	14	69	145	46	26	54	50	8	16	14	35	21	55	19	10	14	11	53	10	11	17	20	9	72	21	28	35	31	16	20	26	39	11	78	34	101	21	12	14	14	35	14	35	12	12	22	54	35	12	37	24	52	7	41	18	31	7	25	23	44	23	25	21	17	18	42	15	23	10	39	8	62	14	14	43	19	50	49	22	18	42	12	13	20	29	11	19	14	60	20	42	22	33	17	9	52	22	34	6	21	2	25	27	28	9	18	18	18	15	14	7	43	11	24	12	17	11	26	33	27	43	14	33	32	20	17	12	26	12	6	15	24	11	12	15	7	17	11	45	10	15	12	17	33	31	53	20	51	22	15	21	22	31	14	26	7	17	34	5	23	4	27	21	8	15	10	30	20	6	12	21	25	11	7	18	13	30	3	14	10	32	8	10	4	4	9	9	14	2	38	28	9	17	11	6	7	48	9	13	3	12	9	20	11	14	4	8	1	16	33	0	6	7	3	17	7	43	10	12	2	12	0	23	21	7	11	4	7	24	15	13	11	5	11	1	10	1	35	7	8	0	4	24	0	5	23	13	49	16	12	14	5	19	15	7	5	3	8	23	14	1	5	12	6	4	12	3	3	11	2	5	15	4	13	5	2	14	13	4	12	8	14	16	1	3	22	14	5	10	8	41	5	27	17	12	7	3	0	1	8	12	1	6	9	4	0	23	3	3	7	0	8	6	1	3	2	3	7	5	1	44	6	1	5	1	4	14	5	2	1	6	2	6	1	2	2	0	1	1	3	2	1	1	2	0	2	8	1	0	1	0	1	2	0	7	0	0	1	6	1	0	0	0	1	0	0	23	0
ne0094	3059	2349	1541	1253	1477	1434	1449	1125	1151	1448	1061	1040	1298	1154	1163	945	1051	902	781	984	915	761	835	746	802	766	1031	900	669	1011	809	652	877	863	790	713	957	646	680	614	715	629	456	684	556	809	687	796	676	623	689	790	587	736	551	793	454	577	602	563	687	514	482	561	683	503	658	693	557	602	540	438	560	428	522	788	463	561	525	501	689	564	682	335	564	607	511	621	305	452	468	500	512	395	486	416	521	428	382	289	589	411	571	518	410	590	532	592	482	404	364	437	562	507	508	435	529	629	370	546	407	494	518	412	444	450	393	277	516	502	542	372	392	392	523	318	346	390	441	412	387	534	284	427	313	447	381	270	381	376	365	349	487	427	396	428	472	372	464	461	432	312	378	450	409	593	409	453	333	313	414	417	376	502	465	408	483	453	346	316	377	404	248	292	339	383	297	395	415	385	296	357	182	433	324	315	323	428	260	383	332	414	177	408	241	434	196	392	435	336	445	409	262	380	331	394	309	626	407	401	438	266	496	328	403	328	382	328	277	335	322	353	285	307	328	355	264	458	453	312	297	276	150	410	228	419	440	286	256	252	342	245	369	258	261	396	198	383	301	265	288	273	271	325	264	312	295	309	376	314	310	343	354	301	232	336	309	288	373	263	432	299	269	201	302	290	340	219	210	247	403	390	609	274	376	170	307	241	250	262	283	182	493	298	264	255	333	267	261	211	291	210	438	200	213	173	232	265	164	370	225	291	330	251	231	312	236	203	222	207	255	421	315	285	235	253	272	405	213	340	241	245	230	259	383	461	234	349	208	195	294	419	450	200	235	324	205	209	244	208	254	268	182	214	252	221	226	165	336	212	207	231	278	251	309	237	199	290	285	291	526	260	243	345	308	180	174	244	300	218	308	282	212	216	109	239	179	211	216	163	341	262	321	235	246	175	201	166	321	274	260	220	206	331	186	170	209	240	202	219	336	245	168	190	285	164	244	236	174	185	201	169	162	246	201	207	174	123	192	214	219	182	246	110	221	205	150	139	292	145	147	84	167	204	250	284	239	165	168	276	143	165	141	122	158	194	137	138	195	155	302	198	123	167	271	139	287	149	153	95	147	147	167	227	130	360	159	219	217	231	155	227	149	324	231	214	205	104	142	201	140	187	121	154	189	172	164	174	156	189	155	165	191	155	208	184	225	174	211	140	183	163	233	116	173	177	147	171	205	139	143	295	184	175	115	217	127	155	185	185	174	123	223	138	133	70	128	172	193	186	94	180	184	103	174	163	218	192	146	162	115	158	226	112	192	155	177	141	126	211	108	148	165	188	206	207	174	99	90	194	248	105	129	94	174	129	146	216	238	114	180	176	127	227	129	169	159	84	169	206	94	155	117	117	159	185	111	157	110	139	163	103	217	130	176	177	84	174	116	206	177	182	149	228	105	177	190	136	131	142	120	183	140	194	132	246	113	80	119	143	126	81	131	135	127	110	118	152	218	138	143	122	193	181	159	128	156	148	138	98	144	208	130	97	129	109	112	113	111	129	110	90	144	152	136	86	124	155	73	160	166	108	92	118	73	111	198	96	103	129	159	119	107	97	96	108	130	142	145	313	102	150	126	120	116	93	154	108	91	197	87	106	129	119	117	101	112	78	90	140	153	159	110	186	154	126	100	178	137	88	129	133	95	81	102	103	106	112	143	149	142	96	98	107	106	135	84	125	91	68	72	143	171	99	112	122	177	77	98	86	93	77	164	80	124	79	46	74	93	144	75	106	128	99	93	117	77	77	152	142	101	93	79	93	77	129	99	104	167	112	84	108	65	188	100	118	53	82	67	133	121	103	52	132	102	40	105	119	72	92	73	72	72	47	123	90	85	81	129	30	87	86	40	75	121	90	85	258	86	70	81	80	47	153	96	62	124	64	85	66	96	97	136	66	118	50	39	66	86	324	116	119	108	67	83	172	86	69	160	98	155	94	122	111	126	94	70	121	57	98	88	90	137	129	62	56	97	124	68	99	70	101	126	140	82	92	98	156	43	100	78	107	60	96	90	80	117	70	112	69	100	69	173	120	117	143	78	64	105	66	60	95	67	68	49	36	79	83	126	81	75	58	45	68	76	82	81	128	82	326	52	85	83	59	68	58	40	79	85	89	65	86	49	93	81	88	82	57	111	71	144	97	93	74	103	101	62	92	120	39	73	63	60	77	77	77	49	100	64	98	112	84	63	53	62	56	54	136	71	117	75	40	60	43	50	91	111	83	30	53	51	51	71	60	61	57	52	61	48	81	75	62	55	37	82	104	95	60	36	76	62	67	115	47	54	44	53	92	123	117	103	65	40	95	35	84	27	96	56	61	58	78	65	58	69	36	83	42	54	94	61	67	63	96	62	54	68	65	45	65	40	118	86	100	53	55	68	38	40	74	61	48	78	83	79	73	62	71	42	53	96	54	69	67	50	109	72	42	49	53	73	46	33	50	57	41	58	59	101	29	44	62	79	62	69	59	52	56	55	42	55	59	26	44	68	96	126	108	26	56	63	45	49	86	88	68	42	82	83	58	248	78	40	80	31	61	38	44	58	45	71	44	43	48	28	54	60	52	60	59	64	48	47	64	46	45	44	44	52	34	64	96	59	70	41	99	51	80	45	48	57	43	44	62	34	53	18	22	52	45	38	54	45	49	87	40	65	38	40	65	55	55	43	37	57	37	45	35	35	49	74	52	49	84	74	42	43	66	77	66	38	83	40	59	49	30	45	44	35	84	16	60	41	33	47	58	39	18	38	38	35	49	90	32	24	59	37	60	60	59	68	60	41	64	46	91	51	42	99	90	103	19	34	46	24	31	53	55	33	37	40	23	39	57	37	81	40	43	22	87	34	32	41	46	45	30	64	49	67	44	18	19	29	109	41	60	52	21	56	39	45	50	44	45	58	68	57	75	13	66	48	36	42	40	53	28	31	32	74	25	38	56	51	41	28	39	42	36	38	55	124	53	27	23	37	48	52	19	30	39	48	27	45	21	29	20	39	24	60	22	34	53	31	33	35	29	26	50	59	37	38	30	54	41	36	30	34	34	56	32	52	34	69	79	53	40	11	20	34	39	49	34	28	20	46	38	34	36	48	32	53	30	23	32	39	47	38	31	48	29	79	24	21	24	45	61	39	39	41	35	30	36	24	26	31	26	13	30	50	28	22	48	17	47	11	50	60	47	37	37	31	43	21	43	60	26	34	31	11	29	37	22	30	26	60	11	39	32	20	28	45	39	28	18	28	28	28	36	23	18	32	18	18	31	27	24	16	44	34	37	14	22	27	30	28	35	31	36	33	24	23	62	6	25	19	22	17	20	31	14	20	39	12	40	19	44	13	16	44	15	24	24	16	19	61	31	22	13	40	12	29	30	50	14	19	20	20	12	27	22	23	23	19	23	18	38	26	38	17	23	31	21	29	18	21	41	29	16	15	22	18	13	31	10	53	18	38	18	19	21	28	68	34	18	36	27	20	19	36	55	43	21	25	17	23	37	46	19	31	21	24	16	20	27	12	11	13	21	7	17	10	11	20	35	19	18	16	27	26	24	17	32	15	13	29	34	18	31	10	17	17	10	20	17	17	15	18	9	18	23	16	10	11	32	11	12	9	12	12	19	16	16	11	12	14	13	10	6	3	23	17	7	15	22	23	9	15	28	32	28	9	15	9	17	20	19	20	19	9	3	9	10	6	9	10	33	10	15	11	9	10	19	34	16	2	9	11	7	14	24	8	7	14	9	6	7	3	31	15	12	17	12	19	30	21	14	17	5	20	4	6	14	10	24	5	28	18	16	6	4	4	39	13	21	5	3	10	10	7	15	10	10	5	3	13	8	4	12	8	6	4	12	17	7	6	9	13	10	4	25	12	26	9	8	8	6	1	12	9	12	8	8	6	6	10	11	6	4	7	5	2	7	9	14	2	3	7	6	10	2	4	9	6	7	2	4	6	7	4	9	7	3	2	8	3	2	3	1	5	1	5	11	3	1	1	2	8	2	2	8	0	2	3	1	2	14	3	1	3	3	1	5	6	2	2	7	2	1	5	1	0	4	2	8	2	3	0	0	2	1	2	0	3	4	2	3	1	2	0	0	0	0	2	1	0	3	0	0	5	2	0	0	0	0	0	0	7	1
ne0095	8215	6021	3963	4918	3982	4426	3974	3630	2931	2911	2574	3222	2757	2656	2484	2457	2591	2375	3247	2509	2270	2845	2392	2260	1997	1698	1747	2328	2485	1770	1535	2246	1974	2200	1642	1716	1714	1616	1779	1788	1980	2002	2077	2014	1826	1548	1818	2075	1720	1392	2081	1593	1333	1546	2192	1621	1548	1602	1782	1458	1559	1620	1360	1556	1489	2054	1442	1716	1557	1368	1311	1429	1629	1308	1663	1411	1174	1315	1850	1650	1620	1787	1392	1642	1091	1286	1880	1333	1416	1506	1270	1362	1189	1176	1308	1160	1451	1037	2204	1740	1242	1310	1401	1299	1202	1396	1338	1154	1752	1695	1399	1438	1151	1162	1130	1205	1126	1114	1154	1353	1141	1447	975	1416	1478	937	1356	1064	1093	1058	984	1468	817	848	1066	788	1485	1089	1257	1277	1029	1275	1457	1128	718	1001	820	836	1216	1252	1255	1099	1229	1149	1099	1001	1077	1034	1061	984	928	931	924	817	1147	947	958	991	513	1065	1092	973	919	930	988	1003	1049	890	813	848	782	934	903	1153	917	846	899	911	996	1021	1003	919	1249	842	777	1146	966	900	879	1030	855	885	1236	990	1015	1203	1069	1086	965	1149	847	949	1235	1281	903	761	897	839	802	857	736	763	1051	1114	815	850	1150	662	904	860	749	990	843	974	1046	735	470	939	802	733	771	746	1026	639	734	811	678	757	954	671	765	699	823	728	590	750	694	764	804	807	845	657	853	837	627	627	1085	629	790	794	723	600	871	721	627	562	1042	706	778	768	732	797	838	740	589	671	772	654	490	796	832	991	688	753	549	736	730	619	983	691	723	595	669	883	885	547	742	548	867	752	483	591	625	529	693	683	762	561	728	533	581	619	695	491	752	698	785	653	848	551	896	870	759	563	918	891	688	502	545	674	729	781	372	513	728	707	760	750	519	605	581	855	704	601	654	816	592	824	639	780	531	629	717	528	482	835	690	636	656	892	643	468	663	733	556	476	776	840	587	532	558	580	743	633	465	477	629	483	550	551	529	421	616	613	533	722	580	591	545	652	594	777	659	656	715	514	558	374	635	565	608	471	573	700	739	642	604	467	577	736	481	455	410	497	607	352	806	671	528	644	625	403	642	511	453	665	319	568	691	476	537	263	618	761	427	382	354	561	495	685	357	486	619	558	534	525	582	520	398	517	698	717	389	362	480	416	439	352	553	641	366	536	534	461	380	617	617	419	479	720	437	367	389	511	439	438	619	457	512	448	409	511	472	318	476	355	529	460	455	369	525	328	773	631	469	423	433	590	587	579	536	263	616	467	325	446	438	527	494	472	375	407	402	351	436	346	498	401	364	623	425	436	406	309	246	469	530	487	405	452	463	458	349	402	416	607	272	391	412	428	354	493	521	451	371	341	509	394	581	314	453	219	500	435	462	648	363	395	477	355	372	508	397	417	419	452	741	550	306	250	396	374	366	361	510	253	386	413	437	423	436	453	338	330	345	291	846	333	406	378	465	463	277	247	256	256	326	269	314	182	273	278	347	418	329	407	300	325	324	333	308	301	363	371	296	382	348	322	254	488	460	364	407	345	337	415	512	459	391	478	301	535	263	377	193	378	158	332	313	394	312	448	418	316	243	378	407	476	318	352	307	324	332	382	233	285	534	394	246	366	130	275	583	500	249	547	258	314	490	384	246	426	435	256	170	755	221	282	226	275	362	304	254	287	414	348	382	289	439	195	287	283	255	320	395	347	183	241	293	412	212	331	261	254	372	273	353	221	327	306	372	246	512	277	517	279	382	193	226	413	269	246	183	147	331	157	338	444	252	472	309	352	348	268	311	328	391	439	249	316	204	217	281	509	336	235	273	282	272	308	455	492	359	288	222	179	350	210	420	385	446	241	231	449	289	328	398	119	422	230	179	316	168	347	454	208	727	325	305	466	423	469	504	198	182	290	340	253	350	173	247	280	335	269	336	319	186	301	252	318	142	183	233	259	138	241	202	259	237	169	363	178	206	366	361	159	176	154	195	273	97	353	183	136	217	278	294	281	221	197	379	338	421	229	182	171	257	337	222	157	175	369	411	135	174	233	284	209	184	157	188	167	262	179	408	165	192	553	145	151	270	166	256	198	167	182	335	290	235	336	264	292	309	260	389	150	168	187	472	261	207	194	222	204	177	247	331	177	341	361	164	221	180	371	269	252	175	327	397	259	159	216	159	167	159	180	147	262	225	280	118	240	244	314	199	210	236	123	174	130	217	255	221	126	210	167	153	182	285	195	251	245	131	245	98	198	201	100	153	203	228	171	328	476	277	130	93	91	260	268	244	104	228	192	336	207	227	211	230	73	197	187	172	236	160	220	242	177	135	111	136	211	254	168	272	233	327	200	115	140	176	236	139	99	180	180	109	199	155	236	190	190	126	126	182	221	207	166	174	417	339	124	174	132	179	215	91	203	157	210	201	245	128	209	298	249	388	184	151	168	332	116	172	217	191	252	211	72	114	221	115	206	137	269	154	70	167	179	111	298	348	141	158	112	178	286	198	190	96	160	157	266	149	160	319	124	144	177	175	141	134	95	137	118	127	179	150	168	168	222	115	178	222	309	103	128	278	216	193	108	117	158	156	174	248	159	126	84	164	92	121	124	83	154	98	151	173	176	184	151	262	181	118	88	305	202	230	110	110	127	120	131	187	172	79	279	228	213	139	99	185	246	218	165	261	79	168	157	145	97	97	117	82	180	143	166	123	211	184	114	153	267	157	102	205	198	219	167	226	219	98	136	122	107	390	213	39	139	228	129	82	140	140	120	173	97	113	161	67	104	234	109	145	114	97	111	127	96	103	188	170	125	119	147	100	80	122	164	178	218	257	85	180	75	287	84	153	78	135	235	143	136	87	306	141	172	83	207	91	175	104	127	185	72	138	88	100	159	108	137	67	127	70	119	115	98	107	143	207	67	243	108	201	117	168	85	73	137	313	132	192	110	166	105	97	173	133	139	107	119	121	57	130	220	46	231	119	143	77	87	74	111	134	64	53	223	168	71	89	90	124	52	78	137	84	50	122	92	85	136	240	79	72	45	93	373	143	79	81	78	72	83	74	121	119	91	96	59	69	113	149	66	261	188	95	207	63	46	118	57	94	98	94	229	105	122	69	71	102	23	78	63	79	59	132	174	157	125	95	124	80	95	123	90	107	99	81	68	68	163	64	55	131	149	142	72	95	98	97	175	86	61	124	124	60	119	102	93	106	60	79	74	82	139	108	57	96	72	67	83	89	44	67	57	127	90	110	114	81	122	59	166	104	86	125	105	98	78	120	93	55	71	61	35	98	107	50	93	72	50	128	31	81	75	83	72	51	53	54	137	84	169	79	104	68	148	35	73	59	82	128	99	60	100	64	73	64	61	69	70	40	80	146	49	94	40	63	82	30	217	146	108	66	56	49	140	84	114	70	76	85	110	151	56	36	98	115	34	51	60	103	70	149	52	64	76	64	48	33	58	76	52	54	48	31	73	67	46	46	79	18	86	40	140	11	114	45	32	85	24	38	52	50	57	78	65	43	220	15	58	76	41	156	114	33	41	94	74	67	31	60	92	75	50	92	35	26	65	63	98	71	96	55	90	34	43	24	66	71	91	70	73	92	33	185	49	37	38	28	106	16	28	95	57	54	43	43	21	11	49	177	60	52	77	43	23	50	48	78	38	45	56	23	66	130	62	51	17	84	31	28	29	49	26	53	35	32	42	60	70	40	82	19	115	36	33	73	44	37	66	36	76	51	43	32	17	35	38	36	28	31	42	33	30	71	62	46	40	27	29	51	36	42	22	23	58	168	29	174	28	47	50	36	21	45	48	66	26	29	29	38	11	15	37	21	41	17	49	22	52	9	8	26	55	54	39	16	137	9	22	61	42	37	16	29	22	14	2	61	69	33	88	28	30	12	28	47	7	16	14	9	27	87	33	15	46	15	20	39	35	34	21	19	13	26	17	31	10	7	44	42	18	26	13	13	26	14	27	15	23	15	12	14	19	5	7	17	28	18	22	6	8	11	25	2	11	14	12	73	18	44	79	5	47	41	23	6	46	4	11	16	1	4	9	8	4	11	13	36	5	14	5	6	16	11	11	11	5	6	14	27	30	7	2	36	10	26	3	3	9	4	8	7	7	19	13	2	7	32	14	99	12	11	14	22	1	11	12	2	5	48	126	6	4	1	10	1	0	1	7	8	4	1	2	1	2	1	4	2	1	4	0	1	0	0	3	0	0	4	1	28	6	0	2	2	0	2	0
ne0098	2864	2586	1406	1644	1846	1406	1170	1133	1079	1179	1151	966	855	1048	697	1025	848	885	1085	824	733	845	871	850	848	639	642	811	746	565	670	660	622	644	579	707	584	618	565	523	683	549	649	634	565	560	666	695	564	539	638	457	557	630	764	518	513	500	452	530	518	503	715	538	541	451	529	512	479	545	611	631	548	422	662	550	465	521	451	504	472	444	540	466	515	492	591	405	719	423	395	481	427	409	492	463	452	562	388	409	389	427	391	522	379	382	409	406	461	724	385	478	540	425	450	634	409	389	362	460	434	438	410	371	463	270	377	427	423	417	367	444	376	328	362	368	344	385	419	376	349	384	509	389	329	299	295	340	295	302	324	384	301	494	314	337	366	361	403	267	370	337	324	316	405	354	385	277	375	333	337	314	291	300	348	277	265	355	291	333	230	253	331	344	322	324	290	312	332	379	395	322	465	315	290	383	300	364	287	289	349	314	291	366	275	300	299	331	318	265	337	207	251	398	319	191	322	240	290	260	300	275	247	270	224	192	298	266	316	292	230	269	318	275	255	203	280	334	238	261	145	336	340	162	302	272	217	294	277	301	339	320	309	275	396	302	305	240	297	295	287	221	270	260	338	293	332	226	358	228	249	210	293	253	168	278	411	248	225	368	264	317	326	178	265	137	224	242	302	288	236	319	223	230	262	276	239	247	213	222	253	168	271	219	215	300	247	139	310	236	261	285	222	252	209	272	220	119	219	219	197	202	211	160	194	214	206	254	253	235	275	245	271	275	214	244	228	191	205	225	344	188	227	139	325	191	209	195	218	236	228	224	188	241	223	225	210	250	187	261	191	186	248	197	169	281	241	197	262	178	222	296	210	216	201	111	206	187	216	223	308	248	230	213	130	158	211	162	209	202	158	186	162	140	170	222	163	225	175	206	262	121	266	261	180	215	157	234	171	158	249	228	196	186	165	221	256	144	150	263	230	191	178	144	204	168	203	139	161	216	198	170	207	198	233	223	190	150	185	167	176	139	184	171	153	177	203	191	167	208	140	134	317	152	153	180	188	153	215	227	174	252	136	206	194	195	150	162	182	155	203	197	154	179	160	157	168	199	208	259	161	168	183	164	178	135	128	125	156	108	122	139	161	141	194	143	128	132	189	238	195	174	165	198	189	145	168	176	165	154	160	120	141	232	182	134	151	141	189	173	164	197	148	200	150	129	134	122	165	162	156	128	130	101	164	158	212	181	171	105	182	163	159	153	183	170	127	127	144	176	175	124	134	151	138	147	165	180	295	150	144	109	185	178	170	182	135	168	150	135	125	159	114	176	133	139	125	143	109	146	103	135	154	142	95	126	133	119	199	129	143	89	136	110	200	204	103	144	220	196	101	108	126	116	125	165	133	166	163	104	106	163	122	97	130	178	151	132	154	96	81	118	123	121	108	147	118	122	103	152	100	156	124	80	105	110	140	122	134	123	125	208	50	113	125	132	100	90	96	134	125	160	123	154	146	117	137	132	114	95	99	109	133	133	94	83	133	128	50	116	227	199	128	125	124	94	111	131	85	115	133	125	78	89	83	98	82	75	97	165	173	110	88	133	96	128	129	116	150	113	139	126	77	154	112	93	77	120	84	124	92	77	119	137	105	103	140	127	109	90	98	106	108	103	111	119	76	89	111	121	54	132	116	95	111	95	82	84	71	104	136	122	141	70	104	108	112	104	117	112	72	98	131	93	85	81	75	144	60	82	157	101	71	78	109	86	75	88	126	157	154	94	162	125	131	87	83	107	85	111	76	92	90	93	101	161	184	112	117	85	105	128	65	83	92	117	76	67	82	72	74	119	83	122	88	84	67	43	115	96	57	64	79	161	136	103	124	116	80	62	111	66	63	100	126	60	64	102	135	74	109	75	63	92	163	86	100	78	103	62	91	82	108	86	83	76	64	75	89	55	65	128	106	63	106	83	58	68	93	68	73	65	108	91	68	96	78	93	112	73	72	59	40	63	48	78	78	79	116	81	73	68	75	52	94	64	55	60	93	75	68	70	99	63	46	87	81	78	85	80	90	110	77	80	93	89	57	52	204	54	100	72	36	43	51	113	104	75	80	99	62	53	123	77	82	80	76	56	75	73	84	75	92	56	88	73	57	71	110	37	113	46	88	76	77	91	61	80	87	72	50	73	68	52	76	76	56	48	71	94	65	74	46	37	55	45	52	83	102	46	51	157	33	82	65	77	105	76	64	51	59	44	74	57	55	48	66	174	57	66	84	32	51	87	59	40	65	67	58	36	112	64	74	65	77	54	86	80	44	61	61	55	57	74	64	72	99	72	56	61	67	78	56	42	72	45	66	31	66	67	68	67	29	64	96	56	65	62	50	45	70	86	43	144	62	51	49	68	61	52	68	49	44	69	93	80	66	62	56	67	44	83	64	43	47	72	128	60	94	54	48	74	30	78	126	41	51	73	62	52	65	74	49	73	73	56	64	38	54	37	41	74	68	77	51	58	83	60	74	45	55	75	56	64	59	39	56	36	57	61	32	66	54	24	83	94	65	47	82	68	34	42	94	65	29	59	56	74	33	48	84	50	54	29	46	74	65	84	103	62	21	38	75	29	60	81	65	45	78	75	59	102	65	58	77	79	49	57	37	46	59	65	43	54	116	57	36	100	87	45	57	40	62	67	42	42	47	65	52	51	113	38	71	40	72	55	66	45	74	32	45	49	32	31	40	37	35	59	33	32	53	59	48	59	70	40	46	59	38	45	45	28	43	97	66	62	78	37	57	29	23	75	39	63	47	53	52	59	38	51	74	23	47	35	45	28	40	36	43	57	30	75	56	47	45	44	31	50	53	30	91	39	31	37	42	30	51	55	58	48	44	35	52	104	31	71	29	51	44	62	21	41	35	50	60	34	49	34	49	44	54	34	33	30	38	81	31	48	50	35	50	92	21	32	16	177	43	32	39	38	59	40	39	34	55	52	51	29	41	40	36	39	33	92	37	32	45	42	30	32	44	34	44	33	44	48	54	65	28	46	46	47	28	74	39	56	45	180	33	34	25	35	99	38	23	37	28	26	43	72	49	31	21	39	44	39	120	49	22	48	33	31	31	26	17	22	26	40	44	31	26	5	35	32	29	32	26	27	27	50	39	48	31	42	58	22	28	60	28	32	10	18	32	16	50	44	17	23	70	43	24	28	16	32	59	28	26	56	28	29	74	27	27	31	38	35	29	29	37	37	31	13	34	61	42	34	17	25	41	55	35	28	26	11	19	46	22	16	26	26	40	66	19	16	29	30	25	20	41	46	73	37	20	40	44	48	24	25	47	37	32	31	74	42	21	22	36	17	27	20	8	22	37	18	26	21	24	36	26	31	21	28	21	27	21	14	12	29	27	19	33	33	28	43	63	18	12	35	5	16	32	27	13	17	33	23	30	63	43	18	17	27	10	30	16	22	9	19	19	19	32	19	16	17	15	37	28	7	7	31	11	11	24	31	32	24	19	52	20	8	27	50	36	25	18	35	32	34	16	19	28	14	22	22	21	24	8	39	15	27	29	13	24	14	20	13	12	11	78	12	24	9	16	17	20	14	22	14	28	19	24	12	16	29	16	20	7	36	22	16	19	17	37	27	43	23	17	11	23	17	10	15	12	32	9	9	40	24	3	14	12	30	10	24	16	8	24	29	8	30	16	29	16	13	15	6	23	10	13	19	11	51	4	12	25	19	14	30	4	20	18	5	17	23	24	13	20	8	8	8	21	7	11	16	18	5	13	17	20	10	9	14	16	25	15	11	8	44	11	17	14	45	9	32	13	23	9	10	37	19	16	7	18	15	14	19	20	1	44	11	16	3	12	9	12	6	8	10	24	8	17	7	4	18	10	8	13	9	27	7	5	10	4	13	7	10	22	6	14	1	9	12	9	13	4	4	4	1	51	5	4	21	6	18	5	26	13	7	20	2	18	6	5	9	9	1	3	5	5	5	3	5	7	10	2	8	3	3	10	5	8	15	20	5	17	11	10	15	0	3	1	14	5	4	9	4	1	3	3	4	32	3	7	8	1	4	12	1	7	11	43	22	4	5	5	4	0	0	3	1	2	3	2	2	4	1	1	3	1	0	0	1	0	2	0	0	0	13	0	5	3	1	0	8	0	0	0	0
ne0099	1300	1099	647	469	640	568	489	436	339	468	422	398	328	301	274	413	353	349	407	351	267	306	368	319	347	248	284	276	330	249	344	259	242	235	246	268	226	224	237	137	238	242	223	194	229	184	246	201	255	231	254	228	194	206	211	209	274	243	167	206	225	257	290	164	229	157	206	216	224	240	268	249	223	154	244	238	207	158	161	235	161	172	245	240	241	191	188	189	289	165	167	192	184	131	184	169	189	138	156	164	116	199	168	211	138	170	128	183	137	180	144	128	186	163	181	178	179	149	152	191	143	185	231	118	180	122	133	148	182	179	162	151	124	167	127	182	113	175	170	136	137	151	130	138	212	87	179	109	80	134	146	126	110	128	136	112	135	158	155	166	137	144	144	97	190	130	132	74	162	112	103	114	121	96	132	163	145	144	158	145	87	106	109	94	148	105	137	148	111	138	122	103	117	123	102	144	111	158	79	70	111	170	103	110	133	108	158	90	153	74	133	95	148	142	100	77	136	141	161	127	150	112	132	95	93	116	154	172	91	108	159	81	114	114	94	122	135	131	136	118	82	128	152	101	84	95	57	122	95	119	129	134	130	151	163	124	275	97	119	104	143	95	135	89	90	103	83	129	133	94	95	106	90	92	91	97	107	95	103	109	122	130	108	68	94	79	112	115	133	131	120	88	130	104	92	103	126	84	85	89	109	131	64	113	61	94	57	65	65	126	111	120	118	83	134	83	67	93	52	101	76	107	81	89	76	104	75	93	95	84	106	79	85	32	60	67	83	48	75	94	105	65	93	69	82	87	95	63	144	125	90	113	117	87	87	68	97	109	95	80	64	92	112	100	126	78	75	107	58	66	68	129	115	67	82	53	55	79	64	69	79	79	90	74	75	100	72	88	78	79	43	92	82	38	52	85	72	75	48	56	104	41	73	44	80	63	61	106	45	73	107	100	80	55	58	48	94	83	55	52	74	60	51	57	69	41	59	83	52	58	97	103	77	66	83	77	71	54	79	60	84	42	92	60	85	71	38	68	78	41	54	25	86	70	73	83	90	86	75	71	94	45	75	83	87	71	75	92	66	69	105	57	58	87	56	97	64	90	74	41	77	71	64	53	68	36	55	51	82	55	56	72	58	74	102	54	41	57	70	80	83	65	53	93	77	39	54	50	78	36	52	60	31	71	87	68	48	32	59	46	61	57	85	157	66	47	58	53	56	57	59	50	56	40	89	64	78	61	88	42	63	57	66	82	101	85	99	85	65	59	66	40	35	48	55	51	81	54	40	77	57	48	60	49	49	68	50	46	50	55	31	30	53	55	57	80	52	30	52	76	63	88	61	78	42	23	36	66	40	57	69	57	83	68	31	42	32	79	48	82	28	57	54	59	65	38	40	132	81	112	64	98	71	42	53	55	54	49	53	66	49	62	48	34	41	27	54	53	38	51	38	45	48	57	40	64	48	65	54	36	44	47	45	60	68	67	97	46	58	31	62	80	60	50	41	73	55	69	41	30	37	25	45	35	42	39	44	35	42	52	47	71	21	74	47	45	60	51	36	52	49	36	54	34	39	31	36	31	22	60	44	39	34	74	29	58	49	55	33	41	29	41	42	50	36	33	34	28	45	38	43	48	51	25	50	50	53	50	35	56	65	42	34	59	37	41	32	52	38	40	43	42	29	32	45	47	63	23	32	47	38	62	53	53	57	29	27	51	47	36	37	48	32	24	41	43	23	38	19	36	37	33	32	38	40	49	31	44	30	49	82	24	61	21	67	45	32	48	21	51	34	42	30	21	35	43	81	48	44	42	39	49	16	33	30	45	23	25	26	41	32	33	44	18	51	39	34	35	34	36	53	27	37	79	69	31	47	24	35	36	30	16	32	23	31	52	30	33	54	28	48	34	50	51	51	43	51	33	56	31	44	30	62	25	65	70	26	37	28	36	36	29	41	37	35	19	29	39	45	32	19	18	41	42	14	36	39	32	28	42	34	35	74	24	28	31	31	32	38	31	33	30	23	27	30	22	36	51	22	61	29	29	23	23	41	32	30	33	41	32	51	20	36	38	43	34	25	14	23	22	34	29	20	15	47	65	60	39	35	30	31	30	50	27	28	20	27	28	25	34	52	25	38	22	29	32	43	51	27	21	28	23	40	18	34	30	47	55	20	16	39	38	62	29	30	31	29	22	25	27	31	39	20	38	25	29	28	29	41	10	26	31	10	44	27	42	32	24	40	14	16	27	21	20	23	12	26	21	40	86	21	31	23	37	34	30	18	28	22	18	16	10	25	24	40	23	30	30	29	14	29	18	29	17	22	23	43	50	27	27	43	17	29	22	27	29	41	31	24	53	27	48	9	19	35	26	17	43	38	27	47	19	18	22	41	24	21	38	31	11	21	25	27	20	28	28	22	25	10	36	16	29	65	9	33	34	51	31	17	15	11	38	33	29	38	21	27	21	38	13	38	46	18	20	37	24	32	21	14	18	39	24	22	40	11	23	29	19	21	25	32	30	27	15	16	14	25	19	29	12	24	25	27	10	29	42	25	17	34	15	47	13	20	21	36	19	22	22	18	28	16	35	9	9	28	27	41	29	19	26	43	12	13	9	33	20	20	20	21	29	26	27	38	21	21	18	26	25	10	15	10	23	27	20	24	81	35	21	19	27	15	21	20	39	21	26	19	21	16	17	20	22	29	6	21	30	18	42	68	18	11	16	11	12	12	21	23	13	11	13	17	20	19	15	39	7	8	20	12	20	29	11	29	16	9	17	40	5	22	8	19	31	15	7	51	17	18	35	22	8	16	17	34	29	15	8	8	11	24	23	6	15	15	24	7	32	9	30	23	8	21	40	20	12	18	16	22	14	16	13	8	26	16	17	11	19	8	17	30	24	6	8	17	30	16	9	24	10	21	13	27	57	35	5	13	38	11	19	17	5	23	50	8	57	10	17	13	24	17	30	16	30	15	21	12	25	24	21	35	13	10	10	5	7	35	29	21	15	5	21	14	14	7	17	24	14	26	20	12	28	14	20	21	10	19	20	18	18	14	8	14	18	12	12	11	11	13	16	9	10	10	16	10	19	21	12	9	20	15	17	19	11	9	2	8	10	13	22	16	4	7	8	7	9	20	9	6	8	16	27	22	18	32	13	19	6	13	23	6	10	32	3	12	5	14	7	2	13	14	16	7	9	10	39	17	21	1	11	5	11	12	15	7	22	15	2	9	11	21	6	9	12	18	3	31	22	7	7	33	10	8	8	16	7	25	12	18	14	14	10	11	23	8	10	11	7	16	11	46	36	10	8	9	7	10	17	6	6	6	11	12	15	43	4	6	4	12	12	9	7	4	25	7	12	18	7	11	7	7	11	14	21	25	22	16	21	20	9	23	4	14	15	16	4	14	4	22	5	2	22	9	16	6	7	7	13	14	7	8	8	4	15	22	23	10	16	11	10	1	10	23	17	6	5	23	5	8	7	15	12	9	2	12	7	14	33	12	19	14	8	11	5	8	12	13	12	4	10	9	10	14	10	12	3	23	8	3	20	6	3	7	7	9	5	8	6	5	15	5	3	13	5	10	7	18	23	4	20	9	2	4	12	2	9	4	12	1	5	6	8	3	23	2	1	21	11	6	9	9	1	7	0	5	12	6	11	7	12	1	9	2	10	5	0	4	2	6	15	8	10	3	8	12	1	8	1	2	4	11	9	3	3	0	2	11	11	2	7	5	8	6	6	2	7	5	10	1	4	3	7	4	6	8	13	6	1	9	4	5	3	7	4	6	9	1	2	7	1	4	4	10	6	2	6	11	1	5	2	5	6	1	4	5	2	3	6	2	1	2	3	5	8	4	5	5	6	2	3	3	2	3	4	7	0	7	6	3	1	2	6	8	2	2	2	7	4	4	1	20	2	8	5	6	10	0	0	1	4	3	7	0	42	3	7	0	7	1	1	4	0	3	0	3	4	1	4	2	3	3	0	1	12	0	2	3	3	1	1	2	2	1	1	5	1	0	2	3	0	2	1	2	0	1	6	6	3	0	2	5	2	2	0	2	1	0	0	0	1	3	2	4	2	3	0	3	7	0	1	0	0	1	0	0	0	5	2	0	1	1	0	0	0	0	0	0	0	0	0	0	0	3	0	3	2	0	0	0	0
ne0101	1225	1431	762	772	546	679	663	625	487	542	507	490	525	446	505	406	461	388	446	436	358	445	364	339	384	363	402	436	452	470	315	331	342	365	390	343	395	311	303	385	368	359	338	276	332	283	247	417	444	341	273	305	231	250	242	370	255	256	285	233	287	254	319	238	260	264	306	256	241	264	260	249	300	274	297	322	262	232	217	217	295	257	196	241	241	185	194	230	247	234	279	239	212	247	166	209	203	188	248	196	221	299	224	207	238	215	213	218	267	204	231	180	213	212	170	241	181	228	187	188	175	167	186	206	192	233	216	138	163	205	208	209	163	191	200	184	163	146	154	183	193	229	169	185	205	273	224	178	187	244	199	134	211	169	222	157	235	150	158	217	185	157	184	185	192	162	172	148	151	191	266	163	224	198	147	148	197	169	168	145	221	259	164	141	161	175	141	250	179	176	107	225	179	155	135	208	163	146	141	144	172	130	145	214	110	233	123	182	222	156	141	183	150	176	197	151	134	150	220	157	205	168	180	152	228	164	111	197	157	156	169	138	132	126	193	188	153	143	136	140	168	124	160	135	93	127	186	104	151	185	97	152	151	107	163	119	125	162	137	128	135	128	106	159	152	167	193	137	124	128	127	127	183	107	142	121	88	172	174	134	102	140	123	104	121	78	164	139	160	132	130	157	99	154	182	111	136	122	140	126	133	164	113	162	118	122	113	138	112	107	112	106	103	122	98	85	105	93	125	146	120	167	102	117	112	135	146	119	118	90	123	173	141	221	130	113	141	129	147	109	100	101	178	128	147	99	102	141	103	79	107	95	104	153	105	151	89	94	118	85	105	76	134	97	135	99	132	144	145	100	96	104	120	100	110	82	87	95	131	95	91	112	91	151	163	105	64	115	100	111	103	140	107	112	111	83	96	111	98	90	127	101	134	145	127	105	80	92	109	115	92	75	111	128	74	58	95	109	103	108	85	89	101	159	104	113	96	110	105	112	101	94	69	129	82	127	106	122	122	92	99	86	93	94	128	86	110	51	111	104	98	113	83	70	104	75	77	85	122	114	81	81	94	86	85	81	73	75	77	97	78	126	99	70	103	113	84	75	74	98	74	96	97	85	79	71	70	102	105	137	70	83	93	71	70	68	72	74	72	93	43	97	115	79	114	79	81	92	125	103	84	125	87	60	82	76	77	56	84	70	73	66	98	97	93	85	96	113	118	88	105	116	107	55	120	78	80	93	63	110	80	110	95	71	81	126	90	108	64	114	83	82	74	59	85	115	98	68	77	47	81	103	107	38	64	68	60	71	109	69	58	51	58	86	54	55	93	62	63	98	76	61	32	69	98	66	72	82	71	95	52	63	65	63	67	92	93	66	89	82	114	60	67	143	63	85	72	45	60	80	45	107	74	64	96	46	72	67	78	64	48	64	65	100	95	76	62	120	86	62	46	55	44	55	51	72	40	78	63	74	82	121	65	74	53	52	93	77	74	47	59	56	54	67	48	83	68	55	80	39	93	97	54	41	95	65	56	64	57	89	58	66	58	71	63	49	53	54	56	96	61	64	63	30	71	49	56	44	62	63	43	105	90	54	42	57	57	57	58	53	76	72	53	99	64	104	67	69	59	76	70	54	66	53	55	54	32	61	105	52	56	65	65	41	51	50	46	62	47	60	58	56	88	55	41	57	38	75	60	48	58	62	46	82	60	36	53	47	73	44	48	51	83	65	47	72	72	52	32	39	71	68	57	62	53	55	63	72	77	80	58	42	64	52	41	35	76	86	67	54	53	91	95	73	47	47	47	26	55	51	36	45	71	29	37	70	66	90	48	62	57	63	40	59	35	53	49	31	43	54	34	43	79	58	44	63	39	43	39	31	66	41	38	49	61	66	62	48	62	54	54	37	40	33	61	42	47	58	38	53	36	54	39	47	45	81	41	40	50	49	46	50	57	57	35	44	47	72	40	39	47	41	49	50	50	21	46	30	34	34	38	61	49	61	82	19	50	38	40	47	45	45	37	67	48	48	52	42	38	41	59	41	40	39	47	45	76	28	45	41	63	57	47	49	49	61	72	55	29	51	33	63	40	38	43	36	22	30	60	40	53	46	32	53	43	36	26	60	44	29	36	44	35	33	49	61	38	75	40	54	29	49	40	51	36	36	37	72	32	34	58	37	33	34	28	65	43	46	26	32	47	34	48	52	41	41	40	28	25	23	38	62	52	53	47	30	19	56	47	55	64	43	61	26	28	55	39	44	29	49	44	39	30	24	37	30	38	25	28	48	37	30	34	38	34	35	30	30	29	26	28	42	39	62	33	28	38	31	28	53	32	49	26	29	30	46	25	18	53	32	39	21	44	40	46	19	25	18	75	28	29	35	24	29	20	22	46	43	46	53	40	35	58	34	21	29	49	39	17	28	45	31	37	33	51	79	51	22	41	39	35	41	23	35	17	36	34	25	33	27	30	42	25	45	18	57	36	27	43	34	46	32	32	45	38	32	24	31	15	26	42	34	47	51	25	32	29	28	16	33	30	43	29	52	44	24	26	24	33	56	24	41	53	35	28	39	34	44	24	36	26	23	30	33	26	37	26	30	25	38	50	42	32	31	30	17	25	19	31	20	47	11	21	16	17	35	29	36	30	31	33	26	22	38	17	24	13	34	30	28	22	34	23	40	33	25	22	35	29	28	37	30	47	22	43	20	29	35	38	31	36	32	28	38	45	31	43	47	22	31	53	50	21	36	29	22	47	31	15	30	20	22	28	17	46	28	26	21	22	43	46	22	29	23	15	22	18	41	33	28	27	17	25	23	24	21	20	20	21	20	29	17	38	16	51	15	10	36	17	30	33	23	23	31	28	28	20	18	13	15	34	36	38	22	14	18	18	38	34	18	29	32	25	28	29	33	21	28	16	20	20	24	23	41	26	18	39	14	23	17	22	17	20	30	21	19	20	40	34	19	29	16	14	26	16	15	23	22	29	19	17	14	12	22	15	25	25	12	23	26	9	31	25	22	20	18	20	22	38	40	21	18	19	18	20	13	16	27	17	30	24	18	41	18	28	19	23	13	14	14	16	27	25	18	33	26	10	19	12	28	17	22	19	15	15	19	12	26	14	9	36	18	32	16	17	15	27	23	15	27	15	22	11	17	24	17	28	19	15	21	20	21	17	11	17	8	14	19	13	21	36	15	17	24	30	18	9	25	17	17	14	23	23	19	21	18	24	19	21	14	23	16	17	18	30	17	12	11	31	9	20	25	17	19	14	18	16	13	13	8	14	17	6	17	24	11	10	15	11	16	23	6	15	26	19	12	19	16	20	12	14	15	18	24	14	22	18	10	9	11	8	32	25	18	9	26	9	29	14	7	15	14	21	15	9	14	16	12	11	20	17	18	18	31	18	23	13	12	8	12	18	13	34	14	10	19	18	19	13	20	14	33	7	32	7	12	22	17	16	32	10	13	17	14	10	20	7	17	12	23	6	17	23	14	18	6	19	20	11	14	25	5	14	14	13	13	14	6	21	13	14	12	9	7	11	14	8	9	8	6	10	15	12	10	6	15	10	12	8	6	2	17	9	19	8	25	18	12	14	12	10	4	5	7	12	9	5	15	9	15	9	11	6	6	6	4	8	9	8	20	7	16	2	9	16	10	6	15	5	3	17	26	23	5	8	6	18	9	7	14	8	7	11	4	13	12	9	5	6	13	10	7	4	13	7	14	11	11	15	9	10	15	5	6	10	4	2	5	9	16	19	4	3	1	3	11	8	6	11	11	6	8	18	5	5	7	3	42	7	2	11	6	6	3	6	6	7	3	8	6	3	8	8	3	3	3	9	8	0	14	8	12	6	8	13	5	11	3	3	2	2	5	5	0	7	2	11	6	6	10	9	7	4	4	9	13	2	9	5	4	1	8	5	8	6	2	10	1	2	3	3	6	11	5	5	3	12	3	1	2	1	6	3	6	1	0	7	3	3	3	4	4	7	3	2	2	0	3	3	8	4	2	9	2	2	1	4	6	2	1	4	3	2	1	1	5	5	2	1	3	1	7	6	3	2	2	1	3	2	4	0	3	3	7	2	2	1	1	1	1	2	0	0	1	2	1	1	2	0	0	1	2	3	2	0	0	1	1	3	0	1	0	1	0	0	0	1	0
ne0102	2459	2665	1444	1420	1196	1435	1151	1255	1024	1076	988	949	1109	860	1015	799	868	663	886	1134	726	899	748	715	720	749	806	816	798	891	690	745	633	613	787	651	619	673	553	579	639	711	504	632	577	456	515	775	804	622	531	621	451	490	701	690	514	556	553	414	496	486	557	449	533	578	501	503	490	554	546	511	625	451	543	987	405	518	524	415	491	578	349	410	896	357	475	451	436	542	528	457	394	382	320	517	420	360	447	337	477	481	426	370	429	390	423	320	495	599	468	425	308	381	337	418	340	474	362	311	302	354	417	509	438	438	384	256	286	314	386	398	335	392	427	440	381	300	314	304	298	463	389	319	501	498	343	354	364	413	468	291	418	317	402	335	395	338	264	335	328	387	377	397	402	350	350	322	389	404	457	314	429	400	255	298	373	261	335	295	362	388	260	318	217	367	240	411	295	380	253	364	271	287	251	347	444	220	334	353	368	267	268	333	210	370	271	344	388	316	228	343	368	312	347	349	247	330	380	317	366	216	366	326	394	255	325	385	338	248	321	294	315	289	394	339	381	305	318	271	291	284	274	245	221	257	383	260	260	323	242	207	626	248	273	183	245	301	324	280	268	275	244	330	274	234	363	290	271	297	246	230	342	263	294	323	245	290	345	268	210	289	252	211	265	215	309	256	325	302	295	227	234	320	262	232	272	144	254	197	296	175	235	300	280	311	207	309	268	258	242	212	252	234	285	162	263	580	153	215	241	301	209	250	194	248	258	238	282	180	244	319	309	354	237	240	266	282	265	197	251	236	259	201	288	213	237	239	217	176	236	290	272	230	193	303	234	192	232	168	220	161	416	245	215	183	228	211	270	233	234	209	216	258	181	162	189	188	252	227	139	222	197	215	301	225	171	246	218	169	263	525	231	187	154	194	203	182	158	180	250	199	190	260	281	186	213	204	218	251	225	173	235	203	186	140	176	166	219	251	229	211	267	282	224	213	217	145	222	238	183	139	191	264	162	226	218	201	225	152	212	179	173	160	205	157	175	136	213	161	163	151	257	188	230	187	172	222	189	207	164	151	177	203	208	177	147	112	167	158	104	233	213	154	151	177	164	140	174	155	144	122	192	164	188	173	174	165	204	270	167	124	199	134	173	132	173	127	165	169	108	194	209	391	177	153	163	204	223	203	150	190	160	116	151	146	157	157	181	150	143	166	200	278	180	113	182	200	235	191	187	268	175	106	276	151	483	196	159	219	185	218	172	159	175	185	239	109	145	194	148	186	158	138	179	223	237	140	206	110	161	163	208	113	183	177	109	148	108	99	72	121	97	154	111	142	147	78	115	160	168	130	121	129	191	91	178	180	163	171	156	127	101	146	135	134	151	100	164	172	162	140	145	241	125	175	136	174	158	98	123	161	159	124	156	127	122	118	180	146	80	130	153	210	168	151	130	172	142	105	122	216	150	129	117	176	94	201	112	133	133	156	109	159	114	116	126	126	153	107	113	115	120	103	108	147	165	134	159	120	180	161	100	78	153	114	124	133	89	144	67	138	158	142	138	93	101	158	107	171	172	107	106	95	127	107	124	113	107	129	119	166	108	118	83	134	144	127	143	96	98	151	75	499	168	149	111	100	164	142	123	126	200	110	129	95	97	138	115	96	131	117	120	121	136	96	111	122	94	149	119	111	148	87	124	134	81	105	83	108	123	86	75	119	110	97	68	75	125	100	102	89	137	99	106	71	109	123	114	62	79	153	133	120	96	98	88	115	102	146	75	100	86	133	81	124	140	96	139	90	94	125	117	112	113	103	106	87	118	85	127	130	140	88	116	151	134	137	128	93	98	100	87	81	92	99	66	65	102	119	94	79	145	75	72	89	78	84	82	79	74	75	61	45	112	101	108	52	123	74	69	92	51	70	94	104	97	110	89	88	106	122	92	89	85	42	107	78	125	90	87	127	139	65	71	105	96	105	89	95	80	73	111	75	129	56	89	64	94	115	66	126	97	81	88	55	133	80	77	97	78	84	88	129	93	108	106	110	61	75	109	82	103	86	94	105	144	88	102	107	143	139	76	76	94	81	116	108	57	78	89	100	63	72	87	79	46	83	114	92	94	86	62	110	79	111	108	121	96	92	94	86	93	60	103	92	62	112	76	90	76	77	51	112	75	68	70	121	100	89	104	69	62	69	50	117	50	91	98	77	97	71	115	74	64	74	85	62	64	68	65	102	107	110	71	75	71	117	108	58	105	48	80	91	92	153	89	100	53	95	82	92	51	66	78	71	93	73	56	90	72	62	63	76	73	61	69	72	91	67	99	79	61	140	77	98	85	87	70	76	110	92	94	64	66	71	60	48	84	61	107	38	99	92	91	84	91	73	84	62	65	80	40	58	54	134	98	45	72	126	57	34	98	51	52	67	106	85	44	69	102	48	51	83	116	92	115	42	63	47	53	67	38	51	65	59	61	63	56	69	75	65	60	78	55	91	51	35	74	76	47	80	61	82	78	56	69	57	45	83	83	74	51	81	55	47	44	44	79	71	61	104	79	57	64	52	57	91	94	74	56	63	53	68	53	57	78	103	49	61	48	36	79	59	53	47	51	51	53	86	97	124	66	64	45	58	38	47	72	58	67	47	41	56	50	90	95	54	89	45	55	61	25	71	44	64	37	71	70	68	36	57	49	63	60	83	66	82	59	50	63	68	69	57	74	409	36	63	51	46	62	37	59	82	70	55	58	77	42	77	77	71	44	49	45	37	66	50	49	34	46	45	64	58	84	63	53	39	48	90	71	32	50	23	32	59	46	77	65	59	61	60	46	39	36	32	66	38	44	21	68	60	64	43	33	32	44	50	30	30	76	37	30	45	40	37	33	30	59	37	41	68	38	43	59	40	69	62	56	39	53	55	41	56	60	85	52	50	28	74	28	54	36	63	34	46	43	47	33	55	55	34	39	74	46	55	20	50	61	34	37	32	24	69	31	31	38	54	35	39	59	63	27	29	23	413	71	30	36	32	29	75	62	70	61	47	51	49	71	36	40	44	37	32	37	34	35	25	50	54	24	53	59	55	55	34	42	32	78	37	42	36	28	42	49	48	43	45	30	48	44	46	37	32	44	64	28	34	36	30	57	40	55	26	50	22	39	29	39	51	40	41	36	36	53	37	50	31	43	48	28	45	33	18	43	42	14	44	53	33	74	44	37	44	32	43	46	41	33	50	35	43	26	33	28	34	36	49	46	20	25	26	36	47	35	16	54	39	20	46	18	31	31	25	38	34	40	31	18	24	21	20	22	36	41	29	40	33	7	23	63	21	34	41	20	41	44	34	40	18	29	44	64	29	29	39	45	19	27	31	27	34	45	43	32	19	32	28	16	18	28	26	28	20	16	26	14	18	40	43	22	22	44	33	25	58	37	12	20	22	28	36	74	46	41	46	50	40	17	35	21	35	19	27	12	19	48	37	28	43	47	32	23	25	14	36	15	33	20	16	16	63	22	25	20	20	11	30	29	32	31	15	33	42	25	26	28	37	24	12	20	12	30	41	17	26	27	32	23	16	12	23	15	27	14	16	22	23	28	17	18	35	27	13	385	27	23	24	37	16	18	15	30	21	37	23	24	24	23	18	21	17	21	28	20	15	20	11	13	28	19	31	8	12	20	12	15	18	26	12	41	15	20	24	17	24	13	18	8	15	19	13	21	20	16	29	12	9	20	18	12	84	6	20	16	17	26	10	16	12	17	16	6	16	6	16	17	8	13	16	17	12	9	4	25	21	9	8	15	23	28	14	32	11	16	20	20	18	22	2	11	14	17	22	5	11	21	14	16	17	5	3	36	12	6	7	3	9	7	24	13	19	16	4	21	10	6	12	11	4	4	12	11	6	6	7	19	18	7	13	8	9	12	11	5	11	3	5	8	14	8	17	6	10	14	3	6	7	6	11	5	10	8	13	6	27	6	5	0	8	4	12	10	1	3	6	8	15	6	19	21	2	1	6	7	4	2	5	6	8	4	5	5	12	7	1	7	2	2	2	1	5	7	5	9	15	6	9	3	9	2	10	4	9	5	12	6	4	2	4	0	8	7	10	4	2	2	3	3	2	6	5	1	3	2	0	0	2	0	1	0	3	1	0	2	0	0	0	4	1	3	0	2	1	0	0	2	0
ne0103	1402	1365	817	670	885	748	756	676	520	665	602	567	445	455	498	449	456	476	402	368	350	487	370	557	437	398	395	447	408	401	360	425	397	361	336	367	375	374	345	275	323	407	283	380	331	244	258	400	333	342	315	360	426	328	296	337	293	319	310	436	288	314	291	252	288	328	297	404	273	308	285	216	281	184	290	301	222	256	272	291	305	304	204	215	270	194	260	272	254	295	279	228	229	172	224	328	199	230	322	259	242	247	232	191	284	258	239	196	224	228	272	254	181	208	182	221	165	217	199	182	173	168	213	235	240	272	244	194	134	172	236	232	214	202	229	280	185	210	155	207	182	217	208	179	200	216	201	266	209	240	279	186	206	182	213	207	232	196	146	208	213	216	219	194	198	207	161	155	235	209	198	189	228	174	133	160	183	136	230	171	214	237	315	157	314	206	285	192	192	200	115	207	131	176	189	217	153	130	148	198	218	261	145	234	248	219	167	194	197	184	117	229	149	203	136	175	182	189	213	179	182	201	224	174	159	188	148	172	157	160	184	167	195	182	223	172	202	205	137	192	160	148	190	152	117	135	188	144	165	157	166	151	177	168	130	102	120	189	163	180	139	147	137	171	169	138	209	163	146	157	154	122	205	137	140	129	108	163	136	175	144	145	156	217	190	197	134	167	159	124	147	130	158	167	174	116	209	99	157	120	202	142	152	145	147	134	153	144	121	162	123	127	161	132	142	94	140	128	258	130	135	145	113	132	124	127	140	157	151	127	132	149	156	168	153	134	142	129	141	107	131	131	141	122	153	116	134	117	177	147	128	163	142	121	122	169	114	121	186	123	127	95	134	143	97	125	159	105	163	130	135	132	108	138	138	123	117	70	153	118	149	114	110	133	110	111	115	94	112	151	134	124	143	121	121	106	128	136	128	113	127	102	133	146	117	93	111	79	120	116	118	104	119	120	84	77	111	100	112	100	89	136	115	117	120	98	110	91	131	121	133	103	101	98	88	96	99	88	120	93	87	124	120	103	137	81	157	52	85	118	125	94	109	108	82	106	96	121	104	113	94	66	101	89	108	101	113	76	104	92	85	116	106	96	105	89	86	102	139	91	81	173	90	127	105	89	130	123	127	83	174	75	102	98	139	77	112	87	72	85	79	110	131	75	114	97	123	78	84	116	99	96	96	69	71	90	84	90	122	82	93	85	93	86	106	72	96	102	75	99	88	110	96	77	79	93	62	93	81	89	67	119	89	86	125	56	106	95	87	110	75	108	97	85	95	75	99	82	52	52	86	96	97	107	97	119	61	108	95	98	92	45	132	86	64	68	192	89	73	170	87	77	78	63	97	94	84	95	61	92	75	53	77	74	81	86	102	50	77	81	96	90	71	98	60	62	64	73	104	127	91	80	69	101	86	71	76	64	78	85	63	87	79	58	78	87	87	76	93	63	77	61	75	80	104	82	71	78	106	64	68	58	67	68	104	99	53	59	70	71	106	73	71	74	65	59	88	86	52	56	78	105	73	64	93	59	76	68	71	96	72	50	71	74	79	85	72	60	162	90	87	51	99	48	89	44	75	99	37	59	79	73	60	57	88	52	56	60	75	68	85	79	59	86	103	94	87	75	81	48	73	66	56	54	68	74	37	87	79	49	61	60	74	74	71	60	67	73	48	63	46	68	132	77	59	69	58	92	45	53	56	39	40	61	58	55	49	42	67	61	62	55	73	65	58	62	77	54	91	71	32	87	70	81	64	51	53	58	60	58	50	54	61	43	65	64	85	71	81	61	46	78	80	69	64	58	86	36	69	56	67	66	76	76	51	67	69	65	66	45	58	63	61	51	32	56	52	52	65	66	57	49	95	38	58	53	52	56	61	47	45	40	47	45	51	52	67	37	37	39	64	40	30	36	51	52	40	61	48	48	65	56	53	53	49	64	77	35	59	50	52	41	86	43	70	48	45	78	37	66	67	45	67	40	64	46	43	47	43	34	59	41	34	52	66	37	73	48	48	41	42	41	48	59	50	54	46	47	58	30	53	46	52	44	40	58	61	52	42	54	64	49	46	53	53	59	71	47	21	58	77	51	33	37	46	38	66	54	59	51	45	41	29	50	52	38	56	36	71	54	38	36	59	51	43	43	38	48	50	48	58	45	42	65	36	43	62	36	53	42	55	34	34	50	36	55	29	37	33	48	38	85	45	51	72	46	30	68	38	53	63	61	23	39	20	54	30	51	59	53	39	34	49	46	45	60	52	43	24	32	32	57	37	55	41	57	38	47	54	47	26	44	48	35	48	48	43	41	37	49	49	45	52	92	43	44	36	62	32	49	49	41	45	35	27	52	76	44	49	35	40	30	43	45	50	28	40	28	35	44	34	45	24	28	40	54	55	57	38	51	24	39	37	28	24	29	49	33	32	32	54	39	40	33	71	43	28	43	41	51	34	39	42	51	31	44	25	31	31	26	29	24	52	52	29	65	41	32	44	38	35	41	43	34	47	34	24	38	28	32	28	41	36	30	29	39	27	44	39	36	63	53	37	23	45	39	27	28	50	32	29	36	42	34	40	47	43	51	36	47	35	27	36	39	56	20	41	27	26	33	30	49	43	36	33	27	24	29	30	25	40	47	63	38	35	35	31	33	22	32	46	33	59	37	12	35	32	21	33	40	21	36	29	30	34	52	24	31	22	29	55	30	34	30	22	36	58	37	27	56	29	47	23	51	37	30	40	33	70	35	57	28	23	39	32	27	23	22	38	32	30	26	19	43	39	49	32	38	26	45	30	32	30	35	26	29	32	22	35	35	34	30	23	25	29	35	43	16	30	38	31	31	40	25	39	11	32	35	39	28	30	25	23	20	31	48	19	26	29	27	19	39	17	34	38	28	25	31	42	19	29	84	21	29	18	40	24	37	31	26	18	30	30	17	13	30	28	35	25	27	33	24	12	43	30	20	26	24	24	20	22	21	17	15	25	21	26	25	35	23	23	34	62	23	22	32	25	27	14	23	18	33	36	24	26	16	17	15	22	26	19	25	18	19	26	18	18	22	18	22	20	20	37	23	15	34	34	19	36	19	19	22	30	21	24	36	18	16	15	36	26	36	20	36	25	21	25	18	12	25	18	24	39	16	32	20	26	28	18	21	25	16	16	14	13	22	22	41	17	14	11	15	8	13	20	25	31	16	26	29	28	14	17	24	18	23	15	9	14	27	23	35	16	20	26	14	20	23	15	13	10	18	49	13	18	23	78	26	21	11	20	14	12	22	13	12	8	23	15	20	35	26	10	31	13	16	16	24	16	13	28	16	8	17	15	21	17	17	26	17	26	17	12	33	28	20	19	16	30	21	16	23	16	12	10	21	20	17	14	56	12	14	15	5	23	11	20	30	24	11	12	20	18	10	16	16	14	17	24	16	15	8	23	25	7	14	20	6	9	11	24	18	12	9	21	13	19	8	17	26	23	19	14	6	19	7	11	20	12	22	6	22	19	15	8	7	18	12	10	9	17	10	15	21	12	21	11	6	12	18	8	8	16	14	19	6	21	11	13	15	7	24	12	18	37	8	19	6	15	23	5	11	13	16	8	19	12	10	10	24	13	20	14	9	11	16	18	10	12	6	11	13	11	8	10	11	13	13	4	15	10	4	2	7	8	7	6	6	13	3	13	12	17	24	13	40	6	9	5	6	16	5	6	14	12	17	20	5	19	7	15	10	11	9	57	8	11	8	6	12	9	13	9	7	9	8	6	37	8	9	5	6	6	7	7	18	9	4	9	8	8	4	16	5	9	12	8	10	7	10	18	1	6	9	9	7	8	9	5	4	11	6	7	3	9	3	10	5	3	6	6	9	9	6	7	7	11	14	15	2	5	13	5	9	4	3	11	7	2	11	6	7	3	8	16	17	9	10	5	5	1	10	1	11	10	7	5	5	1	3	13	2	9	4	13	3	2	5	8	2	0	10	1	4	5	4	6	6	9	12	4	52	1	2	3	2	3	1	5	1	2	6	2	3	3	2	2	5	9	2	4	0	0	4	4	3	7	13	0	2	0	12	3	3	3	6	2	0	4	5	1	1	13	2	13	0	0	3	1	0	1	1	0	2	1	1	3	2	0	2	0	0	1	2	0	3	4	2	1	2	12	0	0	0	1	2	0	1
ne0104	2677	3032	1849	1790	1114	1233	904	1065	618	1298	629	847	928	938	747	1772	834	436	1255	865	514	783	994	365	565	482	496	602	645	503	618	661	480	652	611	728	455	458	427	409	399	489	428	417	517	622	566	535	657	485	447	436	268	606	453	475	441	468	559	263	592	332	363	630	427	523	568	324	409	438	706	695	483	299	457	477	264	418	422	381	356	362	490	347	527	444	397	323	414	417	398	459	453	279	630	582	505	291	374	289	311	446	285	463	282	274	337	459	706	386	295	525	427	411	426	479	412	374	277	381	260	413	357	438	499	408	239	291	398	398	280	317	188	375	316	387	243	201	419	212	241	336	276	183	367	296	230	259	294	275	298	201	268	245	456	337	219	340	393	360	156	275	251	270	645	236	311	316	230	167	321	162	317	374	353	512	219	388	205	234	276	472	218	251	212	186	251	308	198	316	346	182	358	239	144	177	237	372	235	234	317	294	219	421	229	204	191	202	298	294	367	207	227	241	1159	257	138	251	264	180	271	197	238	283	239	189	239	267	261	119	353	282	291	251	202	195	337	191	280	146	226	406	254	396	277	185	184	119	143	458	150	187	464	225	194	320	225	213	220	259	184	259	208	163	272	272	199	190	198	152	143	172	210	141	198	144	254	188	242	270	161	258	225	188	184	203	212	498	274	274	168	308	211	174	214	172	214	139	337	218	146	692	236	160	272	203	158	232	155	133	289	343	236	125	250	162	243	241	100	135	185	177	161	156	223	180	167	163	193	211	181	191	215	111	157	227	132	196	171	155	365	233	210	973	227	318	252	149	142	149	253	168	190	169	243	163	307	168	150	113	178	275	127	134	290	272	173	249	168	245	185	135	198	175	92	197	141	177	148	156	163	186	182	141	177	269	114	250	155	93	196	228	185	175	164	153	139	127	171	170	128	153	173	142	179	161	131	1462	151	180	101	189	254	132	315	98	170	200	159	238	258	160	134	123	165	92	148	121	213	128	103	164	143	99	178	147	113	162	154	82	118	146	173	116	205	87	125	106	191	109	216	167	319	118	129	165	354	142	182	220	84	126	120	211	260	188	269	67	108	220	85	103	186	225	241	121	127	115	124	160	126	244	137	70	122	95	85	170	59	142	150	109	104	105	143	94	70	236	68	158	128	108	129	79	87	98	110	182	133	108	81	108	100	77	83	142	87	127	91	56	94	97	131	374	140	98	126	129	116	182	135	166	105	83	204	109	109	327	158	104	122	100	143	125	109	150	279	278	131	141	131	126	105	54	101	133	148	95	115	74	117	91	167	72	157	147	78	125	68	75	25	78	138	86	99	108	113	39	94	51	94	80	80	106	131	64	93	99	145	118	123	105	83	145	81	167	91	53	123	155	135	165	145	105	59	93	92	193	83	150	81	96	127	124	83	129	96	64	135	95	95	60	115	78	213	109	78	110	67	90	115	75	64	110	74	122	58	229	197	95	305	249	114	107	131	54	106	218	141	82	89	102	95	82	57	154	120	72	123	64	159	94	46	47	77	126	143	182	84	97	106	103	97	50	135	98	46	96	59	75	183	101	69	129	249	108	78	75	69	94	71	168	69	70	113	62	124	116	98	77	68	153	49	282	94	77	39	99	89	102	64	132	91	118	77	62	111	57	110	88	90	87	82	92	117	43	81	84	52	90	66	83	161	101	93	75	103	85	65	114	92	107	58	123	112	90	78	70	91	51	68	54	87	84	45	40	75	113	68	88	131	54	58	60	100	125	110	85	143	106	77	109	88	45	131	70	109	56	110	91	53	129	74	90	54	43	75	81	63	50	125	160	63	77	76	85	120	71	59	59	37	118	77	96	57	100	35	102	90	73	242	65	79	86	99	175	87	30	86	232	189	68	47	59	108	49	50	119	132	182	27	61	49	62	164	62	70	84	125	35	54	44	30	29	58	17	290	145	75	52	87	141	86	44	56	56	77	26	73	71	50	56	84	55	60	54	38	79	58	90	54	67	299	42	65	76	91	64	54	56	187	63	60	91	59	64	74	80	48	53	79	48	58	35	63	45	83	78	57	44	75	125	49	14	52	73	97	119	54	37	45	50	66	38	92	113	50	62	85	44	65	51	41	57	83	43	53	55	74	53	107	37	65	76	57	78	47	81	57	88	56	49	121	44	156	68	53	115	58	54	60	40	82	20	73	58	57	103	40	41	54	36	62	57	23	68	53	45	53	25	72	61	45	58	83	38	20	32	62	50	35	24	409	77	44	44	36	36	25	92	70	48	75	45	51	95	39	52	40	40	71	64	64	47	38	48	31	43	53	46	58	44	55	37	28	52	80	34	51	50	91	36	70	44	43	49	36	77	41	27	50	52	161	57	86	27	33	204	57	48	37	62	126	50	71	92	84	28	49	29	37	51	57	68	20	15	52	19	35	30	61	58	11	76	25	54	83	36	206	35	44	34	57	38	40	41	42	36	39	45	32	51	40	39	35	57	41	54	55	19	27	47	25	46	23	26	71	43	12	116	27	37	63	52	88	25	52	41	47	37	20	75	18	41	35	59	42	19	59	35	74	42	58	45	201	61	37	265	43	26	46	40	56	70	33	71	41	33	48	41	45	43	38	36	18	74	67	34	66	28	49	95	38	50	24	28	53	56	52	42	21	148	45	38	72	32	237	30	73	40	62	54	76	26	57	32	44	29	25	158	37	31	44	52	95	50	25	42	78	37	57	64	27	26	31	39	46	21	55	70	33	40	28	28	27	58	84	71	43	70	85	15	47	112	37	77	16	49	7	49	49	38	32	38	21	77	26	57	35	30	49	53	45	13	36	29	20	23	36	28	39	76	72	35	46	29	47	64	64	36	21	25	26	33	39	42	35	17	20	41	34	29	56	28	34	32	34	52	32	37	20	33	23	27	57	79	23	14	44	58	35	35	52	31	20	56	43	28	98	21	100	67	76	34	26	37	25	48	20	14	38	31	38	33	35	29	19	16	40	24	28	33	26	61	36	49	50	39	31	16	47	40	40	40	63	40	44	89	28	28	41	23	36	13	11	22	28	115	24	16	43	96	49	19	12	40	20	15	22	56	20	25	17	31	36	18	30	18	27	16	37	32	16	27	37	31	22	56	20	39	43	21	24	23	53	14	27	54	9	30	44	15	30	17	21	13	37	19	22	49	35	30	7	9	11	9	23	31	24	82	48	16	23	24	44	11	36	42	18	34	19	37	14	16	39	50	20	29	14	17	27	17	38	30	19	51	41	45	11	36	26	18	14	44	16	23	36	10	105	36	14	17	36	18	63	29	21	28	8	15	10	24	11	8	16	22	22	32	23	8	13	27	48	30	15	12	20	7	10	40	28	29	34	24	34	21	14	29	16	7	25	32	15	8	7	16	16	41	19	15	20	5	35	136	55	13	11	6	25	17	18	21	33	20	7	21	23	80	47	8	22	23	11	32	12	25	24	16	30	19	15	10	28	15	16	43	10	25	32	20	8	35	9	12	19	52	13	46	15	24	28	17	12	16	7	22	23	16	67	6	22	30	20	11	8	12	5	7	19	14	24	14	18	52	18	19	34	14	30	10	23	31	13	2	15	19	17	8	15	6	10	13	8	9	17	20	12	12	20	14	14	20	15	16	14	6	22	29	28	11	11	14	7	9	26	56	19	9	16	19	8	45	5	8	5	10	9	39	15	17	8	5	8	12	10	16	55	28	26	11	4	13	17	5	45	11	14	12	4	4	6	6	1	17	1	15	28	15	3	20	18	22	8	3	7	15	39	22	18	6	5	13	13	13	4	5	3	2	22	11	7	11	12	35	6	18	11	11	19	5	10	11	13	6	2	2	3	2	37	10	10	3	3	8	8	11	4	27	28	2	10	8	9	4	4	16	11	7	11	7	4	8	5	8	3	9	3	22	10	4	7	2	2	8	5	17	4	3	15	6	12	2	7	6	13	1	2	15	5	10	4	2	11	7	9	6	1	2	1	6	12	6	7	23	2	3	2	2	5	5	17	2	8	14	23	1	8	0	0	18	0	0	2	0	2	3	2	4	6	3	2	1	5	15	0	2	6	4	1	3	6	3	10	3	4	6	2	1	5	1	7	2	5	2	2	4	1	5	0	1	0	0	2	0	0	0	1	0	0	6	5	0	0	4	0	1	2	0
ne0106	603	591	346	543	300	300	283	290	314	231	269	244	250	184	279	156	190	243	178	147	175	222	167	239	155	223	225	145	172	215	186	187	138	163	142	165	154	225	212	149	153	164	305	114	172	101	122	137	116	141	117	144	105	257	180	164	267	139	148	93	115	129	137	124	125	153	107	133	91	117	137	125	135	131	153	161	72	131	137	137	125	169	99	122	167	101	141	124	131	135	107	86	110	76	114	96	92	77	114	58	80	89	144	84	127	91	96	78	96	143	100	92	75	86	82	90	73	95	99	87	69	86	114	108	96	129	97	67	55	70	96	81	108	90	81	214	187	85	83	111	75	83	139	89	70	99	100	153	104	94	112	70	90	69	108	167	85	68	66	160	93	133	98	90	79	91	81	72	113	128	92	81	88	106	65	69	69	67	104	98	97	99	93	67	57	109	52	61	84	96	64	59	84	68	70	124	152	57	54	77	69	166	73	90	95	89	59	44	61	95	63	111	133	67	55	97	84	96	65	84	109	45	80	75	66	82	73	80	73	52	90	78	205	91	81	49	87	101	62	68	79	82	90	84	55	58	77	77	83	63	69	87	66	80	61	46	48	91	83	177	62	70	60	45	85	36	58	129	96	112	73	55	64	78	104	124	49	56	81	78	67	72	70	159	102	105	77	49	73	45	60	46	73	59	79	60	47	29	50	53	73	67	63	52	68	184	91	79	29	65	65	70	67	92	62	52	57	85	26	43	55	54	53	148	63	73	68	97	67	52	93	54	68	151	62	57	52	93	54	43	56	62	74	66	55	51	56	57	115	64	58	68	74	45	52	57	88	58	107	68	44	41	121	57	43	65	64	55	36	58	51	41	63	62	51	122	39	38	71	56	72	50	53	46	113	63	120	52	42	56	60	74	73	65	87	46	55	49	63	34	39	54	48	50	49	35	111	66	49	48	64	56	60	46	56	30	45	70	49	53	39	77	44	42	39	41	30	39	110	47	33	38	54	59	59	32	53	37	45	36	31	77	54	44	58	37	61	18	38	33	30	63	39	45	50	52	30	53	65	44	45	18	69	31	50	65	33	28	60	53	73	26	30	42	55	36	47	48	35	52	41	69	26	51	60	40	40	38	39	65	44	38	38	40	71	41	47	36	45	32	42	40	35	108	26	48	64	32	40	48	33	48	38	36	31	50	47	62	35	58	47	55	52	20	27	31	64	26	45	45	34	56	34	22	75	31	27	27	35	58	26	51	51	32	33	53	62	60	37	49	43	53	47	44	42	42	44	42	18	34	45	28	29	49	36	38	30	50	42	32	14	16	59	42	32	39	20	20	31	16	34	35	37	41	47	18	27	42	42	28	44	26	28	39	18	38	26	26	33	29	30	37	46	41	30	49	36	27	37	63	22	30	43	31	36	43	38	28	33	33	22	41	25	42	36	30	56	24	33	30	35	84	43	25	39	42	22	19	36	49	24	14	41	23	18	25	27	18	50	34	37	52	23	24	26	22	47	21	37	46	38	27	35	35	49	28	32	37	29	55	41	49	35	20	31	24	27	32	14	30	25	46	27	39	24	23	29	26	22	26	30	22	38	27	24	28	24	28	21	30	30	21	21	59	26	39	29	40	36	30	14	32	32	19	41	33	12	50	32	21	34	40	23	31	44	52	26	42	32	40	29	33	39	17	34	41	24	40	22	40	23	34	15	33	26	32	36	27	36	28	62	26	41	11	33	18	36	32	38	25	28	39	24	35	23	30	152	31	27	25	33	22	24	33	10	38	23	25	18	25	20	39	22	44	28	23	19	11	29	18	24	34	26	29	31	21	56	29	42	15	21	22	78	19	9	29	16	27	25	34	33	19	38	11	10	7	26	22	24	25	25	11	28	29	28	17	34	19	11	17	21	22	20	37	18	21	23	16	32	54	34	16	15	22	24	24	25	31	15	23	16	23	30	21	31	27	29	25	22	23	25	14	18	36	26	25	32	30	36	17	14	27	32	31	32	28	31	10	29	20	16	20	22	26	18	29	30	22	20	26	24	25	49	25	22	33	12	27	31	11	29	18	21	8	20	21	74	14	11	24	11	20	22	19	21	42	19	17	29	26	51	13	10	27	18	65	26	20	16	23	40	22	26	22	24	43	23	16	16	27	35	14	16	18	12	27	20	23	24	6	16	19	14	6	13	43	43	20	20	18	25	12	24	23	24	18	20	23	30	8	25	24	26	21	19	22	16	6	27	21	13	6	11	34	18	22	17	13	11	74	20	26	36	15	29	8	32	14	30	10	25	15	18	20	16	26	10	17	53	24	19	22	17	54	9	30	14	16	19	15	15	19	18	35	26	13	8	18	10	15	19	12	13	5	15	18	18	14	24	20	17	24	25	9	22	69	15	13	13	26	15	11	17	15	17	29	14	24	7	28	24	10	12	8	28	19	9	16	4	20	6	15	14	10	29	21	13	23	6	22	24	5	41	14	13	21	15	17	14	20	13	34	25	25	7	17	23	16	18	14	20	13	17	25	9	21	14	13	25	19	32	18	65	18	18	11	24	10	8	22	11	15	12	15	18	17	19	17	18	10	18	18	21	11	14	3	27	14	14	9	23	20	12	7	10	13	5	13	19	13	15	17	27	24	5	16	25	8	22	12	13	28	16	16	16	28	15	32	14	8	22	19	12	12	9	17	12	23	16	16	6	15	9	6	6	8	18	10	12	10	10	19	15	15	11	17	11	8	13	15	14	17	20	9	14	48	12	12	34	7	18	8	27	8	30	7	15	17	17	14	14	5	14	8	7	8	17	5	18	10	17	15	7	6	20	8	12	15	7	21	23	17	9	24	27	11	24	8	7	10	7	51	16	13	13	17	13	11	21	12	4	12	18	13	7	9	5	9	6	9	13	14	6	10	27	23	13	12	4	12	14	18	12	16	18	13	10	14	8	18	7	3	11	21	10	11	2	3	13	9	7	5	11	10	18	7	9	15	5	23	42	6	8	6	12	14	16	23	5	12	12	8	8	12	7	10	8	8	19	5	22	9	10	9	10	9	77	6	17	15	23	7	5	14	6	8	8	12	10	17	5	10	5	5	8	13	11	4	6	5	10	17	9	9	24	14	8	11	15	8	18	6	7	9	4	10	13	11	16	3	8	5	20	15	12	7	21	3	16	2	23	10	71	3	3	3	7	6	13	3	5	3	8	18	5	4	15	1	7	11	10	12	3	5	7	7	12	2	10	8	6	9	22	9	11	6	8	7	5	9	15	7	25	9	13	10	15	10	5	11	0	9	12	18	12	4	4	8	3	8	7	14	7	2	7	3	16	7	11	6	16	9	9	6	6	11	3	11	7	4	3	9	2	6	16	10	11	6	11	21	3	7	9	3	9	7	16	59	2	2	11	5	13	9	8	7	14	4	6	9	4	4	6	15	3	3	10	1	5	5	8	6	7	4	14	6	20	9	5	2	7	5	6	0	13	0	1	7	17	2	3	5	6	21	14	7	21	4	12	7	8	4	3	8	7	4	12	3	0	2	68	6	23	5	2	10	8	11	6	22	11	19	6	4	14	4	19	1	6	11	2	0	4	14	6	9	5	6	1	1	4	12	6	4	3	3	2	0	13	0	13	9	7	6	2	4	1	9	2	4	12	14	0	0	1	1	5	4	46	4	9	3	2	2	4	19	7	1	8	8	9	2	4	3	2	16	5	6	0	16	11	55	4	14	1	3	4	3	3	15	9	6	7	1	1	2	4	18	2	3	4	3	1	2	2	1	5	5	8	3	1	9	9	1	3	1	2	6	1	3	34	1	1	5	3	4	2	5	9	2	9	2	2	1	0	1	12	5	0	1	4	2	0	3	2	1	7	18	34	3	7	2	5	2	3	6	2	5	1	8	4	6	2	2	3	3	2	8	5	3	4	3	1	3	0	5	4	1	1	4	1	1	0	3	1	0	1	1	0	4	1	0	0	1	0	2	1	0	3	0	1	11	18	1	0	1	3	0	0	1	3	0	7	2	3	2	2	0	2	3	0	0	2	0	1	0	2	1	0	0	2	3	2	3	0	1	1	1	24	3	0	1	4	1	25	0	2	2	0	2	1	0	0	0	0	0	3	1	4	0	0	0	0	0	0	0	2	0	0	0	25	0	0	0	0	0	0	0
ne0107	4541	4357	2297	2864	2553	2511	2004	2281	1796	1764	1847	1854	1669	1493	1561	1508	1434	1502	1556	1290	1295	1706	1352	1456	1406	1157	1435	1394	1425	1410	1185	1428	1037	1105	1346	1138	1008	1416	1111	1014	1152	1136	1222	1068	1138	781	873	1227	1150	966	907	1061	1051	1251	1578	979	967	965	1004	941	931	774	953	1067	928	1153	901	1010	804	1015	819	924	1071	809	981	1282	751	890	1094	914	857	1090	716	879	870	611	863	816	816	1025	814	687	644	710	752	963	597	640	874	612	638	797	882	658	848	644	695	624	707	1255	838	1002	517	615	489	740	542	646	906	608	632	546	769	854	816	907	814	460	447	647	605	652	638	563	736	695	914	577	510	844	621	702	934	720	613	648	691	700	881	817	717	508	631	521	692	719	702	630	479	774	694	849	567	602	721	662	586	595	760	554	841	581	722	590	468	577	661	438	613	553	762	633	553	638	604	791	544	683	563	846	528	655	576	452	569	716	674	379	583	488	649	708	417	646	530	629	501	594	592	663	388	694	565	526	632	658	515	605	623	636	597	470	585	638	606	676	551	498	582	493	645	591	787	519	819	518	569	694	512	506	633	475	642	518	427	426	441	506	525	528	433	442	564	491	343	316	373	586	572	717	468	512	462	607	500	490	585	523	504	603	388	410	679	519	530	484	428	512	522	479	424	486	467	511	479	437	423	462	433	501	502	433	529	585	543	396	478	383	439	360	689	424	434	465	538	589	490	547	526	502	386	365	480	443	452	356	516	507	261	378	415	442	380	474	554	511	421	472	458	383	567	521	556	736	516	543	482	531	383	297	480	461	335	456	363	450	517	357	441	359	400	518	472	366	378	482	335	412	419	460	332	303	611	542	468	377	480	381	508	513	402	377	315	475	322	348	422	281	498	350	506	515	281	341	468	576	334	374	364	407	539	341	473	423	344	328	427	379	356	243	477	369	339	488	439	357	431	323	334	405	412	310	352	370	300	355	320	353	350	534	312	451	450	358	334	296	387	340	393	504	305	380	259	437	310	366	341	353	441	263	294	327	353	352	366	276	348	295	392	370	288	296	363	327	360	422	371	371	331	352	345	331	346	291	369	375	267	234	395	378	289	419	439	252	351	390	376	297	268	302	350	218	268	404	302	328	389	344	291	378	435	263	345	327	369	231	317	278	296	259	226	342	391	554	274	408	341	345	365	361	330	230	354	242	228	363	328	338	304	288	257	443	298	239	320	203	405	323	340	390	285	425	243	220	346	274	276	277	323	437	270	305	299	291	343	300	274	354	307	341	216	426	340	288	314	371	329	266	306	186	351	204	337	259	355	398	207	306	316	230	186	289	289	302	174	256	157	153	196	224	299	269	199	249	386	206	289	313	217	342	296	229	262	267	212	319	308	227	229	286	325	317	163	392	160	227	197	275	239	209	267	212	266	259	245	271	270	187	213	271	187	284	276	245	325	266	269	285	242	192	271	322	246	232	288	271	193	282	345	287	263	224	260	241	229	215	130	225	279	215	246	252	226	231	147	221	322	240	310	274	288	283	285	191	223	234	322	228	214	300	152	226	341	209	214	200	238	276	156	257	231	295	218	185	221	401	258	237	162	206	239	261	131	220	224	264	175	216	180	200	176	243	145	238	305	279	154	181	260	183	204	311	267	170	318	229	127	245	237	234	242	261	188	226	227	216	175	235	136	274	272	230	220	125	213	190	173	240	153	236	227	252	154	216	229	179	188	205	269	132	237	124	253	197	225	139	214	205	231	235	257	274	218	204	179	187	216	170	172	255	146	144	177	248	235	259	237	151	207	196	117	226	180	233	211	159	281	106	212	155	202	176	255	229	222	228	295	159	205	144	130	222	181	194	106	179	113	165	184	186	113	205	178	139	194	120	158	151	176	126	173	175	183	111	288	131	154	115	180	128	140	191	130	177	219	214	191	207	147	181	276	182	165	147	162	182	120	138	161	164	131	231	324	117	154	204	193	175	165	218	205	168	183	121	258	188	188	236	238	149	122	181	202	155	164	106	232	139	153	253	165	135	198	234	203	167	134	151	140	144	206	173	166	168	155	151	205	140	164	208	183	266	166	127	208	228	207	172	150	123	106	142	123	98	210	109	161	174	199	152	113	156	130	207	172	201	186	148	157	131	151	234	201	95	155	139	112	164	169	212	171	107	96	188	78	182	161	136	156	99	186	106	142	163	88	199	115	123	151	113	176	127	146	128	205	170	162	185	148	171	164	159	131	198	125	154	126	176	146	132	144	99	154	175	179	174	197	172	114	114	119	128	154	146	162	121	106	173	109	119	155	105	142	161	151	137	132	104	189	197	207	95	137	183	104	209	92	151	138	121	166	126	122	144	207	166	68	139	134	91	112	104	159	96	146	167	179	70	111	139	115	184	144	109	144	114	143	67	112	136	232	131	101	111	99	150	155	145	76	154	150	78	94	132	234	140	104	95	98	118	71	125	143	105	156	153	88	104	75	127	142	121	135	194	109	134	91	98	177	118	96	164	148	127	137	102	116	95	89	99	128	111	98	104	114	136	82	137	171	127	113	175	127	100	208	119	185	118	114	119	101	109	107	163	44	104	135	113	106	72	130	98	100	150	106	71	105	78	112	105	172	104	75	105	106	93	78	89	103	117	167	123	126	100	83	175	165	104	93	101	95	106	124	133	205	97	38	98	95	86	120	127	58	104	147	124	97	144	101	105	105	116	105	96	64	92	90	104	86	97	119	96	93	126	120	75	122	162	138	96	152	114	95	78	105	94	184	89	79	145	103	62	118	130	168	124	139	127	91	87	129	74	108	78	76	96	92	106	125	72	121	111	57	68	99	107	87	115	124	66	161	144	184	120	145	80	112	156	89	70	108	89	66	79	105	136	69	67	171	140	95	90	133	86	124	39	111	114	98	67	84	104	100	79	84	157	76	58	70	110	55	133	96	158	68	44	96	151	82	98	60	45	67	99	64	117	64	50	107	45	56	67	56	116	124	76	85	87	55	105	81	126	72	72	64	74	109	72	64	69	66	100	97	51	67	83	49	57	102	50	93	61	134	40	50	77	83	61	90	68	70	58	114	103	49	102	71	59	112	65	75	69	70	115	93	89	70	41	70	72	78	96	73	81	90	90	62	72	95	89	97	85	70	79	82	73	48	66	82	89	74	45	57	52	86	66	81	123	68	100	58	86	61	35	89	59	77	60	56	46	59	48	64	91	58	63	58	63	66	67	66	82	44	46	92	42	54	59	69	80	72	60	92	79	63	35	72	45	35	33	104	52	67	44	74	64	76	48	46	96	48	60	86	70	40	57	53	80	28	60	70	41	56	34	79	72	46	59	32	59	62	78	55	42	32	76	49	26	36	53	43	50	87	64	43	42	61	44	27	45	61	66	24	24	68	71	49	38	57	55	47	67	82	43	33	50	40	26	74	44	31	64	55	40	34	66	72	94	41	59	45	48	65	93	37	46	82	66	57	53	52	52	50	35	123	37	44	62	32	47	44	95	52	59	25	44	43	46	67	77	51	25	21	48	34	61	29	21	33	30	46	28	50	64	17	42	35	44	28	41	45	31	52	58	53	43	61	36	33	47	25	47	45	51	73	42	51	60	37	32	21	40	34	29	42	61	22	32	41	34	67	33	49	41	29	45	50	39	26	38	47	96	30	22	41	17	36	20	57	26	50	24	26	23	55	41	47	39	48	28	34	41	52	15	24	48	25	23	44	46	38	170	11	18	22	26	52	20	39	30	30	23	26	46	14	15	33	29	23	29	37	24	19	19	39	32	16	12	37	25	51	37	42	28	30	15	15	4	41	25	13	40	20	23	13	22	25	10	13	20	28	23	38	15	19	4	28	22	21	37	24	16	28	20	31	19	13	21	3	23	18	17	31	26	17	21	49	28	16	21	24	27	14	18	6	4	7	41	16	17	7	26	16	12	3	17	19	19	83	9	9	13	13	20	10	5	10	36	2	15	7	6	20	5	7	15	9	9	8	7	26	60	22	9	9	8	10	5	4	7	8	20	24	16	2	5	27	11	10	15	7	5	9	10	14	17	11	38	11	14	13	16	7	24	2	3	10	3	13	19	1	16	7	9	4	7	6	2	6	12	15	2	0	8	12	9	5	5	11	1	0	5	4	0	0	2	3	25	4	4	0	0	1	3	1	1	3	0
ne0114	3026	4118	2892	2763	1999	1962	1756	1573	1900	1284	1434	1385	1759	1445	1306	1272	1191	1478	1255	1307	1390	1421	1420	1249	1266	1611	1153	1191	1770	1516	1155	1065	940	786	1038	1008	1028	1077	1152	831	962	1071	1784	785	935	827	818	760	1059	776	756	797	957	924	855	1051	852	1040	835	1026	619	825	981	727	799	768	679	888	767	911	1080	849	988	893	821	716	831	735	794	794	675	710	547	1007	660	665	740	743	849	728	460	789	639	630	946	679	682	853	675	792	638	479	578	704	709	613	679	556	718	647	600	544	586	513	578	617	550	587	777	504	718	591	943	573	481	759	750	863	508	642	645	828	799	901	905	681	1776	580	509	718	542	535	715	632	710	542	496	811	532	690	533	453	587	625	619	948	560	601	465	501	599	634	683	509	473	515	555	648	567	451	684	614	446	362	464	713	595	475	572	587	895	318	559	508	513	761	489	485	594	596	455	435	990	513	574	379	701	435	547	380	378	594	815	520	910	365	460	394	737	513	464	501	1350	463	493	766	563	560	631	444	320	691	464	319	464	534	513	652	531	432	450	322	516	518	477	537	357	419	384	422	338	553	370	791	384	531	485	467	781	439	436	548	387	466	404	365	525	590	666	494	404	438	631	412	511	519	281	613	544	462	460	507	324	451	448	578	379	418	648	428	372	531	530	635	437	681	406	544	446	367	394	312	341	507	627	467	396	419	446	424	449	472	361	411	237	588	581	518	274	415	391	513	335	474	495	337	256	717	338	400	461	447	388	552	379	382	377	348	413	429	446	279	331	489	393	278	511	435	271	339	250	225	322	462	256	392	220	301	479	282	348	457	348	273	481	232	706	478	505	509	338	454	308	329	409	282	382	245	508	197	421	327	293	299	357	568	310	215	400	345	382	243	268	326	628	386	311	276	347	316	450	629	346	633	381	276	327	418	495	335	607	261	261	321	356	366	353	358	183	344	356	299	388	247	710	281	253	330	363	337	300	458	305	229	349	239	420	279	335	394	144	334	286	380	239	222	419	418	378	313	288	338	276	272	340	287	319	290	379	285	278	357	272	289	261	309	262	331	383	334	321	301	308	235	217	250	354	283	419	463	474	213	290	453	535	303	328	198	254	444	367	331	173	315	253	370	272	276	148	506	404	340	392	333	298	302	374	342	380	293	292	293	273	392	124	265	420	280	298	204	288	293	250	266	286	285	231	380	196	340	274	242	306	180	252	283	259	226	303	200	244	375	223	302	304	252	408	175	338	387	229	179	233	267	232	800	183	205	376	248	179	331	224	311	388	278	234	237	584	279	290	186	296	302	296	246	278	212	294	222	230	172	257	319	218	180	169	239	178	211	213	233	244	223	230	310	292	375	245	166	195	187	332	249	220	406	177	221	248	245	190	237	185	226	201	286	333	153	191	314	268	240	191	323	274	138	182	180	204	213	346	195	244	219	232	218	200	146	209	224	177	320	229	339	263	189	228	212	342	256	238	214	302	211	282	204	281	214	288	239	322	303	168	285	196	187	249	106	245	247	193	213	215	213	211	160	192	105	200	277	184	186	249	76	172	286	188	278	185	246	180	298	145	238	310	186	236	289	114	188	225	185	209	206	292	186	178	290	223	122	187	176	162	307	137	172	202	203	196	126	169	171	226	118	148	210	168	142	117	238	208	241	157	155	309	219	174	244	191	179	376	143	81	163	283	172	167	194	174	378	228	260	175	155	148	174	328	214	261	135	302	164	178	484	134	153	170	216	276	175	265	139	193	198	144	165	578	152	175	165	170	159	188	216	128	128	105	174	131	163	126	126	138	191	179	104	272	147	171	186	131	173	244	195	175	116	235	200	203	322	156	136	215	159	111	197	134	221	123	117	244	289	114	178	102	72	102	141	235	216	116	159	269	106	159	190	134	92	131	186	187	180	101	290	193	168	151	141	254	160	125	381	49	131	254	147	264	154	178	101	228	217	145	191	147	216	203	123	117	193	246	165	77	170	126	98	115	113	114	269	174	184	254	123	84	138	145	128	154	147	164	156	169	104	111	178	228	122	148	225	165	200	173	102	162	109	88	64	93	84	164	120	287	83	161	151	92	159	140	123	141	186	126	90	147	178	116	121	92	155	88	110	191	120	105	91	151	200	159	137	142	140	166	147	154	169	116	121	187	126	146	121	146	151	89	140	175	83	117	65	131	168	120	102	98	143	109	205	186	101	135	137	126	58	123	86	98	142	97	130	120	89	125	185	95	136	157	94	128	162	90	137	102	168	167	137	118	67	75	108	70	96	175	108	136	72	93	102	75	69	125	124	226	116	122	121	165	173	92	111	135	112	110	92	166	154	180	130	121	99	62	83	127	123	128	109	139	170	55	117	64	101	95	78	127	105	127	157	105	155	111	121	62	79	114	81	107	190	66	181	84	119	59	99	147	96	90	129	114	109	114	195	134	72	142	81	82	95	166	84	58	98	79	88	67	101	73	109	91	317	199	136	211	123	99	84	100	103	114	120	133	94	123	130	58	111	171	164	150	69	108	84	114	76	106	114	122	125	126	82	101	45	96	85	77	80	100	124	97	69	112	158	151	115	153	64	93	104	110	65	85	66	136	58	101	64	83	152	147	112	144	40	76	92	94	99	57	99	114	78	96	39	80	81	73	67	90	47	235	71	74	65	145	92	87	126	160	123	79	159	56	75	124	68	116	91	130	122	83	72	77	102	52	135	52	129	114	71	82	60	51	123	95	67	108	69	48	57	114	74	49	85	83	64	81	99	87	87	241	94	120	100	87	58	68	75	55	144	88	99	66	137	57	103	142	106	65	74	87	87	83	117	112	93	77	89	67	48	131	68	116	129	43	128	95	64	108	121	182	119	95	107	87	48	105	110	67	57	67	86	51	50	96	116	108	63	93	130	120	93	65	114	97	82	93	53	58	67	36	119	64	117	79	105	88	59	56	67	60	63	40	51	68	125	71	88	70	84	35	73	87	60	66	78	57	74	47	103	73	130	16	98	178	45	56	55	106	95	72	64	92	47	31	42	121	58	46	91	57	66	110	63	49	72	42	58	32	59	124	61	129	39	55	106	126	67	52	30	62	54	72	52	52	84	97	51	328	80	80	27	45	89	78	120	63	88	43	58	47	86	55	50	28	65	61	91	63	21	73	60	78	32	63	61	63	119	57	42	43	56	112	181	67	29	56	77	87	34	48	35	46	55	27	92	56	41	53	18	100	26	72	95	55	61	31	66	73	42	51	45	52	66	41	90	82	52	29	66	109	50	71	47	60	77	111	53	43	29	61	73	71	55	52	76	37	55	27	110	156	41	122	52	59	34	106	80	38	84	17	44	123	46	101	43	63	71	28	40	42	102	57	50	37	82	58	55	54	65	48	37	39	59	70	29	46	77	37	52	35	66	92	51	54	71	49	46	53	45	71	32	73	60	12	39	70	44	81	101	45	59	70	26	37	49	48	70	36	84	58	26	47	46	34	29	31	19	25	40	51	34	54	35	29	72	51	30	87	33	55	165	30	23	41	50	31	89	22	39	35	41	30	30	89	12	112	25	70	24	41	29	48	8	47	56	20	34	47	34	27	21	30	26	28	10	68	39	47	65	27	18	47	52	53	15	22	18	25	21	51	35	43	58	59	60	52	35	14	29	43	23	39	62	46	44	34	45	36	47	40	38	22	22	43	18	40	11	32	16	25	10	32	21	20	23	37	26	14	21	90	40	22	172	109	25	44	25	18	18	21	24	53	47	25	23	23	18	43	9	8	13	19	19	15	31	33	25	39	12	13	27	23	27	10	63	20	11	7	60	12	31	34	64	23	18	17	28	37	13	31	18	46	31	39	7	26	38	36	9	27	22	8	12	11	22	13	13	33	16	19	9	14	14	34	59	8	31	15	19	15	9	18	22	12	31	2	18	41	18	19	16	16	27	22	23	12	19	30	28	41	20	15	20	22	19	13	8	8	27	20	12	9	12	3	7	12	18	3	6	38	5	18	14	7	14	11	22	12	9	18	5	6	20	9	4	4	18	2	24	11	36	7	4	2	19	2	5	12	4	10	7	17	2	6	17	6	6	17	3	10	14	4	16	4	3	9	8	4	5	4	11	4	0	1	4	19	6	0	6	2	0	2	2	5	4	2	2	3	3	5	0	10	0	8	3	8	4	2	0
ne0119	2410	1689	1271	2003	1292	1295	1365	1193	970	841	839	928	850	885	748	918	893	654	753	755	662	924	804	751	671	777	466	507	715	506	551	680	614	658	478	464	711	460	572	505	527	581	487	672	512	670	690	564	451	562	695	543	478	601	339	414	406	574	369	496	550	712	380	496	432	433	634	570	502	408	454	424	386	428	429	292	448	395	340	372	524	291	547	433	347	479	367	428	480	341	349	366	621	382	390	359	461	396	543	525	382	308	257	526	549	417	436	476	423	271	360	335	465	493	501	536	497	301	381	624	285	492	340	278	309	321	290	369	500	444	369	320	288	342	280	306	292	276	455	339	374	302	326	334	339	293	308	271	222	251	402	290	259	365	379	288	296	286	415	432	319	276	346	272	374	346	308	242	249	334	271	295	376	315	394	257	268	395	318	201	349	413	280	410	258	226	289	251	320	264	227	203	284	331	239	349	297	397	182	398	273	195	276	372	198	375	273	224	179	210	401	218	248	283	270	194	244	165	224	252	158	313	220	190	165	202	255	264	295	283	217	204	238	170	263	235	267	210	244	261	173	308	300	231	263	200	231	253	252	241	235	220	290	252	179	362	291	256	255	226	177	215	198	165	250	191	232	209	168	160	219	175	395	196	221	207	242	317	161	208	168	227	208	182	237	120	195	251	205	231	175	307	156	278	263	195	237	188	148	248	159	335	138	240	185	289	223	138	164	209	251	219	164	301	159	183	141	160	270	248	151	160	183	211	203	216	214	197	295	205	168	198	213	276	350	164	165	167	264	219	205	154	281	151	252	187	122	210	185	145	273	204	216	181	290	187	269	212	139	153	137	148	187	171	153	173	197	138	201	143	145	159	138	202	163	135	150	237	176	196	295	163	178	216	144	176	182	169	176	176	137	260	243	159	170	169	193	184	110	201	125	418	259	175	169	141	154	240	189	151	158	151	198	196	193	192	134	141	158	201	230	112	134	203	146	195	197	176	126	150	194	107	151	149	187	169	116	263	132	146	176	97	167	149	193	143	197	115	107	205	142	142	164	149	111	124	178	143	176	101	194	133	161	204	145	170	179	128	102	124	291	110	164	180	187	139	114	248	111	142	119	135	163	102	200	84	167	189	171	69	130	147	129	86	124	124	119	133	113	106	126	111	164	125	179	113	121	100	152	205	117	123	154	142	121	80	128	132	197	162	107	113	91	325	166	152	131	126	78	159	140	65	132	96	179	99	145	189	133	99	106	107	112	135	73	109	186	247	90	177	80	91	165	101	78	63	135	117	145	111	132	144	145	125	171	171	106	158	144	108	151	98	143	146	126	92	143	140	91	139	94	89	99	113	117	157	195	101	149	110	94	123	108	61	166	132	159	115	128	90	123	104	108	97	114	85	111	113	119	152	93	91	85	74	92	80	106	121	81	102	95	97	132	74	92	135	124	96	100	124	150	120	103	122	82	87	156	139	104	86	93	82	58	141	94	101	131	90	56	104	79	127	61	102	113	121	87	115	56	126	102	133	82	90	119	122	92	71	92	79	135	94	109	93	113	185	74	70	222	78	101	102	86	78	87	50	72	87	124	62	91	93	91	94	87	88	121	84	90	75	119	76	88	138	86	145	105	116	144	104	62	48	59	70	91	81	130	77	207	74	84	68	121	48	97	74	133	97	92	71	52	64	87	95	90	139	53	122	96	77	106	67	86	85	76	104	55	65	84	76	65	83	72	102	66	87	98	117	57	79	105	94	58	129	53	65	84	78	95	71	54	89	87	88	84	78	126	111	121	111	76	117	82	145	70	93	76	120	86	100	58	72	115	73	76	91	89	72	83	67	80	53	77	161	108	75	86	82	110	103	48	64	122	129	118	127	74	66	99	84	122	64	69	58	78	119	118	63	63	108	73	59	64	116	85	77	55	136	70	62	63	61	72	96	81	62	147	89	50	52	75	53	115	60	70	64	51	53	51	65	55	82	83	44	49	86	50	65	55	60	75	35	61	73	116	44	70	56	58	63	72	64	41	64	192	43	59	55	53	84	56	37	61	51	48	87	78	80	57	78	52	76	64	79	52	61	90	71	79	66	69	44	64	69	52	68	55	75	43	62	83	46	44	62	61	38	52	29	66	48	76	56	56	79	52	70	49	69	54	41	90	72	98	122	62	49	111	95	35	58	50	54	34	64	59	42	118	69	38	70	57	53	28	51	47	58	48	86	70	75	48	42	22	52	31	51	63	53	55	79	36	43	214	55	52	42	37	55	58	52	54	44	41	74	38	53	70	84	46	56	56	48	33	33	71	40	52	55	48	77	90	56	60	50	82	32	95	48	33	50	56	85	73	41	41	75	92	46	77	63	40	55	28	58	73	52	44	44	36	57	48	64	16	89	41	39	43	57	49	34	47	37	47	62	46	42	84	52	61	48	37	79	46	64	136	35	54	69	48	46	65	34	46	76	56	29	30	51	37	53	46	50	41	52	49	58	23	50	75	45	82	69	32	48	112	83	23	61	50	70	45	71	77	53	23	31	25	52	43	80	44	54	26	32	43	62	31	59	49	21	30	50	51	72	50	69	66	50	51	67	58	25	41	74	62	48	58	39	54	19	15	44	97	47	53	125	25	24	42	64	38	34	17	42	63	28	55	60	74	112	62	41	34	41	35	55	38	52	49	48	41	43	47	26	24	55	57	29	32	60	109	33	28	24	46	52	40	54	75	24	53	57	59	19	28	22	31	76	31	73	98	33	28	51	35	39	61	53	28	24	64	36	30	51	38	56	35	37	56	15	27	61	46	44	43	19	21	22	34	54	17	26	39	21	20	28	34	64	43	111	31	25	25	23	56	18	25	69	27	29	42	31	60	38	23	22	27	43	29	42	42	42	27	45	36	38	20	22	43	26	28	42	42	22	28	40	25	13	38	37	25	23	19	12	36	75	27	36	35	21	30	86	35	46	25	26	100	29	25	64	47	30	26	31	22	26	28	25	58	18	41	33	36	25	23	35	25	26	12	19	22	29	43	27	36	38	22	29	17	42	44	31	39	30	27	27	36	42	27	23	39	73	26	16	44	37	39	39	34	37	25	22	37	12	23	43	20	38	19	16	8	47	28	16	14	45	36	22	24	35	16	17	34	9	43	49	37	36	17	18	11	21	10	10	18	21	22	39	14	38	20	17	19	28	50	41	16	28	15	31	41	20	20	20	39	32	13	23	23	26	23	33	49	29	22	24	20	9	19	28	20	35	26	5	18	32	30	24	43	112	37	30	24	25	14	20	27	17	44	12	64	20	10	37	38	31	23	13	84	16	102	33	19	22	14	19	42	18	16	17	19	14	26	21	12	26	27	37	20	25	22	11	24	28	11	37	13	23	32	9	9	14	17	17	20	9	15	26	23	9	9	31	9	48	25	46	21	32	13	31	34	18	12	25	12	27	14	7	24	18	54	14	23	39	25	15	14	18	5	35	34	19	11	15	22	44	17	17	2	28	17	21	7	7	16	18	29	21	32	20	36	28	63	16	20	16	20	14	25	18	30	32	17	15	7	12	31	18	26	10	20	25	22	20	19	7	10	12	20	10	24	15	16	17	256	8	8	9	17	23	10	10	22	12	20	19	8	15	10	8	8	10	30	12	23	18	19	19	14	11	3	4	30	5	10	9	28	19	5	10	17	1	15	8	24	1	41	13	9	5	9	15	7	7	10	8	7	13	7	8	9	25	4	3	7	8	11	15	2	19	25	16	13	13	11	31	4	2	13	13	47	7	14	26	12	6	8	27	17	14	12	5	3	10	8	6	2	12	10	13	21	1	3	10	4	5	15	4	39	16	13	12	17	8	11	12	21	2	20	4	12	3	3	9	3	4	29	14	10	26	9	10	2	6	5	27	5	7	8	11	5	2	5	7	5	28	31	11	5	10	16	4	5	6	6	8	5	10	1	6	4	10	13	5	5	12	27	8	4	3	8	0	12	3	4	8	3	1	11	6	3	3	7	10	7	5	1	4	4	11	10	11	10	2	12	19	3	5	6	4	1	1	2	7	4	4	7	2	5	3	2	4	2	1	2	1	2	8	2	3	2	3	16	4	2	1	1	5	0	0	2	2	2	6	1	0	4	1	0	0	0	1	0	0	0	0	2	4	1	3	1	0	3	1	0	0	0	0
ne0120	1384	1590	933	493	356	674	527	482	498	781	543	584	619	524	703	379	430	386	308	495	483	455	395	222	418	327	525	492	379	660	394	380	385	431	362	535	412	273	423	339	365	482	228	259	284	314	323	344	433	407	270	355	210	214	313	414	157	317	466	199	292	276	215	220	312	406	280	259	270	264	276	212	353	274	209	281	256	290	400	305	353	429	196	195	228	260	208	318	173	413	231	273	207	256	236	220	214	147	157	108	263	196	244	221	221	244	247	239	225	265	238	309	240	203	216	200	238	249	187	223	245	233	271	346	312	264	241	103	213	241	235	206	190	275	261	246	144	219	212	172	219	241	146	175	251	284	185	218	320	298	250	123	256	142	200	147	222	189	204	164	163	208	242	315	218	192	239	288	131	113	240	195	228	285	177	247	184	194	114	195	107	266	99	123	144	176	128	198	197	163	153	195	70	209	120	109	169	190	236	129	160	137	143	183	187	151	171	155	290	278	165	240	177	156	118	337	156	229	217	142	183	103	190	275	262	218	226	202	187	141	172	283	165	146	197	183	144	192	202	126	196	145	112	262	113	165	216	121	165	171	117	76	178	123	133	153	121	186	168	159	126	148	163	160	102	169	112	141	174	146	195	169	122	167	161	133	105	151	200	125	165	159	76	167	116	209	203	100	98	128	163	160	147	136	207	110	146	109	183	177	206	145	144	145	246	127	207	307	135	133	141	101	118	76	186	76	255	251	76	150	195	202	136	141	144	153	182	108	159	78	92	190	125	67	141	230	170	150	115	99	109	263	177	115	150	205	259	132	138	89	119	120	145	146	151	119	97	85	134	102	128	155	82	103	134	78	95	192	156	231	91	55	152	63	123	145	154	111	171	108	80	132	122	127	212	142	52	102	152	85	125	155	73	196	57	118	91	114	137	54	137	76	104	121	129	44	109	126	117	125	105	128	98	106	106	73	108	131	158	71	111	103	106	151	158	70	74	89	150	97	40	114	60	126	70	176	99	62	111	109	98	123	80	104	144	137	63	84	155	72	70	54	71	120	111	75	101	124	95	129	83	60	118	83	66	71	69	59	86	65	80	113	87	127	139	99	97	39	101	104	83	72	89	97	92	153	49	79	50	186	85	92	73	91	75	98	100	112	77	100	49	108	95	25	55	105	83	108	136	79	43	89	77	49	102	128	95	130	109	44	110	89	100	48	94	98	85	156	124	72	121	191	92	58	105	82	32	101	108	112	111	52	75	99	46	38	55	78	133	91	74	75	54	44	162	117	152	103	48	98	72	89	81	29	50	75	100	75	33	46	25	73	52	88	83	41	52	27	99	48	81	81	66	67	96	41	49	102	56	84	54	113	82	84	61	68	62	78	76	78	70	59	82	76	89	106	48	45	41	98	54	83	87	70	103	40	43	91	62	97	88	57	71	105	49	83	99	119	68	49	64	58	66	73	42	83	18	27	33	47	108	41	104	88	68	41	53	69	88	94	107	67	67	74	71	55	30	24	86	17	100	53	50	42	56	65	67	113	81	89	18	27	60	24	69	38	44	59	49	117	66	48	129	68	28	69	94	63	51	28	95	87	77	51	60	53	75	92	74	63	45	70	46	43	48	54	99	77	64	64	46	92	86	64	95	50	65	46	37	63	80	108	50	68	63	48	38	94	77	40	117	35	76	50	51	46	61	42	57	56	54	35	64	74	57	82	27	30	66	57	42	67	55	38	68	43	65	72	92	34	38	114	96	47	39	54	29	69	49	86	21	61	62	65	16	64	43	42	26	58	81	29	60	33	27	34	23	61	46	26	67	54	38	55	48	70	81	78	40	64	49	55	18	41	54	58	44	81	46	50	56	36	48	16	10	52	49	43	58	37	50	41	23	17	38	58	64	44	35	64	18	47	36	67	57	59	52	65	52	30	50	37	17	57	65	42	48	60	36	51	30	98	35	34	46	51	73	48	56	53	59	34	65	31	93	21	39	52	44	47	59	83	69	62	63	55	21	25	44	87	102	32	75	75	46	55	41	74	60	79	52	40	29	61	53	38	71	32	50	53	64	40	62	33	82	67	30	51	11	37	29	38	75	43	29	16	28	56	54	22	66	63	23	39	16	47	51	91	30	41	16	67	45	22	31	61	22	45	32	46	28	43	12	22	57	34	44	25	38	42	35	43	47	20	23	68	25	71	60	21	49	45	46	128	24	61	51	26	30	29	36	49	49	44	72	28	18	20	35	36	36	33	40	38	50	82	26	24	34	61	25	36	54	25	42	13	68	34	12	46	28	45	40	33	51	46	28	27	23	44	50	51	38	14	28	44	36	28	34	50	64	27	32	27	41	45	6	52	41	25	57	34	54	44	26	46	38	20	31	38	41	33	60	29	42	71	58	17	40	61	25	38	67	37	11	21	38	15	20	29	41	13	33	20	31	53	31	16	27	21	15	34	32	38	20	40	29	18	81	35	27	27	25	15	31	34	14	37	34	44	32	33	27	44	16	26	45	23	6	17	28	25	19	58	28	30	51	43	27	25	28	54	55	36	26	23	30	16	19	32	57	34	14	32	16	21	35	15	26	37	12	37	43	16	19	10	52	23	28	33	41	42	7	28	33	8	13	39	30	13	45	20	24	26	20	38	41	79	18	40	18	16	26	28	20	24	14	23	10	32	14	32	15	26	41	15	42	26	42	41	14	24	31	46	26	21	14	31	13	23	21	29	21	31	71	18	34	35	34	22	13	23	24	9	20	22	14	32	55	39	44	12	26	17	55	13	19	46	25	49	50	22	27	9	18	25	23	51	17	26	27	50	27	19	8	20	20	8	32	41	37	25	11	31	10	32	28	26	6	38	19	3	29	32	27	46	21	17	30	11	19	6	27	16	17	6	38	17	10	12	33	7	21	21	15	41	23	22	23	19	15	25	15	19	19	24	48	11	8	26	25	11	38	43	29	6	14	18	29	22	17	36	14	38	33	18	23	18	4	13	28	12	17	8	23	14	33	19	21	27	19	36	25	31	13	27	13	11	35	9	28	22	15	11	25	12	3	17	18	18	11	11	12	19	24	14	17	19	12	4	5	27	19	35	35	19	12	14	20	9	24	15	19	28	25	27	5	24	13	18	30	21	21	8	6	11	24	22	13	28	25	21	29	12	53	22	40	5	24	18	48	15	17	16	14	9	34	19	18	8	13	18	24	14	9	30	13	6	34	17	23	23	8	23	18	14	13	33	8	10	15	25	8	11	15	17	6	6	5	0	9	10	15	8	13	10	10	20	4	9	8	9	14	47	12	11	15	19	14	8	14	20	13	6	13	13	21	28	25	18	22	4	9	17	9	14	21	9	19	9	30	15	27	21	24	13	11	16	19	8	14	22	15	6	9	5	7	10	11	12	24	8	25	8	8	8	1	5	15	8	9	10	14	35	9	17	13	9	17	22	13	14	8	31	15	21	37	20	11	13	5	16	14	15	3	4	3	8	24	5	11	21	3	6	16	2	5	4	6	14	17	3	10	10	15	6	7	9	4	60	6	2	6	30	14	21	8	3	10	5	7	13	9	6	4	7	29	19	14	12	4	20	20	4	18	10	16	6	6	0	10	3	5	1	13	1	23	11	28	8	18	3	3	13	2	1	9	3	6	12	2	10	15	1	1	5	19	3	16	12	12	8	10	16	3	6	2	6	0	1	11	1	10	36	7	27	0	8	2	3	3	4	10	3	2	10	24	0	1	5	2	9	3	1	2	8	7	6	4	7	6	14	2	2	3	3	3	7	18	2	2	1	10	3	8	12	13	0	7	2	1	3	8	8	3	11	6	14	5	7	1	5	10	1	2	1	5	4	1	10	6	3	5	6	7	13	3	3	0	2	0	11	10	1	3	3	3	4	5	6	5	5	4	4	1	0	1	12	2	1	3	6	4	3	11	8	4	2	5	2	5	1	2	9	5	1	2	4	0	11	1	16	2	1	0	6	2	11	1	11	0	0	1	2	2	1	0	1	3	4	2	2	0	3	1	2	17	0	6	0	0	1	2	1	6	0	1	1	1	3	0	8	3	6	0	12	3	4	0	2	0	1	0	0	1	1	1	0	2	2	0	2	0	4	2	3	0	4	0	0	0	0	1	1	0	4	1	0	0	2	0	1	0	0	5	0	1	0
ne0129	1163	796	520	157	230	583	365	395	388	496	249	370	512	364	461	300	357	195	220	355	224	226	236	120	190	329	147	361	205	259	162	217	209	317	206	178	301	174	191	229	195	214	113	230	139	227	289	363	268	217	203	171	85	108	132	299	108	156	227	85	191	166	125	90	146	201	224	86	171	138	158	187	173	121	111	82	129	204	169	117	266	206	132	101	87	174	127	122	82	170	121	252	150	118	102	202	149	140	128	104	223	114	72	179	123	145	84	198	261	121	175	148	234	149	152	99	183	230	140	155	100	154	69	168	126	110	177	44	170	162	108	200	88	113	163	67	88	85	145	72	121	248	54	77	119	275	97	76	137	203	132	78	226	96	163	68	165	64	186	45	82	81	129	219	111	70	105	112	74	38	103	112	149	228	133	131	55	140	101	98	30	108	43	97	43	102	59	126	117	119	59	185	29	103	80	37	95	150	115	201	65	38	57	113	68	183	104	140	181	146	123	87	84	165	180	94	72	54	133	53	51	56	65	145	143	61	114	126	112	97	46	136	71	104	79	164	38	48	71	79	52	69	80	67	49	87	214	91	87	117	50	58	66	74	122	122	82	113	100	79	60	80	74	141	59	161	160	44	57	124	65	144	108	82	61	62	72	83	78	49	71	92	58	38	36	97	122	60	64	91	41	166	42	114	110	74	25	64	106	99	63	61	60	97	141	73	88	82	119	57	44	70	40	40	86	48	114	48	43	136	68	96	67	40	62	29	116	60	89	21	47	210	107	45	57	102	89	59	81	70	52	113	129	39	191	73	108	104	29	59	89	29	44	67	79	160	46	55	42	37	66	75	17	39	84	44	67	80	135	105	37	30	61	54	80	67	56	90	70	49	19	46	75	146	53	31	42	70	67	62	42	38	57	67	41	69	73	59	79	61	46	50	132	103	81	63	40	152	149	40	58	50	58	155	54	48	44	49	94	46	74	57	50	119	100	52	54	82	43	86	18	55	48	42	67	87	23	79	33	77	79	24	61	60	105	55	34	38	100	37	43	25	118	42	42	28	48	48	60	122	29	26	46	137	42	34	37	20	94	26	7	103	48	50	33	33	75	30	38	38	28	27	42	42	51	40	23	39	33	60	15	61	22	26	19	70	73	48	22	101	34	49	62	2	25	39	34	60	59	75	42	61	50	33	64	48	47	39	55	19	41	24	31	69	53	44	43	124	59	117	95	77	79	62	27	16	31	72	12	44	52	22	22	27	21	22	22	19	35	54	38	34	48	27	46	35	52	34	25	39	29	54	39	14	28	44	48	46	38	52	17	40	31	34	45	22	26	16	36	47	31	32	14	35	47	38	20	38	53	97	29	52	20	21	36	19	59	35	117	76	55	43	32	36	33	30	36	48	13	11	17	61	27	25	54	14	19	43	31	26	40	24	24	51	25	47	43	68	48	32	20	49	27	71	18	29	13	32	40	25	51	23	25	50	14	27	48	49	26	27	39	32	23	64	38	41	30	4	40	15	60	30	16	24	27	39	42	41	30	39	13	18	33	9	47	29	25	35	21	57	15	56	42	32	23	25	22	33	43	17	33	82	52	25	20	21	63	33	43	13	35	43	49	27	28	35	15	14	35	53	24	17	21	27	25	31	62	28	28	73	32	37	56	14	6	15	32	28	35	27	34	21	27	27	24	7	14	36	50	23	17	28	34	48	40	29	18	14	25	27	6	39	25	19	11	37	36	39	17	25	14	33	48	36	19	13	14	19	26	30	12	32	95	25	32	31	38	28	33	20	41	31	24	34	38	12	6	47	20	26	48	57	25	18	20	44	43	32	32	46	45	14	10	13	51	26	40	44	31	41	31	15	36	10	9	46	20	26	14	22	29	39	10	27	19	68	52	25	14	28	8	18	23	14	46	24	36	46	23	21	33	25	8	37	39	7	5	23	31	16	30	33	33	19	20	17	27	26	13	6	33	41	32	19	37	16	11	21	12	24	36	21	14	29	12	23	20	17	13	25	28	46	22	30	30	26	21	10	25	18	26	19	19	32	14	26	84	21	39	33	41	18	21	24	13	7	17	40	7	5	26	38	12	26	10	11	18	33	30	17	28	37	19	17	17	15	22	22	26	12	14	19	28	16	15	16	23	53	33	22	36	34	20	9	46	22	25	33	14	61	18	26	8	25	22	19	21	13	16	14	21	23	17	53	7	10	22	19	13	9	16	37	23	20	30	13	9	28	23	14	15	18	21	7	29	53	23	8	16	9	25	26	9	13	6	21	19	21	13	56	13	20	8	9	32	13	29	8	9	10	14	21	14	15	20	16	6	13	18	48	39	28	18	10	25	20	10	3	23	9	14	18	11	52	23	17	23	24	11	26	22	24	12	14	7	7	35	19	17	62	13	27	69	26	7	5	19	28	26	13	21	15	18	18	10	14	21	10	21	6	5	18	16	24	9	14	16	16	50	19	10	34	11	12	10	20	14	16	16	17	13	12	13	17	50	14	6	9	4	11	17	7	20	24	7	10	44	11	15	10	4	13	9	11	28	16	25	14	6	15	20	15	6	19	25	19	9	26	8	19	7	6	18	8	14	10	13	5	8	19	8	3	7	15	12	4	13	21	17	2	24	4	8	16	25	21	6	43	13	22	20	10	14	10	6	10	21	6	11	19	7	18	7	46	9	2	19	10	7	11	18	19	17	15	32	9	6	3	5	18	19	2	9	18	20	6	17	16	15	12	8	13	7	7	8	5	12	7	12	12	8	21	3	4	15	8	10	12	9	43	23	17	24	12	3	5	8	26	14	29	14	16	10	17	11	14	7	9	8	3	10	7	22	7	15	13	7	18	4	9	10	6	7	21	8	5	5	15	12	7	21	16	9	4	3	7	13	10	22	15	8	8	19	4	7	11	15	8	6	16	4	3	7	4	5	2	24	10	7	5	31	9	14	5	21	4	6	23	4	12	16	22	12	18	8	13	24	7	4	7	30	3	10	14	2	6	3	5	12	16	11	24	10	15	10	8	7	20	10	12	7	14	18	6	13	8	2	6	24	13	3	9	18	8	4	4	14	11	5	4	8	6	16	11	11	5	5	16	7	7	23	5	12	9	13	7	3	13	13	7	11	4	10	5	11	6	12	17	4	16	24	13	11	5	15	5	7	6	19	15	1	10	6	12	15	1	6	6	7	6	12	18	15	2	3	6	6	5	11	5	6	5	12	5	11	9	4	6	3	9	16	12	2	2	6	6	0	1	31	1	9	19	6	4	3	4	6	2	5	0	3	5	4	3	6	5	18	6	2	3	2	3	8	14	11	3	17	8	2	8	4	6	6	2	16	5	19	6	1	11	6	19	15	5	12	2	10	7	2	3	4	9	11	10	6	5	7	4	8	15	4	3	2	4	0	9	8	2	2	3	8	5	5	4	10	6	5	8	3	9	1	10	1	9	3	15	10	12	4	16	4	8	10	11	2	16	11	8	16	8	2	12	7	0	4	1	5	3	2	2	9	4	3	2	13	4	5	5	4	35	2	6	2	7	4	11	2	0	2	3	2	7	10	14	7	5	4	19	11	3	3	15	5	0	6	18	1	3	14	5	10	4	9	0	2	2	3	12	0	21	4	4	7	5	0	7	6	6	2	2	5	3	4	1	8	10	1	13	6	6	5	2	4	7	2	2	1	4	8	3	4	0	1	4	1	2	2	2	3	3	3	0	5	4	3	3	1	0	1	1	3	6	6	5	3	10	1	2	15	11	2	2	6	1	1	11	6	16	1	9	2	1	7	2	4	4	1	3	8	0	3	4	3	6	1	1	6	1	1	5	3	0	2	7	0	6	1	0	3	1	7	7	1	3	6	3	1	2	0	5	0	11	1	4	1	2	2	5	1	10	1	3	2	0	1	2	3	3	3	0	0	1	2	1	2	0	2	3	0	1	0	2	3	2	0	0	3	3	0	0	0	1	2	0	1	1	1	1	1	1	0	0	0	0	2	0	0	1	0	3	3	1	4	0	0	0	4	0	0	1	0	0	1	0	0	0	3	2	1	0	0	3	1	1	2	1	0	3	1	0	0	1	3	1	4	0	0	0	0	1	0	0	2	0	1	1	0	0	0	0	0	0	0	0	0	1	1	0	0	0	0	0	0	0	1	0	0	0
ne0130	3919	5083	2276	2204	1426	1245	1796	1003	1511	1369	1237	767	974	778	1038	918	1092	903	1347	715	1154	1416	1138	1184	972	1330	820	1011	1970	926	793	1262	644	540	1149	704	760	815	929	1244	1011	646	1298	982	1288	519	512	798	1183	715	305	559	753	1100	1341	781	693	445	903	796	452	811	491	1123	391	989	525	833	718	552	710	730	1078	896	718	466	613	634	802	1035	588	796	273	1068	490	329	848	382	688	746	839	494	309	956	842	735	302	717	839	686	397	882	631	438	700	269	494	287	401	1199	846	591	185	340	229	814	172	556	501	245	589	308	345	815	641	649	548	730	139	244	281	585	502	532	357	910	884	452	302	522	509	627	1236	373	503	469	394	666	651	430	552	451	457	535	695	499	419	593	179	357	508	721	382	304	659	381	549	570	396	430	755	437	415	280	86	691	360	216	354	393	733	508	460	445	483	409	456	590	517	615	758	285	1014	252	423	351	790	180	581	275	453	320	871	401	519	346	696	297	593	519	118	423	749	295	496	405	329	343	383	309	234	553	344	391	441	428	201	448	447	378	451	428	448	548	654	332	387	300	302	370	430	281	470	349	525	200	326	326	479	564	297	747	518	513	624	74	552	321	544	426	458	306	534	267	340	531	456	317	311	473	387	365	428	308	385	546	540	534	446	402	451	332	313	450	320	453	466	789	414	647	225	245	301	372	389	433	378	372	513	292	255	231	296	384	496	555	334	223	455	307	217	327	286	403	485	525	369	296	323	277	284	298	330	331	333	258	342	465	306	299	713	333	394	507	275	443	288	438	284	186	563	349	294	574	223	444	368	299	213	441	277	391	351	527	349	235	260	528	300	302	247	314	664	204	351	270	388	377	358	414	358	209	263	415	187	294	435	237	219	316	432	244	259	371	251	593	222	335	244	279	375	355	447	447	306	222	395	332	363	374	309	331	262	278	365	292	397	295	217	281	171	271	350	350	367	355	312	313	174	603	235	323	398	355	346	507	419	340	471	327	168	223	386	232	200	363	205	375	401	185	126	257	336	312	310	210	266	406	309	293	236	273	263	265	207	186	297	332	219	382	292	434	291	302	207	214	262	172	202	605	267	187	325	377	223	325	298	232	194	743	336	253	185	217	346	369	371	472	149	236	289	324	200	203	179	156	347	513	227	169	194	191	155	667	154	197	190	379	252	326	271	309	303	219	124	169	226	303	223	168	153	162	215	391	302	188	332	285	170	256	274	173	215	206	214	101	247	276	74	243	299	117	234	315	181	545	250	77	65	281	343	387	377	213	145	137	237	113	565	167	251	140	452	135	340	369	140	358	250	197	159	339	169	130	172	69	202	250	268	112	128	221	240	195	296	229	265	206	179	147	301	197	208	146	143	202	281	155	173	258	293	166	139	337	113	127	147	139	102	131	151	97	171	235	150	100	161	155	228	150	194	129	220	155	275	216	258	302	125	291	351	307	245	212	145	149	200	307	143	148	421	270	128	193	128	130	168	303	133	143	89	203	131	128	106	233	258	193	190	171	255	233	148	219	160	338	194	277	213	279	167	105	227	69	118	294	178	139	321	111	180	217	155	130	153	268	131	203	332	108	91	182	195	193	222	132	189	100	269	88	114	200	161	91	252	207	166	174	216	126	183	141	115	148	91	142	102	124	219	199	144	176	328	135	84	236	217	118	113	120	152	178	182	93	174	138	128	269	180	285	151	138	54	192	243	94	278	155	225	183	239	96	135	414	116	179	136	198	189	107	282	193	120	152	83	113	235	180	154	145	166	271	84	139	66	109	343	119	294	203	107	101	111	209	90	103	416	76	118	102	98	155	195	73	121	196	273	171	198	82	102	197	151	200	45	317	142	148	133	259	74	250	161	131	54	56	167	213	80	122	46	199	260	155	329	163	128	182	130	146	71	147	146	68	104	136	156	233	144	162	130	130	37	85	116	20	184	140	86	113	133	205	104	194	158	160	203	86	62	99	88	202	112	120	272	117	85	157	80	69	110	118	85	149	168	147	205	122	101	248	156	81	218	211	82	66	101	71	198	56	149	105	97	141	90	175	132	154	180	179	121	135	120	64	96	100	129	219	151	195	77	129	118	183	164	195	105	163	125	107	90	126	188	219	112	47	118	148	113	73	130	150	124	129	137	81	63	132	82	124	56	141	124	184	51	90	141	111	86	71	55	64	54	134	114	49	80	59	72	103	166	41	110	138	99	88	107	91	152	69	88	104	77	96	103	74	88	133	149	88	168	123	183	153	71	144	143	97	119	104	179	103	88	85	103	87	95	139	130	73	148	109	89	173	86	74	66	103	54	159	197	142	44	146	97	149	62	77	39	70	139	110	177	83	90	101	238	91	147	131	122	64	134	50	185	94	113	42	77	155	134	125	58	136	133	76	168	113	188	166	145	55	143	121	78	30	141	63	48	96	109	110	37	102	15	105	92	20	242	86	80	52	115	64	59	82	85	85	97	151	62	62	76	103	38	189	106	119	158	92	56	146	71	108	95	52	61	66	87	76	93	100	80	64	73	68	79	94	82	41	72	91	175	68	138	73	121	64	67	88	58	111	119	131	79	129	84	94	163	72	132	80	78	139	104	41	67	65	57	65	79	87	82	79	53	87	77	102	87	71	133	59	76	61	45	121	113	82	160	126	50	151	77	42	114	95	58	55	110	104	128	77	59	66	66	70	116	114	54	118	115	100	18	154	67	99	106	78	136	69	144	144	58	46	42	70	42	110	61	131	53	58	19	80	53	130	148	61	124	107	70	45	42	175	45	62	68	119	37	151	48	38	63	106	148	56	80	51	29	54	40	70	36	32	48	30	76	39	74	37	57	92	87	94	82	62	37	77	51	124	141	68	64	79	61	59	74	109	41	125	80	65	118	73	81	67	83	64	31	132	98	83	48	12	66	86	62	51	44	53	67	31	95	72	21	152	34	46	93	77	62	111	41	21	41	78	74	37	25	68	126	74	34	80	50	51	64	90	182	34	50	80	90	38	60	53	22	79	63	43	32	106	43	158	118	90	21	35	20	18	52	25	65	32	77	49	11	62	17	66	80	155	105	24	20	37	70	51	68	46	33	53	84	50	54	18	34	18	32	41	72	36	84	79	28	102	77	21	30	29	124	59	72	59	39	46	91	87	86	41	44	60	24	70	43	57	56	17	28	74	97	91	38	118	23	23	74	96	67	106	91	23	18	19	117	21	37	47	58	77	42	27	29	53	50	47	108	36	47	166	43	62	49	70	60	58	37	110	53	18	28	79	80	73	44	26	62	32	36	50	21	10	52	79	76	60	25	38	12	38	21	35	52	86	17	64	75	105	26	26	12	70	327	74	26	79	103	43	17	47	57	41	49	53	35	15	18	97	19	23	30	11	357	65	22	32	18	43	29	54	25	21	9	172	34	94	42	22	44	49	68	8	56	14	12	48	27	55	23	93	19	35	35	72	28	16	22	16	46	44	22	44	46	26	50	64	24	47	17	31	21	59	38	23	41	40	28	41	49	63	53	27	17	42	26	15	19	20	27	23	0	18	35	23	23	70	87	6	18	66	26	21	57	32	23	18	15	15	15	23	19	30	19	18	17	25	12	9	26	42	28	52	37	28	62	15	35	23	70	7	25	24	23	29	25	4	50	157	48	22	26	83	39	338	36	8	29	29	35	24	40	42	35	19	24	27	7	20	13	9	9	14	21	13	14	24	61	23	17	38	47	265	21	13	38	31	36	41	12	61	23	5	1	18	11	28	11	15	12	41	33	10	8	38	21	5	18	14	15	3	6	12	30	12	17	13	39	10	13	6	4	29	19	7	19	12	25	8	7	16	34	10	23	14	16	7	75	29	23	11	34	11	7	11	8	6	18	15	61	9	37	9	9	1	5	20	7	37	15	7	27	9	24	35	14	0	41	19	15	11	8	3	19	4	18	15	4	19	33	5	3	16	13	11	7	1	57	10	7	9	26	7	17	9	12	29	8	18	20	7	25	31	33	3	13	28	0	3	5	17	33	6	2	11	36	30	12	11	37	34	18	2	20	2	27	0	5	13	51	1	61	26	5	4	1	8	21	13	3	1	2	13	1	11	4	4	6	0	5	3	13	4	0	1	1	2	0	2	0	2	4	0	14	4	0	0	5	0	1	1	1	1	13	0	0	1	1	0
ne0131	2585	2226	1363	1779	1258	1091	1123	1059	983	891	985	899	929	958	1011	812	778	676	661	758	999	731	604	656	693	800	741	582	700	866	677	591	605	624	634	832	652	645	542	632	449	642	498	596	540	573	531	508	545	701	590	485	435	707	493	512	546	444	608	467	476	456	559	583	553	499	514	447	369	363	428	480	511	537	454	498	453	516	516	452	445	421	456	410	536	447	358	448	332	494	438	356	424	426	402	429	401	350	336	364	420	401	399	424	406	404	445	418	380	369	344	379	393	413	447	352	429	335	361	432	526	397	376	382	391	392	478	407	413	401	378	350	380	386	468	418	365	301	376	371	372	297	373	328	365	343	342	321	370	437	341	290	359	322	378	218	288	342	371	382	292	329	369	470	294	257	312	373	410	313	353	313	321	401	324	321	352	323	290	259	399	369	276	233	324	358	363	334	272	310	319	362	298	317	282	280	341	318	338	235	367	254	386	226	328	304	245	275	321	301	322	448	287	289	233	436	236	300	293	298	329	277	343	294	360	315	279	349	235	197	256	294	314	262	343	308	382	232	290	244	391	234	256	403	237	252	312	305	237	240	221	308	224	313	253	293	277	287	268	299	227	234	250	335	233	270	221	288	243	239	262	222	218	239	233	277	275	219	249	177	254	245	201	278	330	276	258	219	321	169	250	228	233	225	531	251	255	245	246	203	247	277	291	237	224	257	223	289	214	206	183	198	199	219	242	222	222	268	199	300	310	285	231	311	244	308	185	205	203	237	181	203	219	214	164	229	215	347	205	191	170	230	310	202	180	202	215	225	202	212	180	197	189	203	186	194	198	229	271	189	224	181	229	248	266	214	186	239	299	208	257	190	201	188	179	204	186	248	214	165	315	297	179	197	205	166	195	185	210	190	269	515	208	181	198	188	183	163	195	188	216	292	173	178	186	161	161	177	189	168	168	215	174	166	222	158	255	223	198	173	145	178	205	210	181	265	160	170	219	205	192	172	192	175	186	179	178	193	231	142	151	234	160	141	156	182	167	176	194	144	149	181	119	168	166	161	192	145	138	148	162	110	188	178	140	150	121	310	160	202	407	167	173	184	292	156	151	140	138	157	180	177	211	132	105	155	167	163	148	150	191	146	144	169	141	140	127	170	142	129	134	177	158	167	150	157	166	113	136	150	95	186	150	182	148	146	136	165	107	125	129	204	131	141	109	163	114	137	188	102	149	147	145	126	244	135	143	113	143	123	114	178	126	159	155	152	179	209	176	122	144	207	140	116	223	193	145	136	124	134	108	156	139	106	131	119	132	116	106	117	132	114	148	113	134	113	121	114	141	102	114	195	131	152	160	120	133	102	155	114	109	151	121	124	124	182	121	103	107	109	141	138	150	140	116	102	160	86	126	315	143	121	131	101	134	112	132	126	135	118	118	120	95	156	157	100	126	117	101	107	139	137	123	112	115	102	115	105	90	100	125	85	118	121	135	105	154	90	112	105	140	110	89	120	111	126	136	92	80	95	98	111	96	101	93	119	138	124	146	113	111	143	132	79	83	84	109	121	84	104	139	104	111	117	140	77	254	181	162	114	102	95	136	116	132	103	88	134	84	117	103	100	101	160	85	108	171	151	93	147	88	200	95	164	112	82	103	112	91	102	116	102	75	104	97	106	102	131	113	86	121	118	151	127	87	145	75	76	111	107	101	97	195	93	84	75	116	70	86	91	110	87	87	94	102	96	125	83	107	133	109	75	130	111	120	68	77	103	51	68	118	112	101	101	67	106	79	104	78	96	114	80	98	88	94	127	80	96	87	67	91	111	93	81	148	109	92	84	73	98	88	92	101	63	107	111	96	98	74	67	72	91	71	64	46	100	86	86	84	62	105	87	94	70	83	123	90	66	109	80	95	96	93	236	72	107	55	87	126	91	104	81	71	94	109	112	77	65	77	105	66	86	61	94	82	86	92	59	93	127	57	57	59	66	69	73	96	78	118	82	79	97	150	98	110	78	77	84	55	85	53	78	84	109	94	53	217	89	80	104	74	76	76	83	190	66	73	83	76	57	71	76	84	66	67	95	75	71	55	108	65	51	63	79	72	109	69	67	57	61	111	65	64	72	109	70	71	68	70	76	121	101	119	94	83	125	129	66	62	106	75	68	58	62	92	52	70	98	54	76	61	56	51	56	75	70	71	118	79	84	99	72	135	117	72	81	100	70	83	125	72	49	82	50	58	67	65	60	74	102	65	65	141	65	75	63	46	54	75	190	59	76	69	54	100	73	129	60	68	58	56	74	51	78	86	77	49	88	63	85	80	69	48	92	36	70	84	46	37	50	54	68	51	54	87	63	41	80	123	50	58	77	70	55	50	98	62	49	60	65	57	50	99	56	68	114	61	64	70	46	59	61	87	48	52	71	56	79	61	75	54	77	49	54	55	64	71	53	61	105	86	63	61	51	87	66	66	57	82	60	44	63	45	43	65	69	89	51	56	101	65	34	53	31	61	43	92	38	43	42	62	49	76	66	71	64	49	61	63	55	43	48	49	152	57	43	53	69	63	49	73	83	34	74	39	67	61	32	50	69	34	73	27	49	35	46	62	74	33	63	54	102	91	32	56	41	51	45	52	66	68	36	35	53	38	49	72	51	63	38	48	46	60	54	42	39	50	88	32	68	54	38	41	33	64	68	44	40	56	40	32	49	27	49	59	42	67	71	47	25	53	112	70	31	65	50	63	42	74	35	46	62	63	35	38	47	38	52	61	47	45	33	52	18	30	26	55	52	83	37	58	40	34	58	41	59	53	38	50	44	31	45	24	29	76	33	56	37	65	85	50	55	26	62	29	55	65	44	31	43	52	21	54	53	28	69	47	31	54	51	55	36	53	19	99	38	26	24	46	63	42	38	31	37	50	66	38	31	52	49	37	55	63	30	35	63	47	39	35	21	33	26	68	120	33	33	24	55	40	34	55	27	46	55	47	29	26	57	53	37	51	100	39	29	45	59	31	40	30	28	32	42	28	31	38	38	36	38	26	40	31	36	44	34	30	38	23	24	32	51	95	22	29	18	63	47	29	50	38	24	23	39	34	44	26	39	48	41	34	18	33	18	30	33	27	38	21	37	49	34	35	95	36	24	26	39	38	44	32	38	46	51	20	32	36	21	23	35	31	27	135	45	23	31	16	25	33	28	16	39	36	19	24	37	31	30	31	28	39	44	30	36	14	31	38	23	37	37	22	33	30	35	17	28	34	85	34	23	46	20	28	22	39	25	32	40	46	50	32	45	24	24	52	18	37	34	34	32	107	24	31	29	28	20	19	26	35	23	67	20	37	18	23	30	27	21	20	9	37	15	32	24	25	35	20	80	23	17	22	20	16	58	27	39	18	24	23	30	25	18	31	30	19	22	33	29	23	31	39	33	43	29	21	62	18	39	15	24	30	22	54	29	13	23	47	19	17	19	24	28	31	25	19	22	25	19	15	32	18	27	17	24	18	33	21	32	25	16	10	123	20	18	5	23	11	23	17	20	12	26	32	16	25	10	39	45	35	18	11	21	19	20	15	26	21	23	24	13	4	18	27	10	33	29	52	16	13	17	18	12	18	21	6	10	24	26	30	25	11	19	38	17	14	21	26	18	12	32	5	13	21	15	18	19	10	25	23	19	22	18	16	21	13	15	29	10	11	16	25	11	15	9	11	28	9	22	11	12	17	10	18	36	20	12	8	7	13	23	19	18	15	12	4	9	13	11	18	6	21	7	12	22	15	11	12	5	10	5	30	17	6	6	7	7	15	17	14	4	12	13	24	9	11	4	10	19	10	14	4	30	19	10	16	14	5	4	27	13	10	11	10	11	6	14	10	12	12	26	15	5	12	8	6	13	13	8	6	6	3	3	10	17	6	14	14	6	7	6	11	9	22	5	8	9	9	8	26	10	9	3	7	11	21	4	7	3	4	5	45	5	7	10	4	5	8	14	6	12	7	14	3	4	1	2	8	7	7	15	3	5	2	12	4	4	10	8	8	5	4	18	0	5	8	8	8	6	12	2	6	1	1	15	4	11	0	9	4	0	4	2	2	6	3	7	6	5	5	0	5	5	3	1	4	3	5	2	6	0	1	0	0	4	1	3	6	2	0	3	2	1	5	0	0	1	0	0	0	0
ne0132	2853	2675	1175	1175	918	988	1299	834	703	890	654	671	758	745	646	857	996	569	919	688	609	874	672	662	539	532	378	709	896	566	361	845	496	484	696	432	564	371	499	675	619	473	623	538	710	507	487	590	838	396	392	405	407	489	491	581	352	280	513	441	359	519	317	502	243	495	429	432	463	374	326	499	565	519	402	182	381	312	380	512	393	422	372	575	315	293	347	243	589	374	518	461	325	483	396	495	334	440	525	497	273	520	319	424	334	276	351	329	738	455	467	404	291	294	257	503	303	444	291	286	337	315	177	544	436	270	352	395	276	273	213	436	205	303	190	246	299	255	270	288	302	461	413	251	318	291	227	238	333	232	302	217	382	422	385	261	378	292	234	238	271	279	222	190	497	215	307	286	189	264	368	226	283	226	193	309	235	244	196	194	297	377	326	329	294	208	342	402	233	223	404	238	511	207	183	219	251	238	251	228	232	149	454	278	213	253	359	213	481	273	223	225	320	346	627	182	227	121	344	108	97	360	210	302	156	215	183	268	316	261	242	218	199	241	280	281	218	118	188	203	175	201	420	237	200	173	223	190	292	386	131	269	302	208	281	186	367	256	234	183	260	261	222	208	221	322	317	176	141	254	202	277	246	129	168	195	280	373	232	198	206	209	158	169	185	238	268	368	262	334	109	189	101	188	247	227	210	203	354	160	130	170	161	264	278	177	190	123	255	123	164	105	113	198	252	227	188	165	253	210	155	183	138	141	97	185	210	202	206	143	212	212	235	232	159	220	210	193	234	157	284	198	227	286	265	204	186	169	123	180	138	171	145	321	181	149	166	279	122	142	143	187	145	125	221	165	144	206	186	224	180	126	126	151	139	181	235	176	155	122	172	95	161	243	167	181	152	240	147	163	157	193	226	241	212	143	148	208	205	213	147	216	190	131	233	191	158	312	121	106	90	129	209	184	175	193	181	157	103	244	197	168	173	223	202	241	226	151	163	138	98	116	151	164	97	216	140	233	222	106	136	122	169	178	151	96	203	174	196	180	140	194	203	112	92	112	151	156	156	201	166	234	128	233	121	135	164	101	122	243	91	121	179	162	122	161	191	101	105	315	109	149	121	97	181	142	213	210	119	150	93	137	131	68	93	72	173	203	113	182	108	103	123	127	180	83	97	196	210	178	187	164	142	107	98	64	88	113	112	101	88	94	87	448	131	100	122	185	76	186	154	124	170	119	151	93	115	184	43	140	137	105	92	127	115	200	196	78	30	162	190	134	176	100	49	101	135	60	303	81	110	111	244	66	113	154	64	157	114	106	135	153	73	75	76	80	149	194	116	126	71	141	88	80	112	144	157	99	126	89	109	131	110	72	105	108	150	109	139	109	187	96	94	160	60	78	84	51	50	79	85	92	95	74	81	71	112	77	127	73	113	68	112	100	132	140	125	266	101	144	130	71	107	122	68	54	116	212	116	77	172	273	65	105	86	51	142	230	73	64	70	97	76	68	77	140	84	90	101	79	139	145	95	80	89	207	108	131	117	122	116	68	131	65	85	128	76	63	143	40	67	123	96	96	89	90	47	77	170	51	52	100	155	86	97	54	172	109	146	43	87	120	85	89	105	115	88	67	102	80	96	46	57	54	40	49	136	48	142	168	77	64	156	43	26	80	115	56	60	48	114	72	126	109	80	56	56	115	68	106	100	54	64	138	134	69	98	66	112	80	44	56	62	172	38	69	101	96	77	62	164	109	64	77	57	44	89	95	109	87	89	87	81	70	84	70	156	74	148	82	71	112	58	73	50	50	144	100	48	80	59	87	76	28	97	127	139	108	86	65	86	101	72	101	79	155	74	73	97	126	61	68	128	100	36	101	86	98	74	59	77	74	68	128	87	108	91	160	92	84	79	31	52	80	67	70	64	101	57	77	47	87	50	26	58	40	65	76	34	78	85	99	87	92	60	62	75	42	19	50	29	87	89	51	119	45	57	46	47	57	67	38	56	106	100	46	94	50	45	109	77	103	92	74	65	31	66	37	78	29	70	74	40	48	24	99	108	86	77	105	63	79	58	57	41	48	75	117	59	66	88	86	64	63	92	117	42	47	65	35	55	93	122	79	52	22	62	126	47	40	47	74	47	71	57	41	24	116	83	52	52	108	86	58	61	58	70	98	29	47	32	46	14	97	36	29	36	33	24	78	71	27	48	85	29	62	29	70	41	49	74	81	60	61	46	36	44	79	63	62	127	75	111	53	27	63	48	34	67	60	109	57	40	52	42	44	25	56	45	27	44	63	42	60	60	51	42	70	44	22	95	77	34	36	80	53	34	31	31	67	69	58	62	38	45	80	119	52	72	51	55	27	77	36	121	26	50	43	47	63	48	41	16	93	34	30	99	46	122	85	69	60	71	70	37	27	43	47	49	31	68	78	33	68	35	108	117	44	87	55	36	20	47	53	47	63	63	29	53	65	40	66	59	56	24	108	50	70	74	52	35	86	27	46	55	31	23	61	22	58	36	38	41	48	30	40	70	51	34	42	34	33	45	21	58	43	30	39	29	38	22	40	76	51	52	72	46	54	47	70	47	31	60	62	44	45	25	33	29	40	39	64	47	68	29	96	31	41	20	41	74	17	52	21	45	36	49	59	62	65	29	44	20	23	27	37	48	67	65	55	33	34	36	54	29	21	59	33	15	43	78	45	16	83	44	48	39	68	83	40	61	55	22	31	14	26	28	49	21	74	32	43	33	72	11	54	57	26	53	66	38	47	18	49	33	48	23	46	19	60	27	17	64	43	46	25	33	44	13	55	22	40	22	39	34	19	31	35	40	46	23	28	47	35	29	23	21	39	18	34	67	12	41	75	30	26	31	51	11	44	60	32	44	69	32	47	38	24	20	62	34	44	26	17	71	28	17	18	17	34	34	19	52	27	25	36	26	20	45	32	39	80	24	23	27	29	34	42	16	18	60	33	30	28	21	34	29	40	110	21	42	35	29	40	26	27	20	15	20	14	15	43	39	43	72	30	30	22	30	21	31	29	43	28	19	11	22	22	33	10	28	92	69	16	14	21	36	12	36	28	21	34	33	19	21	16	27	25	13	42	50	27	35	28	18	29	29	31	13	12	43	16	19	14	27	48	34	20	27	23	29	18	22	37	10	32	27	21	13	35	52	24	31	15	43	25	21	48	33	47	83	12	10	11	44	15	25	14	28	28	26	16	16	15	31	36	48	16	12	55	17	27	34	18	21	53	52	27	67	32	22	59	11	32	30	19	17	15	41	9	38	29	23	31	56	30	11	32	12	4	12	20	14	50	13	24	39	34	8	18	14	43	203	32	14	36	42	12	9	16	24	26	38	45	36	18	18	32	15	28	23	52	20	20	17	10	33	26	9	12	18	11	4	99	28	38	15	18	11	13	36	12	36	13	10	45	20	37	15	32	13	21	14	32	17	9	5	9	14	51	20	17	16	16	9	68	9	21	16	21	8	10	24	12	7	19	18	31	27	17	37	16	25	16	27	21	15	5	35	10	8	8	11	10	9	48	35	10	7	14	13	28	27	29	8	11	10	19	35	20	24	27	4	7	14	20	4	5	15	20	26	15	16	9	24	9	7	20	17	8	12	10	11	20	13	11	19	12	16	5	17	9	13	27	14	32	21	21	11	14	15	29	34	4	5	13	2	24	7	6	5	8	8	8	6	3	35	8	5	6	11	17	11	10	20	14	12	22	7	5	8	4	5	11	10	4	10	16	6	27	18	3	11	11	11	4	15	4	6	7	5	3	17	11	10	5	11	51	7	15	8	16	8	18	6	12	28	2	3	4	6	12	17	10	3	3	5	8	10	16	15	5	1	15	9	4	5	13	20	8	5	0	2	9	1	4	13	23	6	2	4	2	21	5	8	9	27	2	7	3	5	4	1	2	3	10	16	6	10	4	0	21	5	4	1	3	13	4	2	2	10	1	12	2	13	5	7	5	5	2	9	5	13	5	5	6	2	1	3	16	5	5	7	6	6	21	1	8	7	7	5	3	2	1	6	2	1	3	10	0	5	1	4	4	1	1	6	12	1	6	16	2	1	6	5	2	5	0	2	1	1	1	1	1	0	1	2	14	1	0	0	0	7	0	1	0	0	8	0	6	4	0	2	2	0	0	0	0
ne0133	2930	2546	1678	1815	1358	1120	1395	1006	1135	966	1031	949	869	992	1110	691	756	794	706	796	1091	866	721	1067	832	917	919	805	885	993	669	888	782	584	845	797	816	659	647	911	624	714	520	906	761	632	535	583	619	735	524	657	606	709	585	468	448	508	725	615	425	583	442	649	597	714	484	686	561	422	536	442	561	810	472	487	679	457	729	523	538	581	386	477	460	429	390	502	405	707	438	440	355	707	428	379	329	743	522	592	603	429	377	361	584	488	564	380	334	454	461	455	350	356	362	492	359	355	384	353	374	345	403	541	485	636	500	406	335	374	439	438	461	366	491	342	410	424	295	432	497	365	514	408	330	424	454	326	470	546	395	369	319	381	431	299	261	368	315	464	393	388	470	485	353	302	426	638	376	341	557	362	369	426	240	417	459	259	292	364	495	292	345	280	377	321	362	382	369	357	312	337	352	392	354	353	413	264	456	323	345	293	270	307	317	371	337	384	333	454	246	403	261	278	231	624	283	280	287	301	288	390	314	333	549	549	282	477	340	248	229	438	473	290	428	412	274	257	254	358	327	327	370	223	203	334	330	360	241	279	311	266	277	318	282	220	404	262	295	468	299	375	361	312	248	305	279	310	220	281	434	355	254	333	284	328	257	280	310	204	271	307	227	173	304	141	277	335	246	239	295	350	264	320	290	246	329	337	213	316	285	386	298	278	344	284	277	525	222	255	196	221	221	218	240	178	322	223	271	282	394	407	346	243	198	218	242	221	268	294	188	205	200	267	291	329	275	370	201	272	238	331	287	366	193	249	299	274	227	245	287	272	193	243	225	234	250	222	174	200	281	148	212	255	246	206	190	204	242	282	218	221	224	208	247	231	174	245	189	262	284	323	235	219	226	325	198	195	318	228	246	175	297	252	251	254	191	180	148	235	216	336	193	220	227	201	204	148	198	222	165	181	206	230	209	165	256	273	340	179	158	119	224	285	198	427	227	199	190	191	225	336	194	203	170	283	166	164	210	253	189	209	193	202	252	250	334	155	321	211	234	211	141	240	181	151	205	191	154	185	198	174	191	166	144	165	192	261	210	190	197	176	177	224	207	182	190	211	125	98	279	198	251	124	170	153	305	351	162	171	213	158	137	124	164	249	284	179	212	155	151	228	158	118	179	175	134	154	177	224	179	157	210	189	203	231	217	175	152	177	199	206	123	147	119	192	157	198	175	124	197	118	197	172	154	191	169	116	126	186	144	127	132	147	119	127	144	263	256	164	155	223	191	170	281	163	174	132	108	217	192	135	180	138	179	137	175	179	86	130	196	124	161	161	197	154	171	169	168	187	158	155	129	149	219	291	159	169	159	129	115	146	354	113	194	117	185	117	140	135	185	107	131	241	194	134	102	110	116	119	176	118	108	92	162	143	124	190	101	122	98	113	138	126	122	122	205	121	171	153	148	163	125	189	145	107	205	124	111	78	125	53	269	132	87	119	177	154	96	140	249	152	155	161	201	114	168	120	148	180	91	153	103	104	158	179	152	127	369	184	200	123	189	110	106	257	114	117	168	114	105	156	108	152	171	112	131	142	328	137	112	154	135	131	96	112	74	235	81	104	177	84	122	114	114	122	186	115	94	120	121	133	93	170	152	138	82	98	138	157	93	82	139	96	106	88	137	135	157	98	93	72	101	148	122	107	155	132	138	83	143	82	91	129	175	113	96	97	109	106	191	160	94	135	94	85	133	76	79	101	139	124	171	150	70	94	49	111	68	87	71	175	118	144	86	94	136	101	130	122	144	94	115	136	136	75	81	80	91	104	118	103	104	140	141	113	110	99	112	70	109	95	67	141	93	113	94	240	77	77	128	213	91	175	109	134	124	139	212	92	161	95	187	92	58	131	107	77	84	60	120	99	124	56	117	86	84	119	124	105	123	73	72	114	108	182	134	70	81	95	90	136	66	128	115	90	79	74	86	133	97	100	100	70	101	119	89	81	114	72	115	112	60	113	73	81	125	79	90	150	58	63	96	124	75	66	74	80	50	65	75	43	78	88	103	108	73	145	85	92	77	78	91	63	63	85	93	121	77	103	86	68	95	86	65	81	57	130	58	69	82	116	83	84	73	48	75	73	98	73	57	109	123	131	64	70	115	59	50	106	44	93	67	109	70	82	124	96	53	91	89	52	52	97	67	79	44	48	84	63	103	72	45	55	62	94	85	66	72	178	79	54	64	51	72	58	82	60	92	84	68	84	114	117	48	108	67	43	172	65	77	83	74	43	78	79	103	59	36	78	71	91	63	90	78	79	59	46	44	97	86	90	63	53	81	68	67	73	65	70	62	83	86	47	72	89	96	178	121	53	49	68	102	84	57	96	76	80	76	124	63	63	89	62	53	63	78	54	66	86	66	49	109	96	68	48	65	80	126	67	68	88	64	63	58	78	48	61	63	82	93	81	225	80	70	45	79	63	60	66	36	65	54	56	49	108	51	86	77	61	56	40	62	46	85	78	70	87	62	58	99	47	82	83	86	61	52	83	66	90	49	47	43	56	63	75	41	76	89	79	60	77	34	82	75	81	95	54	39	61	59	76	38	37	63	50	63	30	37	63	31	53	45	186	50	60	63	24	47	58	62	49	45	23	42	59	136	92	51	92	83	33	43	47	71	38	54	104	34	55	88	56	36	50	78	49	86	48	26	57	91	73	29	21	60	49	55	50	49	70	77	52	73	38	88	82	43	65	51	63	79	55	36	66	28	32	44	45	26	53	42	78	51	41	46	57	35	37	71	67	42	43	59	146	95	42	36	60	57	60	37	51	33	37	36	54	54	77	67	105	48	59	27	41	51	45	48	69	43	28	64	24	47	61	42	50	50	70	34	65	52	36	72	36	99	44	60	32	56	44	33	47	62	39	52	26	41	53	34	40	37	33	69	40	32	90	64	57	34	26	40	51	52	44	71	23	89	62	39	44	60	70	40	54	49	41	45	66	57	37	66	103	31	19	53	24	21	33	57	38	20	70	29	35	40	50	22	41	19	39	29	30	62	19	35	44	16	26	26	50	29	41	26	27	39	15	49	60	35	14	66	47	38	37	29	12	12	33	34	27	24	43	23	22	43	74	50	30	31	67	40	89	37	21	25	66	50	52	43	45	41	34	39	24	42	24	36	42	47	34	20	51	45	36	34	29	19	36	24	47	31	42	35	12	41	23	41	26	45	54	38	39	28	24	42	41	42	52	33	23	42	27	38	23	35	32	18	41	43	43	51	48	24	28	19	18	67	38	16	14	60	23	58	47	37	17	58	14	20	12	41	33	21	32	24	38	50	29	35	39	11	26	21	36	31	42	27	23	36	53	51	39	39	33	51	13	34	16	27	28	51	12	37	27	36	6	24	31	34	45	30	17	11	17	43	38	23	58	13	21	41	20	41	30	8	39	13	28	35	23	18	32	19	16	25	14	37	30	26	21	20	30	31	52	30	22	40	27	48	12	20	43	14	9	11	9	9	19	25	9	29	22	72	10	14	11	20	22	23	12	20	68	17	23	11	32	35	14	18	23	10	8	37	33	16	16	20	29	7	37	12	15	23	15	30	30	18	7	7	36	18	22	12	16	38	15	18	27	9	16	26	29	27	10	16	25	19	41	27	12	18	11	30	16	17	8	19	13	12	27	20	53	24	19	19	19	4	53	24	6	13	4	14	25	21	14	10	10	10	6	8	7	10	6	15	14	26	27	21	15	9	19	31	7	22	18	9	17	21	4	19	6	8	14	5	9	13	28	38	18	19	5	11	9	22	14	18	12	3	17	8	8	34	3	16	6	14	19	9	12	10	25	21	10	8	8	9	25	6	27	16	20	9	8	10	8	5	6	4	5	4	21	5	18	11	11	2	9	9	4	10	2	2	22	8	2	4	3	5	12	7	10	8	10	8	7	3	6	10	9	2	9	10	5	2	7	14	8	3	4	17	7	6	22	12	0	5	14	4	12	3	5	14	7	10	0	0	14	7	6	6	8	23	2	48	6	13	8	2	4	5	3	2	3	7	2	1	3	0	2	2	4	6	10	1	8	3	0	3	3	1	7	2	3	2	1	3	0	7	0	4	4	6	2	1	0	8	1	3	0	0	3	1	0	1	6	1	4	1	7	1	0	1	1	0	0	0	0
ne0134	9164	5612	3606	3646	2189	4532	4077	4159	2783	3101	2266	3442	3198	3301	2416	2987	3528	1946	2063	2948	2178	2372	1898	2212	1868	1664	1570	2146	1909	1894	1426	2067	2066	2535	1560	1685	2344	1367	1611	2110	1664	1870	1133	1861	1555	2543	2337	2235	1836	1703	2533	1524	1062	1530	1346	1869	1127	1179	1464	1242	2077	1364	768	1362	1321	1667	2151	1411	1361	1105	1237	1144	1422	1492	959	849	1560	1219	1384	1013	1856	1186	1833	1202	893	1796	1041	1201	939	1235	1270	1215	1852	1322	1068	1142	1849	986	1243	1208	1229	1073	759	1956	1109	1489	942	1869	1326	1082	1098	1149	1812	1843	1750	1225	1918	1458	839	2222	1059	1787	647	1167	1068	1145	836	1070	1876	1712	1057	1125	751	810	813	640	717	836	1680	920	1340	1361	1177	781	703	1090	896	845	991	961	1187	756	1277	1129	975	736	1060	759	1754	1049	1013	727	1001	939	913	712	815	1127	517	805	827	934	1091	1061	1519	837	936	1586	622	626	1006	855	815	1447	621	538	706	987	820	856	949	997	744	958	744	678	795	1548	928	860	842	538	773	890	541	1289	838	902	1003	822	1535	938	736	1160	1025	707	678	490	1041	668	614	884	630	938	712	821	880	647	755	905	629	811	735	507	839	642	535	622	818	734	726	678	744	531	699	749	858	714	748	770	623	740	661	541	738	1451	569	832	576	602	585	790	698	730	520	954	849	544	514	634	763	700	1114	530	720	561	741	842	615	512	518	613	538	407	510	407	810	735	546	626	611	969	494	901	709	551	607	761	986	665	504	601	699	876	826	571	550	533	900	572	524	462	528	614	542	753	638	409	743	773	555	536	588	447	468	545	707	554	608	436	666	904	757	734	604	665	569	708	724	666	620	711	652	782	916	560	598	744	335	470	529	487	547	624	576	676	633	479	384	383	683	449	427	451	543	482	644	544	692	671	425	336	566	593	511	411	811	779	543	457	462	567	637	735	410	648	532	494	546	499	486	555	611	619	644	542	388	544	401	558	475	683	699	601	630	503	451	660	562	438	358	475	489	762	587	900	542	555	490	534	546	272	572	629	471	755	648	527	461	370	353	431	351	438	492	441	338	436	393	429	600	339	389	372	510	423	420	602	460	618	409	451	569	390	334	363	403	392	352	417	503	372	302	619	304	448	380	368	268	355	301	529	545	480	523	442	603	381	219	403	438	322	572	320	442	312	651	608	357	363	289	470	282	292	341	335	485	469	463	547	298	367	446	318	398	395	272	352	782	440	472	406	358	307	351	295	394	290	480	390	313	278	367	556	452	335	387	506	197	505	450	338	528	376	312	337	275	369	203	292	315	296	336	382	235	406	336	416	257	447	321	293	577	431	237	211	503	275	482	280	301	421	457	252	450	505	295	516	363	372	416	546	213	335	355	246	382	519	406	353	399	277	331	300	320	504	441	363	475	416	286	447	279	323	352	324	485	318	443	418	475	280	327	528	274	228	241	204	238	189	295	224	274	192	251	223	279	291	320	328	273	206	331	364	334	436	340	453	323	323	430	254	291	302	230	362	239	385	337	247	393	260	240	405	221	258	271	371	302	315	205	254	294	294	299	390	390	225	241	286	358	431	260	353	240	420	334	354	336	385	189	215	286	224	222	316	201	220	331	282	320	280	384	228	247	302	221	218	421	150	228	331	351	244	230	250	407	180	385	186	308	315	341	244	248	339	366	242	251	404	203	143	148	362	227	254	416	178	357	296	252	256	356	205	182	196	330	338	238	198	229	181	232	311	239	133	163	322	367	153	259	195	222	387	325	256	125	208	340	232	268	215	188	257	170	341	294	293	186	216	269	363	198	239	235	156	140	313	190	226	257	223	306	228	235	289	332	207	419	197	349	414	227	264	287	210	243	384	219	185	207	357	290	170	213	414	294	269	252	156	344	234	153	253	385	288	328	235	215	277	126	316	269	149	142	434	210	262	217	165	378	226	265	315	272	235	316	252	262	203	185	199	289	156	227	203	266	273	119	290	205	195	142	151	133	212	294	197	148	162	207	200	532	255	126	190	224	155	165	158	142	236	283	153	257	120	137	199	111	144	211	131	124	401	177	141	233	232	134	210	198	294	189	260	462	144	245	217	189	167	190	103	190	131	119	271	349	259	220	211	161	268	150	396	167	124	269	257	121	149	149	248	217	237	144	208	86	246	182	149	160	325	151	205	164	75	193	169	184	148	119	154	185	187	178	109	126	291	135	178	144	288	139	199	215	144	206	250	119	259	153	133	87	211	195	136	141	94	112	196	277	114	76	164	102	185	140	246	136	173	171	141	69	201	104	165	203	196	209	183	193	153	336	172	152	236	220	86	174	147	207	340	108	133	83	200	116	181	210	182	142	212	109	136	175	156	175	121	102	127	221	238	152	153	169	150	98	110	149	200	231	182	209	135	166	203	222	150	170	147	130	121	150	225	163	154	149	85	182	217	142	128	82	205	93	88	210	171	219	211	163	144	206	185	159	82	222	114	132	123	153	120	159	237	466	190	228	152	173	187	119	141	154	152	100	125	199	159	102	152	100	241	122	159	101	183	133	304	162	88	123	125	126	142	204	154	62	165	136	126	110	162	112	198	116	98	147	92	125	127	79	177	114	108	224	114	169	227	94	127	121	113	90	165	111	236	124	138	117	156	149	109	138	151	112	114	150	89	115	97	122	80	302	175	116	195	83	102	128	100	150	92	73	71	144	170	88	154	242	160	134	115	64	72	106	79	71	140	99	106	89	121	90	201	81	76	166	121	67	194	179	89	81	128	136	101	92	141	142	127	158	176	83	140	64	79	151	172	67	241	121	99	64	193	60	122	139	81	84	107	80	169	44	171	114	73	81	122	72	154	113	108	255	164	121	109	81	161	68	171	71	89	72	130	138	68	172	115	65	77	95	102	159	78	78	69	62	139	72	92	118	70	233	160	77	49	75	138	62	92	165	80	87	118	99	99	143	109	106	89	115	161	132	63	106	149	113	55	60	80	91	50	101	65	63	70	124	73	100	94	116	136	69	63	136	98	135	83	68	98	99	118	130	122	53	79	88	164	99	75	235	104	66	47	81	66	41	42	58	44	69	165	60	86	65	91	61	89	67	68	87	83	74	84	93	95	73	52	61	70	67	157	149	46	59	55	101	69	50	36	49	58	185	51	82	83	73	60	55	89	73	46	106	64	49	96	150	87	42	74	142	75	89	39	127	88	142	83	60	113	88	61	59	48	39	75	64	78	106	87	92	105	49	78	90	64	61	89	103	98	116	98	86	44	84	66	53	57	82	98	83	50	66	64	90	92	65	68	78	107	106	63	45	50	60	52	45	60	74	69	54	111	60	86	46	57	70	48	160	50	98	74	54	53	62	63	95	62	72	41	167	62	39	101	22	71	131	62	53	42	25	53	131	53	49	83	101	28	34	57	79	83	57	84	61	34	31	62	54	56	51	26	98	34	37	43	34	71	77	47	21	42	16	67	36	106	37	80	35	54	62	25	79	32	56	103	43	39	26	86	35	65	47	58	38	23	50	23	35	120	49	66	64	69	47	99	43	57	52	21	37	52	66	23	21	24	117	55	54	42	82	27	74	60	70	32	54	45	40	21	30	122	23	21	29	51	52	25	44	56	43	59	77	60	34	32	31	49	41	22	31	62	16	14	124	50	22	22	35	99	52	60	19	26	60	25	46	45	24	88	29	4	33	75	36	25	65	32	37	57	29	27	32	37	39	54	46	23	31	20	51	55	52	24	42	21	61	66	29	18	25	25	18	46	30	33	31	25	18	26	21	54	23	8	44	34	43	14	20	31	46	72	24	37	25	27	28	16	26	59	15	19	26	13	34	16	14	40	55	24	10	8	38	22	16	25	25	29	18	20	39	16	54	16	16	16	35	20	49	10	28	21	34	13	22	23	23	17	18	26	44	28	8	20	19	17	22	14	47	13	23	31	6	17	13	25	7	25	15	2	17	14	18	27	23	46	13	21	13	33	13	6	15	9	21	20	16	28	10	11	14	9	12	17	15	8	53	19	7	11	25	11	11	16	14	8	56	16	16	16	21	11	12	9	11	10	16	9	16	28	13	8	55	17	13	10	6	21	4	10	10	4	7	4	6	1	8	17	5	5	22	21	6	15	6	11	8	14	3	1	11	4	3	7	28	4	5	4	0	6	4	2	45	2	26	3	2	9	4	1	9	1	6	5	0	8	4	3	4	7	25	0	1	5	5	1	1	0
ne0135	4261	3979	2092	2466	1490	1968	1979	1587	1336	1846	1287	1434	1614	1672	1750	1359	1516	992	1316	1329	1128	1267	1477	1075	899	1009	1086	1153	1188	1400	832	1111	965	946	1272	1101	1026	661	928	1180	972	877	693	820	1017	996	909	1180	1155	886	875	793	655	743	866	1098	597	991	873	653	732	703	622	731	774	795	817	962	798	674	732	531	833	721	807	704	656	657	772	657	751	778	649	759	559	622	573	635	895	791	724	778	692	570	562	687	614	567	881	742	698	641	626	696	699	684	731	696	755	606	675	683	693	647	595	538	685	718	445	605	493	659	638	706	729	759	553	494	644	612	519	760	440	545	651	422	399	399	590	480	431	724	480	409	487	743	576	381	570	730	579	408	773	626	567	427	721	548	536	557	476	408	538	587	648	456	496	601	423	483	742	381	518	790	568	491	474	496	411	293	693	536	409	430	395	429	489	493	403	406	473	650	539	436	382	438	396	524	428	573	461	362	382	555	309	508	566	399	629	467	534	523	488	604	659	530	424	401	693	390	439	401	330	690	607	471	522	565	500	407	356	449	367	411	517	475	350	432	474	306	506	625	706	410	370	514	482	421	475	515	331	462	517	362	470	459	443	593	421	335	401	585	307	571	366	459	397	330	302	358	347	347	437	314	436	350	391	432	395	353	299	394	307	247	359	312	504	396	290	391	348	485	285	345	442	413	402	235	471	327	461	254	387	410	431	362	383	392	333	271	349	362	248	321	340	324	406	318	462	404	376	494	295	303	344	392	330	325	416	264	349	478	473	323	462	371	347	482	415	336	328	383	481	504	453	362	359	420	237	262	340	356	312	333	322	369	423	288	261	176	328	315	355	278	369	329	313	356	448	363	283	232	310	297	244	294	201	405	321	303	386	365	249	427	371	410	238	258	310	237	323	272	418	303	331	257	235	310	280	294	319	468	339	301	375	221	226	343	337	245	285	259	291	365	257	214	317	329	378	303	309	184	313	394	333	520	324	307	272	219	273	316	205	282	227	318	248	200	309	221	280	225	259	258	320	248	245	196	371	268	248	276	248	225	197	189	362	231	272	328	312	207	234	255	230	242	257	188	276	288	279	279	247	267	272	223	296	232	163	203	286	213	350	190	282	234	206	345	265	309	219	224	204	170	226	197	232	300	184	292	145	218	231	182	283	230	204	208	318	297	201	307	180	165	230	204	239	208	217	256	158	218	187	419	222	194	175	258	301	205	247	317	262	173	190	177	155	308	279	301	194	169	188	265	170	180	204	181	378	263	204	218	243	162	277	266	251	219	180	151	230	231	273	184	264	302	174	229	122	190	195	145	222	191	164	207	278	247	216	212	215	147	175	138	232	199	188	229	324	207	210	249	228	177	193	184	330	241	306	197	173	212	246	242	182	183	125	169	148	186	185	302	172	175	152	128	171	173	197	184	188	161	158	375	255	198	188	270	189	135	144	163	175	213	129	169	142	214	138	154	241	254	205	236	154	110	189	250	170	194	235	197	162	210	126	198	135	148	182	155	243	236	144	145	197	210	201	239	216	159	162	121	123	151	220	224	124	136	272	280	141	135	131	188	162	199	188	155	256	107	165	209	274	108	140	127	276	247	232	89	150	191	132	187	172	204	217	141	214	267	159	227	196	201	253	183	202	133	162	191	157	169	199	145	191	97	144	155	122	103	184	137	180	191	127	193	116	188	144	120	184	95	141	237	156	159	69	105	138	120	208	136	148	194	119	153	238	192	112	174	132	96	165	341	147	98	95	227	73	129	90	112	202	125	153	164	178	144	197	147	150	177	175	115	150	130	133	190	153	150	175	170	132	221	133	205	129	164	111	125	139	101	63	128	166	158	177	168	156	157	103	225	210	154	117	192	132	111	164	66	215	133	197	98	170	170	157	126	118	146	86	113	128	142	126	114	129	126	116	187	114	111	128	82	116	68	218	134	140	116	146	140	138	170	127	85	141	118	109	123	205	98	186	125	172	134	100	97	95	107	113	125	124	156	121	110	143	101	82	151	163	239	119	153	103	93	148	110	108	114	110	95	69	104	126	111	148	114	143	133	123	125	133	119	155	133	220	167	79	103	167	108	87	124	89	127	102	125	121	94	161	146	93	87	78	95	102	166	97	73	76	107	94	114	103	159	125	159	67	103	104	139	109	151	117	98	143	134	61	117	138	68	53	100	90	83	94	104	105	95	126	100	185	135	87	104	128	116	77	114	111	110	151	78	103	59	95	96	142	157	149	125	102	102	71	107	118	99	92	101	95	122	115	94	59	80	106	130	103	134	92	119	90	137	101	95	83	91	113	90	135	119	117	85	93	91	52	92	74	135	146	64	110	64	72	96	189	110	159	117	66	95	107	98	117	86	99	76	153	108	118	127	119	107	49	43	156	69	81	105	91	103	221	121	78	57	166	92	74	68	103	114	87	90	47	141	116	109	126	74	98	125	166	93	80	84	93	58	84	86	57	123	52	87	53	62	63	108	94	46	116	79	61	65	145	68	54	52	63	75	87	97	127	113	118	76	110	80	53	100	57	75	53	88	101	98	60	66	50	67	60	79	69	80	79	76	105	127	71	116	69	61	79	56	73	76	80	71	52	75	69	39	62	115	87	86	81	60	51	39	94	60	48	68	71	65	60	100	80	88	77	94	38	82	42	53	54	91	61	119	54	82	53	103	107	62	88	54	41	106	146	60	108	58	64	66	67	75	140	73	89	83	117	100	76	72	100	122	53	103	107	71	61	71	24	46	48	45	54	64	129	57	50	60	43	68	49	46	80	97	181	119	94	39	79	65	50	121	49	71	78	63	61	48	51	58	72	64	57	77	74	62	55	50	32	65	48	59	69	35	61	46	40	151	61	65	41	59	46	69	73	80	49	65	66	79	58	64	85	80	67	67	105	51	95	46	64	56	57	82	39	46	47	47	88	53	85	60	67	43	85	61	92	70	68	34	105	100	61	77	61	58	72	75	43	48	49	40	72	49	146	68	29	16	44	50	26	50	53	87	34	68	75	108	30	58	78	47	76	57	47	75	83	51	76	43	23	45	47	59	65	91	70	44	47	64	47	46	48	46	49	55	58	77	60	66	21	69	27	55	82	39	42	37	52	57	37	65	38	51	77	56	52	36	35	40	76	50	46	42	68	40	46	44	52	35	72	51	80	60	52	39	36	29	52	50	25	68	44	45	56	62	84	33	93	89	48	67	67	125	41	51	38	59	51	96	56	46	63	24	67	47	37	12	38	49	27	62	43	33	46	43	36	33	45	32	74	46	55	25	39	70	46	30	50	29	85	41	55	12	120	26	45	35	49	28	86	50	50	31	24	45	55	57	51	34	51	29	28	34	57	17	54	23	38	31	14	76	15	12	41	51	51	30	39	33	12	65	34	38	57	35	23	56	46	45	55	23	28	52	36	27	49	26	21	34	28	40	34	34	23	56	51	45	48	26	30	30	34	55	30	58	28	42	34	40	43	30	45	31	27	61	40	20	27	23	16	37	29	59	56	24	30	18	37	18	24	21	65	46	30	34	41	33	18	103	38	15	12	10	60	34	29	24	18	43	33	34	18	22	13	45	10	39	27	12	15	30	39	21	59	22	22	13	30	15	13	45	28	55	26	27	18	60	17	40	28	20	19	35	23	17	26	11	21	36	17	16	7	23	24	71	33	17	33	7	75	34	17	16	21	8	13	13	20	13	16	27	39	10	21	20	4	17	12	17	69	32	35	20	10	24	29	21	13	23	11	11	29	30	19	8	141	19	10	23	13	6	22	12	15	16	9	15	15	22	12	32	32	33	9	13	18	16	23	22	30	11	17	9	24	15	14	18	6	16	11	29	14	43	19	14	13	17	9	15	7	21	17	3	7	16	17	12	15	26	9	22	5	2	15	3	19	14	26	21	8	11	18	31	5	3	8	13	5	11	3	7	8	3	6	11	9	16	6	4	19	12	6	6	14	7	5	7	14	5	4	5	8	4	13	4	9	7	9	7	11	4	6	16	14	7	2	6	24	1	8	34	3	10	2	3	7	5	2	3	3	3	4	8	2	11	26	7	2	6	5	8	0	10	2	7	5	11	4	22	8	4	4	9	1	5	0	2	4	3	3	3	1	0	0	2	2	2	1	1	6	1	0	9	3	0	1	5	1	2	13	0
ne0136	1613	1561	1007	725	1229	482	699	383	498	485	621	486	430	321	468	626	373	546	411	356	304	421	448	440	462	381	362	386	329	285	584	364	306	284	441	298	333	296	358	233	347	369	355	249	301	239	302	185	279	376	240	284	510	261	286	305	424	287	313	430	208	338	534	203	312	217	197	259	295	316	458	463	254	222	406	359	283	301	259	409	263	324	243	205	394	262	279	335	388	241	229	235	133	234	306	338	161	228	295	245	194	322	290	193	175	204	213	159	194	226	179	269	158	132	162	268	131	206	178	136	137	160	251	234	209	236	202	321	124	175	239	231	204	284	176	323	145	198	157	157	209	119	207	191	330	150	146	215	170	155	212	164	167	205	187	165	186	248	111	317	206	207	305	189	179	233	207	157	234	253	168	204	177	168	110	202	144	163	156	248	146	177	287	123	330	205	286	174	154	106	119	89	133	175	163	242	229	118	115	126	152	281	253	210	284	105	139	104	141	136	104	86	143	154	332	143	171	303	151	188	252	196	251	145	110	127	125	131	139	174	159	168	174	150	112	180	231	173	146	154	77	166	322	175	100	126	118	148	152	168	199	171	132	178	116	96	166	152	163	165	173	124	177	91	97	133	63	109	229	169	161	182	127	157	57	201	181	110	159	220	272	143	181	339	118	240	136	128	235	107	99	91	236	136	58	145	111	94	127	151	206	238	179	106	121	211	121	128	50	126	151	233	183	138	248	133	118	134	142	112	99	180	94	93	119	145	150	145	139	84	108	82	124	204	80	114	132	87	100	66	161	103	121	124	65	164	151	80	180	235	123	169	136	97	110	94	171	146	177	149	57	216	174	132	102	174	106	102	46	125	138	183	91	91	128	179	106	58	83	93	50	70	137	71	78	80	156	99	86	93	82	103	58	128	158	91	129	86	158	136	143	83	80	66	98	111	141	221	95	98	111	95	124	83	75	59	89	112	67	103	131	106	81	62	79	55	88	73	129	84	115	105	110	67	91	118	95	80	137	85	45	148	122	69	86	121	82	56	111	45	94	111	162	87	102	158	113	121	90	135	92	93	170	129	159	92	147	45	105	72	152	41	83	138	66	98	75	111	137	130	94	117	35	92	56	105	113	32	157	75	70	108	92	116	107	83	77	86	95	83	90	83	66	109	114	68	139	105	67	59	92	79	68	97	95	115	80	43	87	46	106	86	180	108	105	105	71	75	90	126	87	53	40	75	161	80	100	59	98	93	110	113	61	76	170	89	121	103	68	58	104	73	41	70	88	62	41	73	114	88	25	79	74	76	56	81	94	46	81	98	105	39	94	59	83	77	70	101	55	63	68	85	109	93	70	51	73	55	53	59	110	36	72	87	37	55	37	71	55	69	91	44	55	67	83	70	96	104	97	118	65	53	86	80	86	150	106	73	151	66	122	103	90	65	39	68	63	50	42	73	45	65	84	77	55	58	68	90	58	58	53	71	46	73	96	82	43	68	85	37	81	76	44	39	65	53	57	83	50	55	24	74	65	60	96	49	37	59	42	54	42	112	38	87	39	48	68	90	57	64	78	26	80	74	48	27	32	58	42	104	60	66	31	87	91	60	80	69	41	193	17	37	33	95	45	57	41	55	64	63	105	25	43	26	70	54	35	97	61	79	41	76	29	79	52	72	42	33	71	43	98	88	94	77	64	73	94	57	37	55	33	70	40	23	41	46	44	51	51	51	44	80	82	32	82	37	43	73	54	58	43	57	61	53	36	99	115	47	67	95	107	17	50	52	137	42	21	51	28	43	31	24	78	34	54	56	77	29	85	59	49	23	24	49	28	22	52	61	31	78	20	38	53	48	27	69	34	29	32	36	76	24	24	42	98	42	57	55	32	74	80	34	18	47	43	49	40	90	69	68	59	55	34	43	56	70	59	61	80	66	29	29	68	33	71	83	97	58	40	155	40	72	34	41	109	60	32	62	44	36	56	41	18	102	36	78	55	26	61	92	31	58	66	22	54	55	17	19	91	30	58	40	35	28	27	38	43	44	55	26	31	59	62	30	33	42	12	51	64	30	121	59	91	26	77	37	71	44	41	57	62	55	13	20	37	28	81	31	33	90	32	23	15	34	47	65	20	17	36	93	65	29	15	61	55	33	59	32	62	30	45	22	40	44	85	50	21	22	46	6	52	52	84	77	20	40	69	51	72	46	14	86	33	30	76	44	56	56	56	73	58	50	24	40	36	38	30	40	25	31	33	34	39	28	33	21	19	57	31	23	37	18	60	18	66	48	49	37	22	27	33	22	55	43	40	52	21	55	22	26	35	53	36	28	38	24	47	46	21	23	43	35	21	40	26	44	23	36	28	31	71	47	28	10	67	30	18	66	22	23	45	27	25	30	58	80	24	63	40	32	41	39	15	26	33	39	33	37	20	41	23	62	27	36	18	35	64	20	33	18	30	14	11	39	38	42	15	58	48	32	36	14	30	53	44	25	36	26	22	32	26	26	28	69	14	44	57	21	30	29	28	43	25	40	20	43	34	31	12	21	46	14	75	15	12	51	30	26	55	57	79	27	32	29	57	26	13	83	41	14	28	52	46	17	49	89	29	29	20	35	24	51	47	17	32	25	18	46	51	34	29	61	74	58	68	25	22	21	9	20	37	42	68	34	34	24	58	18	56	42	38	20	66	43	16	22	7	11	80	73	17	11	45	51	29	26	24	16	24	20	16	7	41	22	37	20	30	13	47	16	5	24	24	29	34	33	27	37	51	25	42	37	30	17	8	17	63	26	25	14	19	58	13	7	21	25	20	26	47	13	19	18	56	17	13	42	19	31	38	34	11	21	22	63	23	52	41	25	26	31	8	29	9	14	27	11	48	24	23	7	34	62	28	9	7	39	9	22	36	13	33	17	8	47	23	9	42	25	50	26	40	23	44	21	29	23	13	34	27	32	20	12	14	63	4	37	20	8	20	15	4	13	32	20	24	23	17	31	23	20	20	2	72	21	38	20	20	28	12	38	39	8	33	24	37	14	28	17	21	7	30	18	8	8	32	32	56	53	21	19	23	30	8	15	11	20	18	30	23	56	19	18	17	20	21	15	29	30	18	13	12	6	15	21	16	8	27	15	16	16	17	10	9	10	23	22	13	12	25	6	11	30	12	57	37	33	15	29	2	18	15	7	17	8	35	10	19	8	17	17	26	14	5	11	9	9	16	12	21	12	18	12	10	18	13	13	7	9	39	21	10	23	26	8	21	18	64	38	18	11	19	12	18	15	13	6	13	39	12	11	13	5	16	42	29	24	5	10	16	32	57	24	7	13	23	12	6	10	23	10	12	30	8	10	8	15	6	3	13	28	6	21	14	13	6	19	13	6	10	42	7	8	9	28	19	16	27	7	26	12	18	7	15	11	3	10	33	2	10	11	4	22	7	14	19	17	11	21	20	12	16	21	3	12	15	15	3	12	9	6	9	5	9	8	7	15	29	11	9	18	5	9	20	19	51	40	15	19	8	2	11	22	5	25	9	11	20	25	8	5	26	6	19	6	15	7	7	10	10	6	7	3	5	11	34	2	5	12	8	10	17	4	19	48	22	16	3	13	6	10	4	10	19	9	7	16	14	7	12	3	15	17	14	3	10	15	4	12	12	1	11	2	5	4	9	54	18	13	30	18	8	16	4	11	9	38	8	7	13	6	2	2	3	4	6	3	15	3	1	15	9	16	15	6	3	15	3	7	13	12	11	6	7	18	4	1	17	17	0	8	0	16	17	14	0	5	10	1	8	3	3	12	10	7	8	5	6	14	4	27	7	9	5	6	11	8	6	4	25	10	13	0	1	6	3	8	3	6	3	11	0	1	7	9	3	26	3	7	1	6	4	7	5	6	4	0	0	8	7	14	2	6	16	2	3	1	3	1	7	1	5	7	4	6	5	3	4	2	6	6	2	2	5	6	2	1	1	5	27	6	3	5	1	3	0	8	2	3	11	10	1	7	2	3	3	5	0	4	2	0	1	2	0	1	3	2	15	4	1	1	2	3	0	4	4	2	2	11	16	3	2	2	1	3	0	3	0	0	1	0	0	0	8	3	0	1	2	0	0	0	11	0	1	0	2	2	0	3	3	2	0	2	2	1	0	0	1	0	1	0	0	0	0	0	0	0	2	0
ne0137	750	1413	759	386	762	238	379	158	295	345	381	245	324	231	376	605	236	268	315	218	205	260	367	219	252	251	225	325	281	326	398	316	224	143	454	276	216	174	213	205	188	260	188	132	146	119	180	133	395	239	85	151	251	155	159	267	266	178	230	211	85	255	439	129	173	161	86	181	205	185	382	312	229	163	275	170	133	175	239	242	160	288	56	120	218	98	252	225	258	181	159	190	37	181	170	312	43	175	159	106	138	222	207	71	102	132	110	54	136	140	156	194	82	46	49	182	35	149	140	31	86	45	172	231	214	99	192	92	28	72	114	230	164	195	134	257	92	116	45	114	88	104	102	134	294	116	105	125	146	147	117	98	144	151	96	152	132	181	27	63	101	166	214	103	157	151	174	160	127	99	215	140	105	94	21	174	108	87	83	184	62	125	129	50	136	151	151	180	122	86	66	67	74	103	100	98	115	42	115	54	83	98	115	125	158	62	99	101	203	108	21	50	114	124	376	155	111	239	164	74	156	121	203	130	126	90	94	140	177	84	114	129	85	159	79	169	113	117	97	91	31	95	192	84	67	119	75	76	108	174	90	136	132	70	94	18	104	89	116	88	118	55	119	74	68	141	68	63	179	119	92	137	54	97	24	83	81	69	163	137	216	96	69	181	99	187	186	68	260	96	62	49	154	80	56	93	57	35	118	87	150	60	121	71	101	103	35	137	45	69	90	109	98	55	169	95	99	100	71	67	103	232	83	64	54	76	87	97	89	39	54	46	98	103	56	96	75	57	72	52	87	90	113	206	41	176	177	58	94	148	88	82	81	103	72	45	71	121	77	114	32	147	59	71	151	62	52	74	63	89	92	93	108	52	72	110	72	39	50	60	55	46	100	44	91	42	60	87	58	50	59	51	40	96	96	61	117	63	128	63	98	41	42	62	69	107	89	329	39	64	55	65	88	44	60	25	52	79	75	68	89	133	61	92	115	53	61	57	99	71	31	116	78	73	39	130	73	61	117	67	19	89	130	57	76	101	48	42	123	25	67	54	137	58	64	96	82	111	124	130	43	51	78	120	87	30	56	24	94	28	30	16	58	81	50	46	49	42	79	64	48	69	27	51	30	126	60	34	113	134	49	93	78	80	63	56	80	80	50	77	46	43	44	22	83	36	117	140	49	43	61	80	38	59	90	99	55	24	42	17	60	42	142	138	59	105	56	63	93	88	55	73	39	45	128	56	84	74	57	105	104	112	49	51	106	39	111	20	83	38	64	47	58	59	79	56	54	45	53	63	29	51	77	52	26	28	60	31	59	41	39	33	26	50	77	15	51	47	30	21	49	48	55	70	53	37	55	38	32	34	60	19	47	63	21	25	30	58	42	41	66	21	49	17	59	70	57	28	44	88	32	61	52	79	53	68	58	46	75	40	101	32	63	64	33	56	53	56	31	47	38	49	56	60	39	45	29	90	30	31	49	84	57	71	23	26	47	49	64	33	83	41	29	12	46	80	17	18	58	37	56	35	25	39	101	43	49	34	27	31	19	42	48	20	33	16	37	41	27	44	32	15	77	37	15	11	9	70	69	45	45	63	30	80	53	21	42	71	52	110	14	28	22	58	19	24	11	43	26	82	77	27	53	13	42	23	18	125	64	52	14	70	21	47	15	22	26	23	55	30	146	50	63	40	22	32	54	21	20	40	26	70	14	32	48	45	50	40	52	40	11	64	53	41	14	24	17	51	22	19	27	44	35	21	20	49	45	38	114	128	87	29	38	31	108	28	21	42	14	24	12	28	90	30	20	38	33	16	43	58	48	27	27	35	20	28	34	47	19	85	8	20	37	30	15	41	16	26	15	53	39	9	16	21	48	16	43	60	31	38	26	23	10	54	22	31	11	66	62	68	12	37	9	36	56	48	24	19	88	56	17	26	7	33	27	4	20	37	23	152	25	115	22	51	72	52	44	54	27	31	28	27	28	72	20	21	40	42	33	129	14	58	83	11	44	41	4	26	48	30	60	39	21	36	14	36	22	31	61	19	19	29	23	14	16	26	22	37	52	20	157	53	45	18	48	44	36	47	48	31	54	56	8	19	15	14	45	35	50	25	25	12	15	28	93	16	20	40	13	55	17	29	8	36	19	16	63	29	43	24	56	20	6	15	45	35	17	45	25	10	16	29	47	22	23	13	18	53	83	21	1	43	31	21	24	32	27	33	20	15	35	50	39	13	27	16	10	30	34	19	38	25	24	11	26	31	7	21	14	18	28	12	40	14	28	21	49	20	8	28	22	10	53	50	18	24	19	35	21	19	22	45	29	16	44	20	13	20	9	34	43	21	33	16	17	18	30	19	23	17	55	19	26	9	51	23	20	48	42	26	31	8	19	16	25	50	32	35	30	55	24	27	44	26	10	19	35	21	12	23	18	56	22	16	4	29	61	15	36	12	6	18	16	12	11	17	16	21	35	30	21	4	15	16	33	8	36	7	21	30	31	33	23	48	12	25	24	20	10	18	12	17	26	14	5	24	32	20	3	16	31	14	60	16	9	34	24	14	16	31	116	31	12	27	28	11	16	45	12	19	10	28	27	7	12	64	16	11	10	21	30	43	14	9	19	32	13	46	13	11	28	21	27	45	53	13	11	14	15	16	13	51	48	16	39	16	31	7	41	37	17	22	93	62	9	20	23	7	67	50	7	23	24	36	19	22	25	17	20	11	5	3	25	27	23	19	19	13	46	9	5	23	11	19	21	33	11	26	37	18	24	18	24	17	11	11	14	13	2	31	10	42	6	6	10	5	6	19	32	10	43	32	67	8	13	15	17	27	49	12	4	14	20	36	23	51	7	13	7	56	18	10	6	25	23	9	25	16	13	18	16	65	22	12	4	30	24	32	14	7	44	11	4	10	14	7	31	27	28	17	27	6	21	20	20	21	16	18	14	13	21	12	0	52	7	24	26	8	2	13	20	13	23	18	24	18	29	18	7	6	8	2	16	39	21	14	16	9	9	37	20	5	17	22	34	14	27	31	29	15	9	14	10	14	38	10	13	40	33	5	7	20	15	14	15	12	9	7	8	38	10	17	14	24	31	9	8	23	6	2	12	10	19	16	10	14	20	9	7	6	13	1	12	8	8	22	6	13	14	2	7	24	7	59	50	30	13	22	3	4	25	8	14	2	39	5	11	7	21	15	32	5	7	6	11	8	22	5	22	22	9	9	7	12	9	9	17	20	29	11	5	16	14	1	12	3	19	3	16	12	14	6	11	8	21	7	7	17	4	2	5	6	7	21	19	31	4	8	4	19	3	4	3	17	13	9	3	2	16	11	12	7	2	14	9	7	8	8	7	23	9	23	17	12	8	27	8	14	1	13	14	4	14	25	6	1	29	3	12	8	28	5	2	7	6	5	32	2	9	17	13	14	7	10	8	9	9	16	10	20	6	26	1	11	12	8	5	9	10	12	8	5	7	10	8	8	19	7	3	45	0	18	10	5	56	6	4	8	5	3	2	20	4	14	24	4	9	16	7	5	14	6	12	18	8	28	1	6	5	9	0	4	4	2	24	12	2	12	8	10	22	6	11	12	11	21	3	3	5	7	7	4	26	3	4	9	6	13	3	3	6	19	5	1	1	16	3	5	25	6	16	3	6	5	16	36	3	12	12	9	3	6	11	12	5	16	9	7	4	4	1	1	0	5	9	4	21	1	1	6	6	5	5	1	5	10	2	1	8	13	5	6	4	14	1	0	21	9	0	7	4	1	4	3	2	2	3	4	1	0	2	8	23	7	5	3	5	6	2	11	0	6	3	3	7	10	19	9	1	1	3	1	0	10	2	1	3	2	26	4	6	0	0	4	3	19	1	3	3	6	0	13	7	3	5	3	3	4	0	11	0	4	19	1	1	1	2	0	4	0	6	1	4	5	4	6	1	2	6	3	0	3	1	1	0	1	0	1	0	6	1	4	0	1	0	2	0	3	8	3	0	1	7	0	0	2	0	2	5	2	2	0	1	1	0	1	2	0	1	0	1	0	0	4	2	2	1	2	0	2	1	1	0	0	0	3	1	1	1	1	4	0	11	0	0	1	2	0	0	1	0	2	5	1	4	0	0	0	1	1	1	1	2	1	1	0	0	0	1	0	0	0	0	0	0	0	0	0
ne0138	939	1265	661	329	1076	254	374	168	397	369	544	311	271	219	411	397	248	385	227	225	254	260	329	217	352	358	361	225	207	262	667	336	203	167	402	232	297	242	305	190	191	237	236	162	233	121	144	135	236	271	108	179	310	184	160	182	266	258	211	284	101	302	561	231	175	156	112	288	198	199	318	240	173	217	391	269	242	205	203	290	197	277	89	155	347	161	236	215	268	191	129	205	71	206	234	228	76	208	139	110	141	214	217	91	122	112	186	108	148	110	122	180	96	61	72	185	67	184	201	51	104	67	219	167	189	175	217	149	63	100	199	162	206	261	117	315	113	157	71	162	188	139	165	158	267	132	174	193	139	162	122	115	112	133	143	193	116	238	53	119	150	177	215	117	134	250	180	210	147	100	126	154	118	134	48	158	112	96	141	216	93	119	185	68	237	179	165	171	141	120	101	82	156	109	135	80	178	71	88	102	91	113	158	178	287	89	86	76	146	114	49	114	120	83	111	184	146	323	139	106	170	124	209	91	109	159	126	150	180	102	164	133	107	219	89	154	179	168	124	115	74	128	148	138	152	80	86	108	106	127	122	121	122	126	131	44	105	64	111	113	74	105	113	52	119	95	42	110	213	141	194	142	83	113	41	148	65	68	118	181	259	94	85	274	142	328	134	69	227	72	75	48	228	66	49	146	108	128	72	111	150	133	169	73	88	94	87	159	50	102	132	137	121	95	200	130	80	138	92	54	92	154	97	106	70	107	125	101	94	98	86	42	51	62	55	84	85	59	64	41	98	74	75	55	45	172	119	43	154	185	84	138	130	79	84	62	73	133	144	110	41	259	53	155	108	96	74	64	54	78	133	233	75	47	106	199	66	58	49	77	52	54	128	41	69	71	57	67	74	87	71	65	59	77	111	80	143	62	228	65	103	41	56	72	91	116	111	101	63	71	83	97	109	46	54	35	64	85	65	43	94	218	48	40	74	39	51	65	100	76	91	156	61	48	78	49	72	45	148	94	32	105	206	43	96	88	113	50	126	59	69	67	100	83	94	120	62	91	106	109	58	40	103	95	104	49	82	24	108	92	73	31	79	79	28	88	76	61	90	105	58	55	25	85	27	159	78	72	70	65	126	71	118	159	91	83	81	85	75	104	78	46	49	28	35	51	159	106	64	45	55	70	51	91	108	130	74	44	60	55	91	62	130	62	82	82	37	49	46	42	53	26	38	51	119	54	84	79	74	103	63	118	93	53	175	97	114	99	82	29	104	70	40	58	80	38	73	74	82	80	48	60	101	46	36	40	109	35	97	51	46	38	48	55	69	38	64	46	26	38	60	69	64	70	57	66	57	62	42	39	79	26	94	112	41	79	32	55	50	59	48	48	51	98	78	74	61	51	74	59	94	27	67	98	65	172	40	67	98	42	165	53	59	43	28	67	48	15	40	43	35	56	56	51	56	48	104	70	47	38	30	40	68	106	55	50	33	84	76	21	94	77	22	25	72	23	27	11	38	39	16	54	51	57	126	46	61	31	83	39	31	69	31	17	40	61	49	47	32	27	39	18	42	33	23	17	22	65	44	105	62	38	17	73	129	35	35	76	67	145	42	30	25	37	17	71	41	50	35	35	124	23	22	21	44	35	18	82	37	39	23	102	26	64	21	39	39	34	63	51	100	85	54	38	41	65	99	37	25	67	25	63	21	10	35	37	41	68	39	39	15	96	97	19	75	21	36	90	36	42	37	17	37	29	45	131	37	35	105	71	113	25	47	23	61	29	18	46	35	38	4	28	61	23	23	37	38	16	74	58	94	42	12	65	19	19	37	36	26	120	20	27	62	28	16	42	17	71	32	32	45	13	18	44	121	13	62	50	84	22	10	20	53	85	23	25	19	95	34	46	64	23	16	62	31	51	31	32	90	58	21	29	5	40	57	77	33	41	8	204	22	82	9	39	75	73	12	60	35	105	21	34	9	63	40	54	55	24	42	120	36	47	63	9	23	53	8	11	36	28	57	9	35	36	9	35	24	42	55	13	27	55	40	26	15	35	11	39	51	14	93	46	53	10	51	70	29	39	61	52	78	43	23	10	25	25	68	30	22	38	17	13	39	18	21	46	30	13	24	101	60	25	13	28	18	15	59	23	76	28	72	16	23	17	23	42	22	26	73	6	22	50	101	33	16	29	52	59	75	32	16	48	15	11	48	45	25	32	34	27	51	57	16	17	36	26	25	19	23	15	28	24	9	20	52	26	16	27	31	18	35	18	80	22	60	39	22	35	40	26	41	17	57	45	27	34	26	112	36	14	15	43	60	13	9	20	77	38	15	18	44	38	31	36	25	24	31	76	54	31	46	41	22	7	49	14	25	42	23	23	52	20	28	14	73	82	19	61	17	13	28	103	15	34	25	70	54	22	29	26	6	113	17	14	2	9	15	42	20	16	35	18	45	12	47	27	12	33	65	14	26	10	29	23	64	21	31	24	18	12	34	42	30	43	29	29	42	59	25	24	10	28	38	9	19	29	62	32	14	20	59	7	68	11	6	52	21	18	83	51	108	21	15	33	39	18	13	26	22	20	17	32	37	9	24	36	24	35	31	12	40	25	78	15	20	27	17	37	17	22	12	42	66	97	41	9	13	4	6	16	19	32	74	29	29	22	25	12	57	29	40	27	71	32	26	16	22	14	66	56	12	29	9	54	11	57	13	10	24	10	3	4	26	9	25	26	47	3	58	13	6	18	35	30	46	42	9	69	94	19	35	30	44	6	8	13	34	26	14	28	11	39	9	21	27	16	20	9	39	18	25	5	61	14	13	28	14	20	25	17	16	21	17	32	48	38	15	15	23	38	16	23	7	12	25	16	30	14	40	21	16	113	21	7	13	35	6	14	20	8	14	20	7	31	24	6	17	25	54	14	29	23	35	21	26	23	14	36	9	25	38	3	7	20	0	28	32	9	18	19	13	12	22	11	37	28	24	44	15	18	14	9	30	42	25	13	22	64	13	37	29	7	23	30	46	10	19	26	7	2	7	26	2	22	26	12	6	43	36	22	10	20	3	14	6	19	27	21	53	65	21	13	4	19	12	14	20	27	17	11	6	19	5	31	26	5	23	13	7	12	22	8	6	20	25	30	8	7	29	6	3	57	4	34	18	43	19	14	2	5	9	4	7	3	26	12	22	1	30	9	24	10	6	24	6	9	22	14	28	11	12	29	23	14	12	11	13	6	29	18	10	40	44	4	16	13	16	16	4	40	11	7	31	9	37	6	10	19	6	16	27	38	3	34	27	50	1	14	8	39	3	5	13	5	40	24	5	4	23	11	24	14	4	29	14	4	5	19	24	24	8	9	1	13	10	7	23	12	6	38	10	23	8	55	30	5	87	9	23	11	14	10	11	3	7	4	50	15	17	37	12	42	6	5	25	8	1	16	8	5	10	23	16	4	29	4	11	12	3	2	13	9	5	5	14	2	23	17	4	27	2	8	9	3	47	33	16	10	16	1	0	22	14	22	6	17	14	10	2	5	40	4	11	2	16	10	3	8	29	11	8	1	7	8	43	5	8	7	3	27	25	2	13	33	8	8	9	11	1	9	1	10	29	6	6	18	14	4	4	0	12	32	27	1	4	34	4	7	10	1	41	3	5	8	0	8	6	4	12	16	11	6	5	14	7	26	0	2	17	7	6	2	5	10	1	6	16	4	12	6	16	11	15	3	6	11	6	8	8	3	3	9	7	19	3	0	19	28	1	1	5	4	15	27	2	2	10	1	5	2	2	10	4	12	13	15	6	6	0	24	4	8	3	10	15	3	16	11	2	4	5	8	1	4	22	0	0	9	44	5	0	0	5	23	5	44	5	2	1	11	3	14	2	22	7	5	3	1	10	9	4	33	6	2	2	1	1	4	4	2	8	7	2	3	22	7	8	3	4	9	2	9	1	3	2	2	0	2	0	3	5	8	7	27	4	28	0	13	3	7	2	0	0	3	3	4	1	7	1	0	0	8	3	10	0	1	0	0	3	0	0	0	0	2	0	8	1	8	9	0	3	1	2	0	1	6	0	0	1	1	2	0	5	3	1	2	0	1	2	0	0	3	0	1	3	3	0	0	1	0	1	0	11	2	1	0	2	1	6	0	0	0	2	1	1	0	0	0
ne0139	1696	1466	971	1259	909	841	948	662	812	712	771	738	595	561	396	679	531	768	336	558	463	453	522	682	512	578	479	391	381	315	491	400	481	453	329	437	430	482	495	333	415	345	508	376	416	408	499	217	194	490	448	443	387	446	274	342	716	522	309	418	378	376	428	444	439	272	411	222	368	438	235	337	330	335	347	443	401	308	261	355	343	253	394	337	351	414	270	324	323	227	278	233	346	270	252	269	382	255	176	242	238	274	305	352	240	337	246	367	262	165	231	255	371	339	378	223	385	217	247	329	248	344	361	188	312	279	230	337	377	337	400	198	315	200	221	179	217	259	311	237	332	205	247	252	234	160	334	309	165	154	261	280	149	230	209	250	151	299	306	255	274	234	268	173	240	212	243	164	189	311	141	320	282	140	345	218	262	302	295	251	211	238	307	207	330	190	257	169	215	189	226	139	180	316	295	233	219	286	156	183	178	327	272	198	225	162	211	171	171	141	316	218	148	152	144	123	309	183	155	243	245	214	182	110	89	187	187	148	180	253	209	168	247	173	132	146	191	224	268	229	205	253	220	141	328	185	137	221	217	154	295	248	184	388	224	276	239	161	182	242	176	153	166	99	132	164	102	254	206	141	197	177	203	207	192	219	206	136	150	177	231	149	174	296	190	148	100	156	182	127	216	162	171	145	84	205	166	177	75	190	139	232	159	126	106	216	198	85	112	231	165	143	159	243	158	276	102	155	157	145	107	112	180	186	147	89	154	166	97	323	106	133	139	262	100	106	135	82	167	194	135	114	126	113	142	127	90	143	173	258	164	146	141	121	123	111	164	166	136	135	130	115	89	169	129	144	121	113	64	90	171	165	154	125	181	169	121	141	114	169	191	123	151	110	64	149	316	161	108	136	151	105	138	120	223	146	111	155	111	187	95	49	135	83	106	132	142	115	97	131	150	171	95	124	120	152	125	153	103	62	102	80	90	69	103	52	100	83	75	114	102	144	147	91	118	107	104	106	73	150	140	95	165	120	92	150	149	125	87	60	124	175	87	129	126	132	140	112	109	137	122	55	127	93	151	107	115	108	140	129	167	50	86	78	53	95	81	123	117	95	131	196	75	129	107	85	91	63	96	66	85	108	83	124	114	143	85	64	112	125	112	94	87	71	71	131	148	100	80	79	94	75	85	154	115	126	108	120	118	112	119	97	110	73	114	111	103	79	111	67	66	84	77	112	89	115	111	71	168	103	86	79	107	114	64	128	110	179	148	87	104	68	89	125	50	91	81	143	64	141	82	100	74	172	104	67	115	74	89	120	147	88	170	110	132	58	55	127	101	191	82	124	142	106	48	107	91	69	49	63	77	112	43	80	84	48	45	121	87	101	42	120	94	107	109	71	80	111	134	99	70	99	99	81	68	147	67	108	76	74	72	83	85	69	54	104	70	55	61	90	64	112	96	58	94	73	58	67	82	97	60	54	70	70	125	152	108	42	81	58	60	103	109	64	132	70	62	63	59	39	45	65	51	105	75	73	42	101	59	98	69	107	33	62	69	53	119	114	49	96	106	56	63	61	80	69	48	70	41	94	86	58	57	84	52	94	45	43	41	53	70	82	98	49	47	51	73	42	76	33	58	60	82	55	74	78	79	63	73	43	49	49	37	75	129	72	85	46	100	65	42	80	38	93	59	74	96	43	58	78	92	67	45	28	68	71	81	71	47	97	63	103	87	25	84	61	70	61	54	63	50	31	39	56	94	91	170	45	74	43	143	57	84	78	53	40	34	144	48	70	50	35	46	49	106	72	26	78	96	44	38	23	26	78	43	34	53	70	43	53	44	76	150	67	86	50	65	50	60	27	87	62	64	32	77	57	84	43	41	99	41	74	56	69	51	73	71	37	84	36	100	88	64	44	58	57	64	67	77	81	51	51	41	59	60	135	74	132	56	51	64	51	43	62	52	62	31	81	64	63	45	67	22	67	30	63	62	60	47	60	48	65	34	59	77	52	22	58	46	32	29	63	59	26	38	50	55	53	52	57	38	76	69	43	31	56	42	40	24	34	40	39	39	30	51	96	101	56	88	45	63	53	71	56	36	34	66	35	63	77	53	38	48	46	49	73	60	15	44	55	90	39	40	51	63	96	72	28	42	74	38	38	75	29	56	65	45	47	53	43	51	92	84	51	59	37	69	40	39	97	48	63	49	27	45	65	52	45	40	51	60	68	50	39	44	73	75	53	42	21	42	65	20	30	37	38	27	46	47	28	43	37	53	43	75	58	21	27	54	32	36	69	27	43	62	77	49	57	43	33	28	41	72	69	24	54	47	53	63	44	20	40	28	130	34	38	13	43	44	48	29	68	16	34	24	57	40	73	53	42	27	41	61	26	41	29	14	53	38	16	37	27	16	28	76	99	48	93	73	48	25	14	57	20	46	37	28	29	10	37	45	38	15	66	44	48	31	62	46	27	49	69	52	41	75	23	15	32	21	39	61	20	59	42	19	62	55	37	72	33	50	27	37	37	67	44	19	52	25	23	57	11	33	38	14	25	47	47	30	44	31	39	15	27	74	30	23	28	51	22	30	62	25	9	42	30	29	44	27	23	25	12	46	19	31	34	38	27	64	56	41	38	60	26	57	15	27	39	32	17	35	42	68	48	61	89	74	11	42	22	39	37	30	21	37	45	32	33	23	39	26	21	28	25	47	21	43	37	8	20	13	21	16	60	8	27	17	20	26	19	11	31	78	39	58	26	5	44	41	37	29	39	18	16	26	8	28	22	24	7	15	54	34	61	57	64	39	22	40	17	23	19	26	29	18	33	16	12	43	41	44	18	21	38	23	47	30	19	30	31	19	65	17	24	17	42	47	22	25	37	22	29	28	12	19	27	11	7	37	27	29	17	28	25	16	16	60	31	58	19	36	46	26	28	49	37	40	26	20	19	15	21	37	39	24	15	22	22	33	22	29	16	13	31	27	19	26	35	18	45	13	15	27	46	37	32	32	22	28	14	29	8	37	6	18	20	15	34	32	37	38	18	8	30	45	50	185	30	27	13	23	11	19	34	12	26	17	56	7	34	23	18	19	39	14	34	24	20	27	7	11	17	9	38	88	12	18	14	23	18	23	18	19	47	37	30	18	10	31	10	9	15	14	9	15	8	20	9	23	13	7	16	25	38	13	40	25	8	18	22	8	16	13	18	17	33	15	24	19	11	13	15	32	19	21	28	17	10	18	21	32	8	41	18	13	11	14	23	17	19	33	16	19	32	12	27	41	21	48	26	23	18	12	21	12	22	6	25	55	42	38	40	30	12	42	17	28	19	25	17	17	17	4	12	16	5	7	22	38	11	16	15	8	14	12	13	18	12	29	31	15	5	25	22	27	23	24	6	21	14	7	26	18	17	7	6	17	39	20	15	24	38	12	4	18	12	48	17	13	16	16	20	43	27	16	28	31	6	10	7	16	21	18	22	27	11	21	17	10	21	25	1	23	26	32	22	12	50	14	3	12	18	18	16	19	10	24	19	16	29	44	8	18	5	8	9	14	27	11	12	10	10	16	5	30	19	9	6	8	13	24	10	20	21	11	7	18	6	3	17	4	10	17	25	5	42	20	7	14	26	11	16	6	5	18	11	5	5	5	3	36	11	6	8	5	11	0	23	8	12	1	6	16	13	6	25	10	14	9	20	12	17	12	12	4	9	10	7	7	29	20	21	17	23	0	6	1	17	6	2	7	6	18	2	12	7	1	28	8	3	22	22	11	10	10	3	8	3	8	7	4	18	6	8	2	8	3	3	4	3	6	7	12	8	14	3	3	6	10	13	1	4	3	4	17	5	7	6	18	1	1	3	8	5	7	6	7	7	2	5	21	2	3	4	9	3	2	3	5	5	2	14	3	0	4	7	18	8	3	1	12	6	7	5	2	1	4	5	3	0	7	1	6	3	7	17	1	1	8	5	1	0	6	4	10	4	3	18	2	2	0	12	5	2	3	4	7	2	1	0	1	5	2	4	0	21	0	0	2	0	1	0	2	2	4	3	6	2	16	4	0	2	2	0	5	1	0	1	5	2	1	0	8	6	1	0	1	2	0	2	0	1	0	0	0	1	0	0	0	0	0	0	0	0	0	0	14	0	0	0	0	0	0	0	0	0	0	0
ne0144	4169	4369	2767	2013	2217	2388	2201	1841	1695	2496	1660	1789	1612	1558	1340	1658	1611	1329	1718	1394	1394	1716	1324	1557	1105	1096	1132	1359	1557	1372	966	1498	1126	1147	1224	1207	1176	942	1223	998	1354	1057	1103	934	1257	972	1081	1121	1305	1076	1186	937	874	1070	1029	1273	862	803	977	953	973	957	688	757	761	1011	1077	1072	1084	823	891	1071	1107	693	935	826	622	686	833	1003	958	768	846	1000	694	786	806	824	960	724	902	839	882	681	822	844	982	683	931	902	747	925	901	867	794	691	686	766	685	982	783	724	808	873	710	639	707	861	730	758	830	891	608	832	691	772	675	913	676	718	594	840	598	682	740	537	627	676	697	636	585	805	1029	642	554	642	637	566	652	560	677	550	556	611	649	579	612	601	636	634	584	595	595	516	691	630	577	546	432	782	765	523	648	513	564	551	680	607	509	545	740	594	621	628	563	477	643	614	573	582	603	581	881	582	478	737	653	568	506	495	559	494	736	593	764	767	680	508	650	579	560	499	648	722	1013	556	562	615	461	411	411	602	479	514	574	579	513	485	697	554	553	482	522	545	812	391	463	455	427	457	483	619	600	449	329	441	421	473	600	612	520	375	533	496	535	499	576	466	606	475	512	416	446	390	385	520	476	397	617	388	476	410	544	402	435	377	431	486	420	470	429	535	572	439	392	374	510	515	400	467	455	576	428	509	384	483	517	333	455	392	353	325	480	527	481	422	413	482	399	437	374	401	433	477	452	327	406	297	540	480	468	438	328	372	331	399	454	475	498	355	477	526	429	461	450	445	414	425	353	378	506	420	527	607	426	479	374	284	390	348	339	444	431	541	408	453	310	410	365	424	437	365	435	333	333	386	508	405	392	403	344	301	439	399	376	383	421	297	321	345	389	357	339	435	417	494	318	392	278	319	440	310	380	321	490	325	365	416	321	375	408	282	378	360	501	353	321	435	252	335	287	383	360	395	353	290	339	377	327	491	346	411	374	496	288	250	375	435	314	310	394	305	310	331	327	489	288	363	220	262	320	261	343	379	469	344	312	309	307	451	259	424	438	281	288	272	309	323	303	342	385	324	329	382	323	265	280	203	228	375	316	338	315	373	350	314	364	294	268	415	302	246	321	255	367	326	433	380	343	309	199	257	191	263	272	224	377	367	240	363	354	291	449	311	394	211	270	343	352	389	335	351	311	357	226	274	304	188	271	283	224	220	292	410	254	219	347	439	265	434	406	257	273	273	252	246	333	331	241	281	340	232	330	275	142	339	194	187	220	361	311	210	324	262	248	311	410	227	372	259	255	335	309	199	286	356	228	361	320	218	292	235	233	241	194	241	286	365	231	218	319	198	237	290	286	250	302	239	181	318	221	219	310	171	227	211	272	295	331	181	224	204	186	245	199	213	244	185	174	179	221	235	214	209	223	171	248	210	255	196	202	197	249	176	346	186	335	356	212	210	320	210	209	223	211	231	162	248	208	241	346	148	233	311	185	188	143	294	188	214	158	179	199	172	167	172	253	265	221	207	264	284	217	237	213	283	232	194	224	241	283	155	217	211	187	245	151	242	262	159	190	168	226	232	173	284	257	158	170	153	225	310	193	207	152	137	254	182	316	175	178	245	182	207	204	211	189	171	216	192	214	231	177	208	180	151	210	202	167	161	178	230	249	158	171	145	196	265	168	207	143	188	143	189	164	135	162	255	158	174	172	198	303	192	302	173	247	174	196	164	192	141	156	171	151	153	234	248	126	184	198	399	165	187	174	127	202	221	136	219	206	168	255	171	186	153	305	219	253	197	201	195	252	224	177	151	332	175	126	244	178	205	301	93	131	133	234	201	226	167	213	150	176	169	183	157	128	220	134	233	142	181	189	162	156	218	151	236	174	119	216	163	181	160	170	189	142	168	121	171	152	106	126	166	115	161	133	167	120	207	105	135	173	158	187	88	124	161	118	158	136	191	182	176	142	137	153	141	131	95	114	111	118	147	221	94	148	130	116	313	145	101	82	182	154	141	156	112	136	222	182	136	137	121	132	136	188	127	122	124	140	311	105	154	174	179	215	145	133	220	156	176	142	197	98	89	232	170	114	154	171	220	159	153	144	148	116	230	143	94	115	175	222	129	147	83	129	129	119	148	148	150	139	141	151	83	109	171	123	96	147	213	126	140	94	167	169	129	109	146	103	127	84	185	91	120	99	118	66	112	165	121	159	149	102	96	125	115	117	95	132	174	94	157	140	100	124	140	128	123	127	185	145	126	111	127	162	116	138	138	232	123	61	111	107	117	133	139	144	116	162	90	88	101	131	148	198	131	93	118	179	147	145	108	153	126	113	96	174	103	75	163	103	86	110	154	201	129	137	119	143	114	119	141	105	101	103	70	83	130	131	117	109	84	64	76	155	102	153	177	114	135	177	160	111	85	223	92	112	114	105	111	161	111	173	154	132	114	197	113	138	93	150	139	83	147	119	61	99	121	127	124	131	133	67	91	58	207	125	47	84	141	88	108	141	97	67	116	100	110	99	120	121	126	60	99	98	107	77	103	77	99	90	86	136	99	79	78	74	93	114	85	131	125	61	100	90	133	101	103	135	121	104	126	69	104	148	89	87	84	85	155	43	120	87	126	240	108	54	106	118	88	76	61	59	108	75	158	117	142	104	84	71	70	83	77	48	77	118	85	65	131	72	126	70	69	137	86	57	82	147	69	60	78	82	59	243	114	157	79	108	69	86	88	100	80	128	180	63	183	192	104	70	104	86	104	78	63	86	80	65	138	63	165	100	106	77	77	62	107	108	57	155	83	70	64	81	75	72	70	88	70	88	135	79	49	32	103	83	89	104	47	66	111	101	90	43	69	109	56	115	86	119	126	31	50	78	115	69	94	81	62	63	115	71	57	74	128	90	110	105	66	65	52	54	59	52	79	61	62	104	71	76	58	106	40	88	46	91	61	102	89	57	49	60	90	131	68	45	64	78	99	110	92	50	40	67	84	117	65	33	55	143	53	72	76	78	56	50	67	66	88	75	83	77	118	55	84	43	43	71	108	80	48	50	34	77	59	67	87	33	68	78	52	74	53	70	69	64	53	27	82	65	65	76	32	106	45	51	70	66	51	73	54	59	57	86	55	48	42	86	65	54	60	69	54	92	69	48	82	59	66	73	61	43	50	51	60	46	51	48	62	68	45	89	42	43	116	57	70	89	66	42	36	94	47	60	72	61	57	55	43	68	55	61	216	56	51	60	59	65	77	36	82	46	51	124	68	45	21	41	81	77	48	43	62	64	34	35	58	42	62	30	41	50	47	65	44	37	45	18	72	37	68	28	85	68	31	32	40	39	48	110	79	64	91	71	42	38	31	59	46	56	91	64	34	37	54	29	31	69	34	23	40	19	34	38	31	36	69	52	52	55	39	39	67	40	38	40	31	47	37	48	16	40	55	27	77	46	56	49	72	36	62	46	26	27	37	28	43	36	30	37	47	44	39	36	35	51	35	30	49	37	60	40	32	41	52	60	48	71	27	49	39	68	40	48	35	25	50	26	56	74	32	67	45	38	38	29	32	22	64	51	31	37	27	27	27	27	28	27	65	56	40	19	25	27	34	24	45	48	35	19	24	51	28	17	54	33	25	26	41	24	35	30	42	40	17	21	34	22	18	49	27	63	38	38	38	21	31	49	28	37	31	36	10	28	62	17	34	25	23	21	21	41	35	25	26	39	37	18	20	27	24	17	50	19	38	25	29	45	28	13	34	20	19	15	13	16	46	13	17	196	18	15	9	27	18	11	11	13	19	16	25	15	10	12	27	23	23	16	35	22	2	36	20	21	11	22	12	23	11	36	18	32	23	30	20	12	23	35	19	26	14	19	22	15	11	16	22	27	34	13	14	14	17	16	30	7	22	25	9	16	10	33	10	12	17	50	14	11	7	7	8	5	25	21	19	25	15	13	15	11	11	16	5	11	24	10	6	7	8	6	20	5	7	8	4	1	10	16	18	7	9	8	15	5	5	9	13	23	6	7	3	10	10	5	6	9	7	7	17	3	10	9	6	9	4	7	10	62	11	11	6	3	2	6	6	4	8	5	6	3	8	11	3	2	1	8	7	3	6	16	9	1	2	0	3	1	0	2	1	0	4	3	1	5	7	1	2	3	0	0	1	3	1	0	0
ne0145	5341	5067	3595	2119	2759	2636	2715	1823	2151	3486	2026	1940	1754	1741	1365	1798	1712	1789	1538	1403	1672	1961	1550	1734	1481	1461	1649	1634	1512	1419	1415	1507	1459	1293	1463	1363	1518	1147	1857	1216	1446	1463	1083	1077	1313	968	1147	1213	1364	1556	1166	1238	1443	988	993	1284	1263	907	1140	1293	1092	1206	1072	1199	978	1016	1162	1213	1366	1164	1114	887	1206	1117	1199	1065	1091	876	893	1284	1297	921	830	1114	933	915	1026	1164	894	841	999	874	819	789	1068	1031	975	918	910	970	761	1018	851	801	992	938	1066	767	699	696	940	756	905	946	762	802	709	857	856	764	945	857	681	797	767	793	1023	871	633	732	907	1015	1044	974	819	788	608	838	754	751	835	815	835	972	745	673	671	883	664	577	1016	684	628	644	642	729	754	977	621	731	624	732	865	547	740	902	739	697	579	794	760	861	868	483	540	714	943	587	631	715	959	614	767	732	769	787	857	604	766	617	631	742	669	791	668	647	798	555	625	640	641	571	818	846	1046	857	916	564	953	529	554	605	562	815	573	729	863	733	511	567	522	701	774	561	524	654	532	545	931	812	616	581	570	714	863	500	556	685	554	625	556	658	522	605	524	563	541	636	696	687	643	523	677	645	679	479	463	503	564	532	514	574	519	456	501	701	530	626	709	571	626	672	624	529	448	527	435	592	543	741	739	540	711	964	536	1019	618	474	584	631	700	547	668	616	556	703	637	393	519	514	495	379	697	554	482	456	612	505	514	602	477	623	686	572	592	572	403	528	579	660	515	558	433	526	454	465	496	592	752	465	481	549	473	568	509	432	500	414	367	599	688	406	608	425	467	640	403	312	563	675	453	571	550	600	520	417	620	535	458	544	608	497	423	451	492	429	598	612	451	418	602	604	518	414	608	509	605	271	395	370	287	475	439	465	452	426	453	390	350	412	542	528	388	477	612	443	594	548	665	438	411	292	403	395	557	543	483	292	270	454	409	611	406	455	235	350	402	470	382	405	385	541	428	453	431	331	382	523	285	508	337	428	340	476	444	564	382	376	371	337	394	428	615	421	483	436	475	419	359	443	334	491	321	370	421	434	385	395	461	512	480	366	484	366	334	358	362	211	304	341	315	506	385	438	425	429	384	390	388	436	339	269	353	443	486	458	384	415	327	363	359	390	322	431	293	327	528	471	283	467	308	306	483	208	354	269	646	430	400	500	429	313	275	295	371	377	407	307	397	343	328	330	401	309	387	315	354	502	206	445	452	264	382	310	323	298	208	350	229	276	431	285	397	376	266	320	263	192	263	422	356	233	347	285	265	224	483	300	277	287	266	354	403	255	314	415	362	459	489	294	343	330	398	336	266	247	255	367	304	242	520	256	341	337	299	322	269	238	247	272	413	237	335	280	295	234	253	408	440	264	246	270	202	225	282	212	371	217	219	249	511	193	291	374	260	331	268	314	235	296	330	309	313	165	323	309	390	318	257	241	312	242	297	296	279	333	183	239	277	292	354	146	297	368	271	313	197	291	288	270	266	300	210	247	281	191	273	225	221	182	262	260	326	302	231	365	311	255	296	251	218	203	203	188	261	262	206	229	283	176	219	148	323	209	236	203	333	453	157	249	269	316	186	252	366	179	303	261	288	269	217	256	257	331	211	207	308	172	280	248	274	209	147	250	197	213	176	223	180	190	165	322	222	264	162	271	215	335	243	217	220	206	183	264	239	220	232	249	201	228	166	227	207	198	352	280	224	220	237	274	182	227	257	164	222	205	269	310	274	251	185	453	226	222	265	188	192	215	172	255	221	149	359	213	256	204	294	281	230	163	198	259	265	208	166	197	198	151	212	246	221	213	291	286	205	182	243	184	201	208	334	245	185	223	184	272	202	243	142	274	135	175	241	103	235	217	231	236	264	162	134	177	194	305	215	227	182	181	187	205	260	149	128	266	151	172	204	155	139	303	151	184	151	192	193	117	411	204	108	176	210	173	191	151	164	203	213	165	179	249	301	164	133	193	203	189	170	127	193	225	159	110	158	204	175	202	140	123	180	229	224	196	238	144	172	238	181	179	241	138	163	237	157	195	181	257	220	119	201	309	128	223	148	169	134	210	199	197	119	192	214	298	161	221	133	172	148	211	130	172	106	148	137	228	148	110	135	149	154	250	169	196	128	165	179	119	101	180	136	114	208	247	134	139	126	153	168	133	204	119	150	227	166	131	125	163	107	159	116	183	126	220	110	169	174	143	144	129	109	232	167	221	80	122	168	149	137	188	152	134	160	163	94	139	141	138	309	166	166	113	160	129	151	176	159	210	113	145	185	136	181	162	130	143	126	108	302	284	102	127	215	158	299	119	179	123	99	187	293	93	96	208	105	143	143	195	118	173	157	132	161	178	134	115	143	142	103	122	70	160	140	119	105	97	112	124	198	139	158	165	126	119	162	174	98	163	242	137	121	125	122	188	294	146	214	141	191	159	165	150	136	98	123	191	129	110	110	125	142	88	144	68	157	109	124	134	70	194	130	74	141	131	136	141	127	101	87	102	114	180	124	119	123	87	124	112	104	169	90	159	112	96	149	102	152	111	92	102	125	142	132	94	132	140	78	126	107	194	156	98	135	128	82	138	107	118	222	242	92	63	71	94	81	126	113	126	75	181	93	77	136	169	146	103	105	83	95	197	67	106	94	112	134	124	103	85	95	72	127	127	114	152	236	110	127	63	152	70	88	98	131	95	78	165	77	130	116	137	93	87	128	88	99	101	123	79	101	188	157	176	181	68	167	116	122	115	78	159	174	122	77	246	52	127	64	84	63	141	53	107	81	111	166	113	60	139	91	76	164	95	137	70	94	240	103	158	80	53	133	45	139	91	76	113	84	110	121	124	127	152	92	111	123	116	93	134	93	120	108	91	100	103	76	72	126	82	91	98	127	70	132	81	54	96	73	94	83	59	54	68	103	68	100	110	59	51	68	141	98	108	102	48	53	91	62	55	83	57	70	100	69	125	98	65	99	68	66	98	104	71	54	108	90	80	82	108	73	71	45	54	115	109	72	69	111	84	75	98	55	67	76	105	48	99	123	73	84	41	69	54	79	79	96	35	52	59	70	125	37	55	119	85	91	81	79	48	64	95	64	83	53	85	54	131	63	62	119	85	70	57	91	59	46	62	84	56	143	95	69	74	42	105	72	91	42	99	50	78	29	63	92	47	86	83	80	114	116	141	47	112	112	38	43	48	64	47	63	51	97	56	66	47	81	95	61	110	55	47	55	76	57	130	56	39	36	46	91	69	62	28	115	87	96	49	31	83	80	62	38	89	48	57	56	75	52	48	38	89	140	73	332	57	41	61	92	35	106	60	36	45	159	72	12	65	48	84	33	52	33	49	62	39	80	65	46	66	68	66	50	79	63	175	41	54	94	39	48	43	94	25	43	66	55	34	58	42	62	70	104	83	45	61	37	18	65	54	30	16	48	37	78	69	62	63	38	48	34	44	43	83	44	47	37	20	54	27	93	93	44	58	35	50	53	44	68	43	53	32	55	36	95	49	35	43	52	55	31	39	17	63	36	54	74	36	148	27	39	27	56	61	35	62	65	46	69	41	44	27	30	22	16	50	62	36	19	22	52	25	28	34	40	31	64	35	61	39	41	32	31	9	30	46	42	43	30	71	26	27	38	30	54	42	67	44	37	45	33	30	44	40	43	51	50	53	62	17	17	71	37	41	26	36	17	28	27	46	72	17	60	40	56	58	29	57	20	52	16	27	13	30	90	44	71	41	22	16	24	25	11	36	13	15	54	33	17	11	51	27	15	8	14	15	19	34	14	10	19	17	27	14	26	9	19	13	23	29	56	10	17	22	19	24	23	18	42	15	28	14	19	26	39	18	13	21	37	24	29	30	11	41	47	35	12	25	29	12	23	21	10	20	22	41	20	14	37	18	7	19	42	1	23	40	12	18	5	22	75	20	11	53	39	23	16	22	39	18	4	30	15	16	11	24	29	8	9	12	20	7	14	10	22	16	5	7	9	13	5	22	5	26	9	21	9	18	4	30	0	30	18	3	4	12	15	3	7	6	9	3	9	15	11	15	9	5	2	3	10	13	15	4	2	2	7	9	10	1	2	2	4	11	2	1	0	11	2	3	4	4	3	7	3	0	0	4	0	1	7	3	0	7	5	0	0	3	3	3	0	0
ne0146	4365	3553	2773	2901	2645	2653	2029	1911	1871	2815	1979	2063	1712	1657	1168	1712	1548	1636	1272	1517	1503	1396	1248	1582	1324	1368	1424	1394	1316	1141	1072	1290	1281	1272	994	985	1236	1161	1301	831	1178	1189	1095	980	950	977	1187	1053	880	1089	1318	1106	1039	1088	875	1001	1085	910	879	1152	1088	1042	854	855	902	953	1261	1045	1159	922	816	1044	966	878	1133	1150	995	761	797	863	1093	791	957	857	973	981	818	1041	631	716	769	761	991	633	870	730	990	843	801	980	860	678	729	930	798	857	699	916	646	573	774	652	1009	1019	861	649	935	733	1621	880	828	924	665	662	622	780	695	894	848	875	835	807	796	710	797	645	616	824	818	689	622	695	594	712	489	690	623	679	638	519	738	607	632	587	558	670	550	754	756	791	590	572	695	598	737	678	606	449	1324	616	666	641	674	468	758	468	717	728	658	617	953	555	717	609	691	958	595	444	532	662	398	592	547	723	582	488	614	733	452	622	482	622	609	644	566	810	712	542	612	515	727	625	574	710	447	578	689	463	328	499	597	521	469	495	435	648	603	403	669	563	491	501	552	535	802	302	502	610	592	510	553	641	354	376	480	542	529	543	624	497	678	393	554	513	445	650	476	394	536	540	383	480	420	400	449	489	411	537	453	383	609	488	620	559	585	463	461	437	401	571	386	494	689	355	688	410	418	386	401	519	622	542	515	534	352	438	401	320	313	465	375	511	392	527	397	390	415	432	284	641	403	395	584	605	310	273	385	232	477	516	473	373	437	456	441	334	447	497	480	415	382	452	427	423	440	376	409	432	362	467	539	438	361	471	446	438	318	284	644	394	456	381	397	409	404	505	539	366	381	515	362	259	252	359	277	351	532	306	342	323	339	460	457	395	498	328	400	238	408	364	447	286	436	468	376	397	331	353	310	356	444	305	350	208	500	448	362	398	338	430	310	278	379	326	424	408	316	213	318	394	444	387	423	377	201	227	262	416	385	310	310	392	312	310	321	308	326	373	276	299	253	308	234	316	427	470	325	353	278	357	382	419	351	364	432	413	391	291	223	341	269	450	234	337	332	344	337	361	346	367	371	349	425	256	338	316	307	378	251	246	402	351	348	332	339	386	270	547	453	204	407	368	200	283	405	251	329	317	275	289	428	229	305	244	298	308	436	315	277	336	418	297	477	150	248	300	375	302	241	397	318	298	312	441	261	229	382	180	304	324	371	264	313	212	278	285	362	397	233	361	366	232	388	277	226	293	375	400	269	309	251	307	337	303	283	279	188	276	238	283	227	231	324	313	294	229	305	381	119	271	285	313	273	269	334	288	336	422	361	265	353	155	306	352	250	182	218	399	251	201	374	222	280	269	229	270	234	189	161	271	385	206	270	270	234	269	280	336	320	178	271	320	242	220	272	240	227	230	204	201	355	149	269	242	202	243	233	331	185	253	133	339	266	150	253	174	315	236	287	215	233	242	197	172	239	243	351	200	248	283	222	57	189	295	203	312	193	184	228	262	199	257	251	206	247	129	223	186	170	266	168	227	294	253	184	265	283	138	212	226	234	214	163	145	234	238	224	215	163	127	216	200	195	215	238	180	282	274	174	224	258	278	215	264	192	211	226	159	210	200	213	215	229	240	193	141	263	168	178	187	308	271	152	130	169	223	188	206	148	117	213	248	199	248	248	173	219	204	228	330	148	194	90	269	220	278	221	254	176	242	203	193	330	167	312	226	199	173	212	142	267	199	229	118	198	153	234	186	81	432	153	432	207	204	253	247	148	248	188	245	181	159	315	175	186	160	301	243	190	176	284	145	173	175	227	228	136	166	188	167	209	232	291	191	174	100	179	164	223	176	293	170	147	170	180	125	178	175	99	206	137	231	156	85	227	167	205	179	172	136	130	166	277	245	141	152	137	140	143	134	209	134	165	279	129	110	121	106	127	171	121	118	116	128	153	290	343	146	142	100	206	158	136	215	150	153	174	174	187	175	140	170	84	134	189	181	138	122	172	135	202	125	117	223	182	139	115	118	138	195	130	127	174	113	128	179	232	162	102	183	154	186	133	135	167	237	153	153	144	218	104	136	126	189	85	203	197	102	93	119	164	211	213	193	143	109	254	229	123	131	66	184	187	136	145	138	122	79	147	116	177	162	138	131	159	101	119	117	131	107	322	224	178	103	130	121	130	89	207	115	155	151	84	118	135	140	288	111	82	85	200	209	172	136	81	147	148	127	177	193	141	141	119	134	109	103	146	143	100	104	109	163	79	173	254	112	182	179	125	104	118	155	123	450	137	154	67	136	188	90	252	137	154	131	154	123	214	146	231	97	169	150	211	85	114	131	119	131	212	119	66	140	112	143	140	179	72	126	134	120	180	108	135	85	122	90	84	96	57	140	160	148	94	73	164	65	139	96	124	176	226	72	127	187	129	172	228	112	147	98	118	144	210	102	227	69	99	179	85	131	91	135	121	196	100	113	140	76	141	82	164	76	113	115	124	68	89	176	77	85	112	113	133	118	120	112	88	205	122	259	95	103	129	78	118	117	37	113	109	112	93	69	83	143	113	74	85	82	126	83	66	75	86	102	87	97	130	125	128	63	126	131	93	114	96	85	139	121	77	70	50	69	191	130	118	130	61	78	82	134	110	254	100	77	39	85	77	171	77	112	110	102	77	116	53	71	70	50	109	78	90	118	83	69	92	97	129	113	67	75	126	86	70	45	95	153	77	117	73	74	123	79	71	135	112	92	83	191	61	143	206	59	148	135	79	94	77	94	52	70	57	171	67	70	84	75	157	50	52	89	75	112	143	85	66	119	65	49	92	92	84	46	79	165	98	126	37	107	86	136	99	94	52	90	132	78	73	96	83	46	89	125	146	135	109	54	72	149	80	74	84	63	70	70	106	43	90	86	156	65	110	79	63	56	90	66	59	79	61	109	104	60	64	45	76	35	73	95	39	85	123	58	77	89	71	29	97	56	92	82	64	97	119	66	57	110	54	121	73	78	29	97	22	124	58	80	86	72	42	51	65	78	64	50	78	57	82	73	38	55	75	51	35	79	86	43	43	81	170	90	24	91	78	67	62	86	44	45	49	62	85	45	76	52	40	390	108	217	42	76	38	70	46	40	51	54	141	45	69	60	88	59	69	71	87	105	111	95	47	66	32	100	63	71	48	73	43	62	61	52	64	27	58	97	35	57	18	114	43	76	54	46	53	34	60	68	66	64	57	42	60	82	86	93	59	37	44	43	39	65	52	78	42	76	50	24	39	41	46	50	51	100	66	60	31	89	69	41	20	82	77	57	64	58	59	29	41	64	36	55	249	63	42	46	53	56	80	20	16	88	43	56	21	53	46	70	39	57	88	39	41	38	26	40	41	34	168	44	78	181	59	29	39	60	65	44	40	20	100	40	42	90	64	21	52	41	39	49	39	47	45	80	46	36	31	34	34	29	38	23	29	57	39	21	68	59	44	43	23	42	51	64	46	53	50	17	79	69	35	48	17	27	31	68	36	34	82	29	56	41	93	38	53	49	38	44	26	47	17	59	100	38	72	29	48	39	37	61	19	54	62	40	48	27	49	37	19	32	42	28	42	49	65	81	18	24	37	71	15	48	39	27	42	41	42	25	28	32	32	16	36	34	200	51	44	74	35	29	27	21	32	18	28	14	32	30	21	54	22	83	49	79	44	21	47	19	32	66	142	34	40	42	12	27	32	46	26	18	28	36	34	17	6	38	16	40	8	36	15	19	48	24	41	30	34	18	22	22	6	20	29	94	53	30	23	21	29	26	24	20	9	25	22	34	22	30	28	5	27	28	13	9	25	8	30	21	37	11	18	50	17	11	27	17	39	29	13	13	4	34	14	12	22	25	13	18	211	5	2	58	14	38	5	44	22	18	5	16	8	39	22	20	7	8	22	269	12	8	35	1	67	9	10	15	13	35	34	17	13	33	15	11	52	10	11	17	11	16	14	5	10	15	5	26	13	3	6	10	15	17	8	23	6	11	4	8	9	21	6	16	9	8	4	7	1	7	4	3	6	0	18	17	14	15	9	6	10	12	3	8	16	10	29	5	11	3	2	11	10	4	26	3	4	14	1	8	5	0	1	7	4	0	2	5	5	2	3	5	3	5	3	4	2	1	0	8	1	9	0	5	0	0	1	1	0	0	0	0
ne0150	1387	1495	950	536	567	540	528	403	564	674	501	476	624	462	695	337	380	496	362	480	461	361	556	288	415	370	444	517	346	596	367	319	347	304	462	398	377	310	390	446	364	322	260	232	249	323	231	328	400	273	206	344	251	393	200	389	262	407	346	244	228	243	275	283	288	269	216	231	324	313	371	272	364	289	207	297	200	301	280	275	248	306	161	266	236	188	217	278	154	283	259	332	157	279	230	237	156	273	191	176	302	196	253	171	187	227	215	174	175	165	228	197	169	144	187	176	143	259	201	127	220	164	323	240	231	204	265	145	138	164	232	197	195	228	255	229	163	194	132	185	168	193	159	183	173	254	165	179	203	203	174	169	220	155	198	178	216	126	119	118	184	180	190	224	257	184	224	268	155	126	198	215	144	306	115	273	226	118	190	174	109	220	118	147	174	177	155	231	188	148	181	166	149	190	186	95	170	122	179	188	131	188	155	201	235	167	188	227	242	184	122	149	142	131	161	229	188	249	261	167	181	153	189	181	237	136	194	138	190	203	163	180	126	176	138	246	119	197	170	147	133	236	114	260	105	215	206	141	184	171	146	104	177	171	133	96	129	164	153	119	140	171	149	155	137	189	146	138	194	184	130	241	152	136	93	137	118	131	192	141	167	136	139	177	116	282	220	105	87	126	198	144	182	126	233	213	70	120	126	134	180	125	148	125	140	149	206	214	133	106	189	188	166	87	169	94	145	211	56	121	143	185	116	146	122	147	143	106	147	74	90	114	124	83	84	130	128	179	114	130	128	145	102	87	128	159	139	152	74	109	126	139	141	156	133	137	70	110	128	94	99	189	59	109	113	76	107	152	150	130	167	63	171	92	114	157	117	130	122	121	138	106	119	97	179	110	107	113	119	100	101	243	93	182	74	128	88	148	190	100	133	140	89	149	104	92	94	137	122	146	103	106	98	94	123	72	102	135	77	59	76	124	80	82	180	91	78	137	136	103	60	108	87	87	95	129	99	71	93	81	73	98	90	118	145	89	76	89	217	65	92	63	71	95	119	85	142	109	94	125	95	49	141	102	96	94	70	83	108	95	166	94	63	101	162	71	99	73	119	86	72	93	68	90	78	82	78	75	55	142	56	92	78	60	102	120	80	102	77	95	75	71	91	23	53	31	100	103	135	84	69	87	74	35	89	134	76	108	96	82	80	76	127	64	115	73	73	112	115	73	95	183	62	87	93	110	49	83	112	105	119	58	93	61	45	59	56	85	158	80	103	63	68	79	99	110	101	112	58	85	49	68	77	68	43	61	75	75	75	79	64	67	74	81	74	63	25	45	64	75	97	88	79	65	60	76	53	123	102	79	53	72	67	92	66	100	53	79	78	92	50	94	115	41	69	102	79	59	80	194	49	47	96	60	94	64	45	68	65	91	113	92	62	143	85	89	81	86	46	57	63	62	68	164	80	83	46	45	53	51	82	67	101	50	63	73	60	81	95	83	111	66	91	99	68	43	45	15	80	69	88	48	47	75	72	59	82	108	65	70	50	51	51	24	61	47	63	91	25	119	50	47	64	105	35	28	70	67	83	39	74	75	89	66	84	47	47	106	50	51	34	65	91	106	46	60	68	43	44	117	81	69	65	47	83	30	54	44	32	132	59	86	57	77	90	74	44	96	61	35	86	51	103	40	38	46	48	45	58	50	67	43	55	46	72	66	50	48	75	70	28	66	49	42	51	50	72	80	63	50	43	42	83	51	49	58	28	78	38	93	37	50	57	41	43	56	44	43	45	32	44	63	55	34	36	44	23	43	44	52	64	59	51	75	41	59	40	47	52	99	36	34	33	30	37	47	39	69	49	59	38	34	38	28	30	57	28	55	73	30	58	65	17	34	33	72	37	57	36	46	24	57	36	68	51	63	47	51	76	35	40	42	11	61	75	33	43	47	48	58	92	70	22	40	54	41	49	55	63	34	104	37	49	73	47	37	25	32	33	65	67	68	82	34	70	44	36	39	39	36	62	43	61	41	19	60	35	66	36	47	44	44	40	72	69	28	48	25	31	34	72	29	67	38	68	44	54	37	32	40	27	35	28	46	21	34	32	51	34	42	32	49	34	15	35	28	40	101	31	37	33	34	36	52	46	85	40	44	38	38	25	23	36	24	59	41	47	23	28	29	43	24	39	45	33	49	31	51	77	30	47	70	46	49	45	33	24	24	33	33	39	43	47	27	39	38	39	27	47	37	57	33	15	30	31	49	30	17	23	33	30	19	34	17	32	24	32	12	24	32	45	34	42	44	32	45	27	64	26	21	22	20	26	34	29	34	22	29	42	36	49	49	20	40	15	53	19	50	33	33	20	25	32	30	29	31	31	15	31	28	17	17	39	20	29	35	28	48	25	43	18	58	32	52	42	18	23	24	24	46	23	53	30	20	35	41	29	22	25	25	16	22	27	26	23	33	33	33	35	33	21	24	18	23	70	20	22	47	30	18	56	21	21	29	26	34	44	28	40	17	31	19	82	42	23	31	57	36	22	19	31	18	31	51	12	24	20	20	10	42	39	36	13	30	17	20	9	45	52	24	32	29	21	4	17	29	31	31	26	35	25	20	14	11	14	6	39	24	34	15	38	23	12	31	33	15	17	39	21	14	14	24	37	21	24	17	30	13	26	38	28	42	43	38	42	33	24	17	11	21	12	22	34	32	59	13	19	17	6	26	15	48	24	26	40	28	32	18	52	28	19	37	20	15	13	32	19	29	71	39	47	22	16	13	22	15	14	16	36	43	39	43	17	17	18	17	23	40	35	19	22	38	43	18	25	38	22	44	28	76	36	20	7	17	10	31	40	25	24	24	19	16	18	31	18	30	30	7	31	17	11	28	25	7	17	15	20	28	26	32	23	18	10	27	15	18	28	17	29	21	28	14	20	21	18	24	18	17	16	14	29	5	47	54	17	8	16	18	33	10	36	38	21	17	31	11	21	20	22	18	69	18	18	12	32	12	29	14	27	19	37	8	19	15	22	18	29	16	46	17	23	23	11	28	23	22	14	30	20	11	48	9	11	17	21	16	17	11	15	12	16	14	21	47	35	11	18	27	15	16	21	11	20	19	28	15	14	16	14	17	9	18	10	10	17	8	15	7	37	14	19	21	25	8	43	17	21	4	0	12	33	14	9	32	12	17	19	20	22	21	13	21	8	16	7	15	22	19	31	19	11	15	17	6	14	9	20	20	17	7	28	15	16	12	33	34	8	27	22	0	17	12	15	29	10	16	21	23	25	13	7	6	21	16	19	17	13	16	26	6	3	22	24	12	31	8	16	28	24	6	21	7	16	12	17	7	14	20	49	12	26	12	10	16	18	11	8	57	49	11	8	48	7	6	13	5	7	7	10	17	7	10	19	11	8	10	21	9	26	21	29	9	13	16	16	12	15	6	10	6	10	19	7	25	12	34	4	20	7	11	13	5	17	21	7	10	16	10	18	10	8	6	3	6	9	30	4	7	5	16	15	10	7	9	14	2	17	18	8	12	8	8	5	10	23	18	7	8	7	1	7	8	2	12	7	1	7	18	11	11	5	21	11	5	20	10	6	5	2	7	4	12	9	9	5	15	9	17	8	12	14	17	5	5	7	4	19	5	9	10	7	3	4	6	11	23	6	12	14	8	7	9	10	7	10	0	4	21	7	4	6	8	11	10	5	3	5	24	5	6	1	12	10	6	4	6	24	3	5	1	8	10	13	3	6	4	6	1	16	9	3	40	3	1	8	9	5	7	4	1	3	1	6	3	8	5	6	1	5	3	2	6	6	11	8	7	6	3	11	6	3	5	0	8	5	1	10	8	6	10	3	8	9	2	7	4	2	5	2	4	3	13	6	4	3	3	5	4	2	4	6	3	2	0	0	1	0	9	7	8	1	9	1	0	5	5	5	2	1	5	1	5	3	6	1	7	0	7	1	4	2	7	4	2	1	3	2	8	3	3	1	3	0	2	0	4	1	0	4	2	4	1	2	0	3	2	10	5	3	10	3	2	0	1	0	0	2	0	24	3	0	0	7	3	0	5	0	1	4	2	1	0	0	0	1	1	1	0	6	1	0	3	1	2	1	2	0	1	0	1	0	0	2	0	1	0	1	0	0	0	0	0	0	0	0	1	0	0
ne0151	2456	2521	1216	988	590	993	1071	867	639	1223	630	757	784	657	1048	627	753	504	705	594	548	617	535	551	537	530	492	636	634	825	375	606	429	541	782	536	488	415	516	638	498	459	449	601	532	572	427	528	728	417	401	380	237	336	475	571	264	335	537	257	390	412	412	298	270	615	418	393	405	304	369	277	531	334	357	212	326	365	454	378	394	417	322	444	271	277	328	241	329	470	629	404	364	283	276	288	271	312	406	376	458	541	412	373	362	216	327	311	443	450	393	339	272	302	344	418	295	420	252	274	272	315	196	352	318	345	315	190	265	263	183	328	207	251	284	353	262	225	247	245	180	367	289	223	282	412	292	256	324	321	304	176	386	231	383	267	348	215	228	326	244	287	253	419	295	194	285	322	180	362	408	211	281	422	187	341	284	226	182	190	242	482	211	184	197	202	224	368	226	304	190	240	260	173	191	326	319	218	248	287	252	146	251	238	196	248	339	249	337	309	191	270	283	221	342	277	226	195	252	186	169	194	187	339	349	219	199	342	246	208	226	288	273	291	229	347	255	149	200	186	292	138	278	296	97	190	305	170	253	301	134	187	245	233	261	174	203	307	259	237	221	274	226	203	161	228	271	249	184	203	225	198	205	160	231	184	188	257	270	145	182	190	101	177	161	221	390	231	164	268	136	196	95	202	266	223	227	150	262	183	183	190	205	222	309	210	166	238	149	137	120	146	117	272	187	117	244	190	251	226	184	224	141	211	149	235	190	164	187	144	155	222	164	209	174	245	213	305	260	156	194	254	396	273	211	165	223	235	108	142	177	167	159	251	157	259	231	142	164	98	169	143	211	137	194	159	160	243	232	240	182	102	195	130	131	144	140	223	151	152	129	184	125	218	275	195	162	159	168	123	147	151	235	203	135	131	139	229	195	138	182	228	177	144	174	108	124	157	160	153	97	142	126	174	176	103	185	166	162	151	181	132	183	276	252	162	241	165	192	162	233	107	119	180	111	152	98	125	144	110	137	122	153	172	163	134	119	103	152	192	155	154	106	122	149	119	147	152	140	135	190	142	126	150	99	153	132	90	108	106	91	136	145	124	173	122	176	120	114	159	172	144	159	88	188	99	122	157	241	210	70	165	101	69	66	99	106	166	117	102	65	146	119	133	234	140	112	106	151	132	105	173	157	78	84	146	133	91	145	75	86	75	130	191	116	100	107	149	138	112	155	161	150	96	139	91	46	144	62	100	105	165	95	100	64	110	134	77	153	172	197	154	183	69	131	100	138	66	137	92	103	182	113	49	106	152	94	142	76	80	83	65	72	59	94	110	175	127	142	145	95	93	102	114	157	119	94	163	167	114	99	142	91	89	96	118	156	104	87	151	132	109	118	136	81	114	90	66	79	82	73	122	75	101	107	54	91	75	177	73	109	74	110	168	180	141	131	163	151	115	68	84	90	130	70	98	50	132	79	76	165	192	94	97	64	84	154	153	103	79	76	100	75	71	74	111	137	96	95	82	126	153	53	48	123	169	65	156	94	127	71	40	95	99	74	137	64	85	129	97	86	98	133	84	87	94	70	87	89	45	69	94	111	87	69	59	139	93	121	39	108	90	68	68	100	171	117	104	119	163	131	78	108	82	95	113	119	103	155	121	75	72	134	50	47	62	122	116	69	56	145	72	225	84	73	74	81	90	79	43	77	60	50	146	115	72	94	66	94	93	102	65	69	116	63	83	137	153	83	63	85	106	81	123	30	48	65	121	46	80	94	102	49	76	55	69	100	118	128	64	103	119	133	91	73	46	89	94	38	62	68	65	83	25	58	137	115	132	132	74	70	52	60	82	98	103	79	73	85	126	57	126	140	51	31	117	39	74	64	53	131	46	81	49	64	107	113	85	44	60	49	58	67	91	50	88	93	61	59	51	66	62	75	43	78	45	105	56	54	110	73	36	106	69	61	57	91	57	26	43	38	59	95	61	84	35	39	65	48	53	67	81	100	86	124	71	132	68	46	58	88	70	68	108	66	85	59	51	60	56	71	34	33	56	43	70	82	89	60	69	106	55	83	32	55	24	159	133	22	125	56	68	66	122	49	75	23	93	53	75	126	58	68	92	61	34	53	135	66	57	63	38	56	75	85	61	39	110	39	88	70	83	41	69	56	53	88	85	38	79	44	72	53	58	41	67	53	77	41	27	88	55	43	104	52	49	71	50	50	36	49	76	48	62	70	41	45	86	80	105	70	59	98	69	65	94	64	55	36	78	138	67	23	59	33	81	91	72	42	74	45	61	33	61	62	48	42	53	35	60	83	76	30	29	61	69	43	45	35	55	105	85	55	46	72	50	74	39	69	46	48	37	67	54	47	52	50	25	78	71	62	51	36	54	21	57	95	82	108	91	48	44	66	78	35	38	63	42	39	59	68	27	26	62	25	84	44	13	83	22	118	46	54	41	32	57	40	27	51	90	38	71	43	49	35	69	38	79	54	63	41	54	30	51	87	31	22	29	24	69	78	62	96	105	16	39	67	26	31	60	29	51	36	55	88	35	72	29	30	92	33	52	52	60	36	81	43	38	41	85	33	48	58	85	44	42	74	32	16	46	61	67	26	43	33	32	39	21	29	35	78	15	36	30	36	62	47	42	50	69	42	30	29	27	19	25	36	59	37	74	29	47	21	26	27	58	36	32	42	22	63	44	29	53	32	20	16	63	64	51	52	35	54	31	36	78	54	56	34	100	50	27	17	41	49	33	42	44	39	40	47	24	24	39	33	29	27	52	39	66	48	16	52	32	26	14	34	44	29	48	28	68	43	23	9	23	41	27	30	41	30	29	51	45	42	41	20	17	17	30	62	21	37	46	10	28	34	34	25	30	44	59	43	53	23	22	79	53	33	34	66	21	34	30	41	62	27	31	14	30	32	13	47	29	24	28	38	16	30	31	45	39	70	25	50	35	34	47	10	20	48	21	9	46	30	9	45	42	48	24	96	23	34	19	29	28	18	17	29	46	21	55	33	39	25	33	9	30	45	50	25	8	51	27	30	20	29	16	18	52	38	102	52	25	63	23	27	18	30	17	10	61	27	24	45	10	12	16	13	15	23	20	16	25	35	44	16	18	20	35	55	24	35	11	29	13	46	44	18	18	29	28	21	23	17	24	33	15	38	15	47	36	22	25	21	10	27	54	16	34	40	43	20	13	44	22	18	22	38	76	19	36	30	38	30	47	41	42	29	37	7	61	12	17	16	28	13	27	27	22	24	44	20	30	14	7	22	19	23	5	9	9	10	13	21	24	41	23	16	37	16	12	28	39	6	17	28	30	33	24	18	9	41	42	22	33	18	14	9	25	34	17	18	21	22	19	12	34	12	8	26	13	33	39	9	9	10	29	26	24	38	6	10	47	27	31	22	15	43	8	31	14	47	24	15	19	9	23	31	20	17	48	15	39	16	12	27	26	18	44	11	44	22	27	13	27	4	35	25	16	10	35	17	16	16	7	13	21	10	12	24	8	11	7	21	10	24	5	35	14	18	6	28	12	25	15	17	11	7	15	2	23	23	24	8	14	25	18	13	4	12	13	6	24	17	12	3	3	18	24	34	15	1	6	20	4	19	32	9	9	13	16	3	17	8	8	21	19	7	14	9	13	6	33	17	19	8	10	15	14	20	16	31	25	26	4	8	14	10	1	4	14	10	19	21	23	7	7	6	10	16	9	7	5	14	20	14	20	30	4	11	31	3	3	12	22	6	5	22	18	11	3	9	5	7	18	8	0	11	5	10	4	15	5	4	8	11	36	11	4	6	16	3	12	14	4	8	12	7	1	4	7	17	13	12	13	6	6	4	13	14	8	5	11	4	6	2	17	9	7	3	13	24	5	2	13	0	8	6	1	12	8	5	16	10	2	22	4	24	30	2	5	6	2	8	14	4	16	5	2	3	2	1	7	3	1	1	5	1	4	3	11	4	2	6	4	11	8	2	9	17	2	3	2	12	8	6	3	3	12	6	1	2	3	4	8	12	10	1	5	5	8	0	2	0	9	3	9	4	1	4	13	8	8	1	8	0	6	6	1	5	2	4	3	5	2	5	2	3	3	0	2	0	2	0	0	4	3	1	0	0	0	1	2	3	1	1	2	2	1	4	0	4	1	0	0	0	0
ne0152	3383	2729	1607	1517	999	1535	1267	1350	1070	1776	977	1145	1048	943	1189	850	1014	784	774	794	833	998	733	885	725	909	679	818	892	882	587	814	644	743	760	641	668	602	606	701	565	637	593	956	666	640	590	736	701	550	703	553	428	759	706	668	511	491	688	521	590	546	419	416	439	824	605	625	518	470	481	379	620	386	565	426	533	496	644	522	543	516	539	508	389	466	430	420	455	591	612	443	587	380	448	408	473	484	582	598	683	482	533	505	497	371	370	474	427	520	508	455	448	494	524	545	495	441	348	474	376	460	332	455	415	470	412	498	469	452	366	432	393	376	429	459	465	373	391	435	324	441	544	370	334	588	440	390	443	422	396	268	545	330	528	372	479	298	394	437	420	372	362	549	371	289	335	347	333	470	424	335	424	469	374	352	431	368	320	266	446	451	392	333	376	311	335	388	326	372	266	422	384	323	344	392	436	381	335	477	313	263	406	353	397	372	375	353	317	383	350	432	391	299	376	354	316	218	303	287	221	327	227	440	397	324	344	387	294	264	235	355	403	286	385	335	346	245	303	264	442	234	298	369	231	287	423	270	317	250	240	381	304	345	287	315	250	386	291	325	272	395	302	342	208	236	349	371	253	225	306	206	304	248	419	290	237	282	267	241	205	263	235	240	326	168	344	321	231	349	313	291	183	306	443	209	336	243	292	258	287	278	189	252	356	227	236	293	236	243	173	209	202	382	307	176	327	174	380	325	273	247	248	326	290	317	198	235	237	274	225	288	195	348	324	314	274	403	300	242	224	328	426	362	295	226	269	299	204	206	214	217	197	239	196	398	295	189	181	174	196	176	309	262	235	186	256	239	286	289	218	193	250	226	209	145	199	282	251	233	356	261	197	280	261	267	226	186	240	221	327	344	336	155	229	176	154	279	157	239	219	290	250	242	256	161	195	189	308	277	180	187	180	257	198	177	202	262	240	248	244	166	289	342	241	241	254	228	207	198	294	191	145	225	225	192	157	179	181	187	248	205	158	182	185	172	234	140	132	293	200	229	160	186	172	167	211	201	138	163	235	160	151	196	118	220	185	216	169	104	310	258	190	233	239	118	231	227	127	175	196	215	171	150	225	132	232	259	243	170	222	188	167	147	128	135	199	205	208	145	131	214	204	232	259	196	155	127	151	185	160	193	226	160	119	130	163	145	190	143	142	200	140	165	177	160	144	148	176	149	203	215	217	149	236	146	130	163	111	159	202	166	157	135	123	136	160	124	179	220	186	221	285	145	204	156	307	138	152	146	171	228	161	125	181	230	126	164	100	129	181	98	141	119	124	126	262	225	179	162	163	127	137	143	266	174	158	163	187	124	131	154	148	98	172	154	230	107	92	135	179	149	132	160	103	127	151	90	118	172	202	157	71	95	138	102	127	102	163	111	98	120	146	149	268	139	153	136	186	139	206	122	120	110	107	107	137	130	115	131	128	88	111	147	102	146	185	141	114	137	102	127	127	129	111	153	157	131	113	93	158	209	102	118	158	202	149	132	149	149	154	91	177	132	101	230	111	111	174	122	124	188	161	121	164	149	129	140	127	74	108	112	176	130	99	118	171	84	135	64	183	152	107	132	184	174	140	181	134	142	121	185	132	88	191	188	180	134	174	117	143	75	188	74	98	112	146	132	83	93	140	81	185	147	135	133	81	150	134	73	110	126	96	140	182	93	79	120	90	104	155	80	86	140	138	132	173	131	69	82	62	157	133	121	75	80	109	190	67	92	72	108	85	110	103	105	134	143	194	117	147	123	133	150	133	83	92	155	82	95	96	100	118	81	141	157	146	114	162	90	145	91	86	136	132	88	121	83	103	155	49	137	175	36	48	129	117	101	96	63	103	94	145	109	87	116	146	76	78	92	120	82	119	123	66	97	91	91	79	51	129	80	100	54	102	159	110	78	112	85	102	68	173	143	91	89	107	70	58	139	56	97	130	94	136	101	65	85	119	55	91	86	132	128	145	70	194	88	52	95	90	86	74	120	113	79	141	54	65	78	77	62	62	76	96	117	110	144	115	101	103	74	91	57	71	52	160	102	29	133	58	94	104	153	78	144	45	147	90	80	139	115	76	95	90	71	100	76	140	74	71	64	83	104	80	115	73	83	64	122	55	146	104	116	69	52	118	90	59	111	85	62	37	73	69	94	115	129	85	51	149	90	100	108	49	67	92	81	86	136	62	91	87	80	82	56	77	80	101	163	64	107	56	82	75	89	134	98	56	66	110	114	51	63	69	83	108	67	92	76	72	77	58	136	62	61	59	76	44	80	94	106	63	86	82	85	66	92	64	107	112	115	91	68	68	82	93	70	72	52	60	36	99	72	55	93	87	35	78	68	67	123	52	79	60	107	87	85	72	83	76	39	99	101	65	77	90	54	69	59	94	52	69	74	89	83	74	51	83	61	121	101	53	98	108	90	69	49	45	92	78	71	75	68	65	84	40	136	91	72	68	60	59	52	143	55	43	70	65	45	68	89	116	100	55	58	49	44	48	65	34	67	41	84	78	29	49	63	63	84	52	57	67	90	47	86	102	54	44	90	56	49	69	102	72	41	82	68	35	56	68	54	61	87	59	82	59	53	42	58	60	41	45	29	44	84	75	44	70	87	68	32	43	50	38	48	29	89	59	51	72	70	34	60	42	51	78	74	49	44	80	61	26	38	48	39	54	43	44	53	79	54	54	78	37	64	78	73	24	138	85	45	37	84	32	35	60	75	38	51	22	69	34	59	41	55	42	54	56	56	76	46	99	66	49	40	39	55	57	68	43	32	46	57	44	19	57	18	39	67	47	31	50	52	51	36	35	22	40	48	60	57	68	68	43	23	38	47	41	47	56	44	45	74	109	42	91	43	61	51	86	36	60	53	33	71	53	42	32	56	31	50	60	31	46	76	44	24	28	41	53	56	77	73	65	34	80	54	30	38	65	47	37	54	24	41	41	65	65	68	75	106	36	14	30	49	20	26	37	68	32	78	42	33	14	41	23	34	46	72	34	31	66	44	53	37	27	18	23	65	96	74	53	44	53	18	34	26	27	28	21	57	30	26	32	51	71	20	25	16	52	32	26	35	53	72	44	45	18	44	64	32	46	25	34	55	100	63	25	18	25	25	18	29	22	34	21	29	87	42	36	41	37	27	25	23	19	68	35	23	33	45	50	33	70	40	34	19	29	59	32	36	45	42	32	36	57	60	31	50	40	65	35	32	33	30	18	61	31	45	31	34	25	29	20	19	30	29	60	41	32	36	37	28	28	29	57	48	70	15	14	26	26	30	20	33	56	20	32	32	20	34	22	49	23	44	22	35	14	19	29	29	20	9	16	110	14	43	36	21	31	12	41	16	23	27	25	75	30	26	53	15	14	39	75	37	24	35	19	33	40	42	35	29	17	22	26	27	65	19	57	51	34	29	27	12	36	31	24	30	15	26	20	27	27	17	16	35	33	18	31	51	24	31	23	27	26	16	18	36	23	20	24	9	31	18	27	2	47	21	84	12	34	19	39	15	35	17	26	30	28	27	34	15	19	26	34	18	24	12	25	41	15	28	23	14	7	17	23	25	31	15	9	15	25	11	15	43	17	40	27	26	13	46	8	17	23	19	8	14	43	17	18	48	19	25	12	19	10	20	22	24	23	16	52	10	11	18	17	18	11	15	10	9	34	7	9	18	15	16	34	20	11	22	12	27	12	36	21	11	13	16	9	15	19	23	9	24	14	15	8	17	36	16	14	30	10	6	26	23	14	4	24	16	12	11	24	2	14	8	15	23	15	11	12	5	5	14	8	16	14	8	23	13	19	18	13	12	0	18	11	16	5	5	9	4	8	28	6	7	12	12	20	9	4	12	2	7	5	2	26	17	10	25	14	12	32	7	28	12	13	8	10	6	8	13	13	17	4	6	1	1	19	11	5	2	26	7	29	6	2	9	5	3	11	4	8	5	31	10	17	15	7	1	16	13	12	9	3	7	14	5	4	3	23	16	9	5	3	13	15	13	4	11	3	5	8	3	12	2	12	15	11	12	3	4	3	5	6	1	12	3	8	5	4	2	6	1	6	2	1	5	0	2	2	1	0	2	2	0	0	0	1	1	0	2	5	6	1	0	4	0	4	0	0	0	2	0
ne0153	3662	4000	1895	1563	1358	1479	1365	1209	1208	1732	1245	1243	1205	1015	1232	879	1150	1159	1020	938	843	944	975	852	829	749	740	1148	1090	1199	752	971	624	864	1039	931	703	780	925	788	790	743	1054	809	786	626	588	701	1138	688	495	516	612	673	1003	901	670	614	901	560	619	704	577	535	478	970	584	594	655	577	483	529	895	519	715	415	480	572	776	777	623	797	513	621	415	481	732	418	563	711	923	590	469	472	578	576	469	460	641	441	576	768	866	498	522	322	405	454	670	792	751	620	422	419	470	614	380	586	831	461	577	453	470	609	514	433	570	379	341	355	290	487	486	411	500	465	792	432	385	522	278	577	539	437	460	568	407	483	685	465	503	392	506	409	548	532	620	396	325	400	494	565	421	514	484	378	441	422	651	468	626	451	484	407	280	578	343	356	366	409	319	598	323	302	350	542	412	535	446	421	506	392	577	253	397	383	740	340	394	410	432	392	487	371	433	344	544	341	548	593	287	422	629	339	451	436	439	371	399	366	268	272	368	500	463	345	312	443	421	372	407	433	516	602	459	457	366	317	291	330	428	248	364	602	296	233	367	273	451	407	284	401	374	371	329	242	291	412	404	436	432	279	318	358	285	379	378	344	359	365	272	299	307	334	338	444	317	348	533	300	464	301	229	348	205	591	496	374	262	409	214	270	266	416	533	467	309	230	425	252	365	257	334	345	487	427	322	318	292	327	224	181	257	372	473	282	400	381	244	306	292	288	257	288	333	389	283	319	257	239	389	302	255	338	302	405	301	338	334	219	329	377	390	300	355	315	401	358	176	344	252	289	254	327	270	305	306	278	316	305	272	344	502	329	303	284	279	421	399	391	417	194	282	228	215	351	289	308	292	226	306	239	220	230	512	256	306	220	212	225	216	374	375	410	154	171	269	340	554	226	302	250	250	287	259	181	274	300	194	235	229	276	247	271	324	179	275	203	217	225	306	317	237	349	311	146	283	204	255	340	281	172	298	298	167	215	235	260	311	190	156	161	290	311	231	210	187	200	227	243	199	168	172	196	244	235	220	308	294	317	221	225	316	244	162	239	205	139	286	229	263	255	177	171	311	220	313	209	224	441	203	220	183	250	261	297	191	222	242	377	258	252	237	203	137	154	244	260	193	161	163	258	212	421	202	228	314	217	225	164	132	223	315	169	128	158	225	174	254	180	146	183	216	219	203	150	243	263	230	181	268	261	223	198	196	121	93	256	165	230	207	214	170	175	181	275	184	113	164	227	393	303	285	227	205	187	259	184	144	183	187	205	199	171	174	240	162	212	220	200	80	150	182	181	151	114	240	128	231	194	124	211	264	213	230	135	139	224	206	152	188	160	129	157	143	259	181	182	101	184	185	169	154	125	111	184	160	97	130	290	114	129	160	216	185	153	170	138	208	108	304	149	188	212	249	204	197	211	156	195	160	191	171	178	128	178	89	181	168	166	240	290	179	181	147	142	178	267	136	153	108	151	125	126	106	158	186	155	132	116	197	232	107	136	150	194	131	258	145	229	109	110	154	143	81	216	163	178	168	197	156	246	282	147	114	170	184	112	101	98	148	144	129	174	219	119	208	79	197	78	149	149	161	134	169	205	149	151	181	251	148	226	168	114	160	188	154	139	178	169	118	163	220	93	126	135	182	135	99	152	287	196	320	100	131	99	76	179	119	141	131	188	102	168	170	132	194	122	122	190	70	88	190	232	169	114	125	134	191	112	148	208	123	123	81	114	228	171	87	138	124	147	95	175	59	90	128	179	189	130	112	113	150	160	126	102	150	118	140	127	138	138	186	70	74	215	197	157	209	141	97	137	180	138	88	151	105	61	127	221	92	107	157	133	60	71	103	115	88	103	115	70	89	93	118	127	129	96	85	85	76	145	122	265	72	145	138	114	144	94	143	124	100	42	120	19	170	122	107	191	126	104	161	74	115	115	224	103	68	57	112	82	110	128	240	86	95	163	97	122	104	117	163	100	182	128	137	112	79	141	139	73	127	151	147	113	136	53	164	118	170	111	106	111	108	96	106	110	103	105	164	132	149	53	153	82	167	173	98	174	64	103	111	93	92	133	66	108	90	165	163	97	101	158	115	74	81	144	81	101	155	127	97	112	188	110	94	129	97	127	179	97	57	102	68	82	91	83	60	104	91	76	79	117	88	96	95	182	102	128	76	105	105	143	119	84	137	103	92	50	108	135	114	82	164	126	89	120	117	143	81	131	122	103	88	156	98	101	65	166	196	119	68	103	80	131	121	91	88	60	112	78	86	96	82	93	76	62	96	123	113	81	56	128	61	92	94	97	87	77	155	175	85	117	88	85	61	77	65	87	79	88	113	55	79	96	86	72	79	82	86	98	106	96	99	83	120	76	143	154	149	109	73	61	68	99	104	99	48	114	57	65	54	48	64	106	86	33	131	73	157	72	91	44	50	121	67	70	90	113	88	98	99	92	99	90	95	96	68	90	47	119	61	98	134	84	169	47	73	56	132	84	92	133	51	89	121	77	55	49	75	91	71	115	106	68	72	50	32	150	67	87	96	74	69	77	66	57	56	51	83	90	82	126	82	45	117	37	38	62	116	79	33	91	75	49	74	69	100	58	130	56	73	72	55	82	76	65	115	68	58	93	58	40	36	54	70	56	80	138	58	79	63	53	43	75	54	54	65	79	59	73	16	151	49	74	66	65	74	78	61	66	67	61	58	70	74	94	78	148	68	27	75	89	79	88	57	72	77	79	54	34	71	71	53	44	65	139	33	91	67	51	56	49	72	50	88	64	51	62	33	116	55	44	62	40	49	36	49	149	47	80	80	96	105	74	47	38	46	128	103	59	57	51	62	45	71	38	74	79	58	62	75	74	20	56	106	86	40	65	56	41	47	63	51	139	71	59	34	56	68	64	85	39	60	55	70	66	53	46	67	51	61	73	69	61	71	46	40	37	66	39	27	59	57	49	70	61	58	68	98	8	51	80	70	60	45	36	41	56	64	94	40	86	67	61	18	48	50	47	61	24	38	21	64	42	75	72	100	67	133	114	71	25	81	67	56	41	31	38	30	54	37	54	83	33	41	32	33	33	60	32	57	114	34	64	38	64	32	44	89	61	35	40	58	32	62	41	37	35	34	32	34	31	24	62	79	23	60	43	100	81	36	29	14	14	90	77	19	56	72	70	31	44	94	30	61	16	55	53	37	27	55	53	50	53	45	36	71	95	25	118	35	61	49	63	34	56	33	10	25	31	53	69	46	33	49	34	83	38	15	19	68	46	37	27	35	42	23	30	20	24	37	62	26	19	33	58	42	47	46	41	59	127	13	62	31	53	63	29	57	32	29	40	21	34	70	25	56	27	35	26	29	21	24	40	37	47	22	34	65	32	22	111	67	61	44	17	65	27	40	29	45	30	21	23	35	49	34	35	27	49	19	82	33	47	45	49	55	43	26	36	56	26	28	21	21	38	20	25	28	28	44	54	14	38	51	22	14	85	35	25	20	19	30	6	33	11	42	27	62	22	57	45	32	32	51	15	18	24	18	27	20	57	19	32	46	43	33	19	13	27	28	40	19	22	21	26	30	40	27	25	32	8	19	17	18	26	14	14	31	51	19	19	21	2	14	47	22	36	18	21	16	80	35	24	31	14	15	23	29	16	33	20	25	16	15	25	32	21	6	45	19	14	24	37	74	10	10	25	42	104	14	10	22	37	22	7	19	27	26	25	5	19	10	22	6	18	6	25	18	49	11	6	24	17	13	6	13	2	24	14	27	6	15	6	29	26	22	14	30	34	7	23	32	41	10	15	36	10	16	16	15	15	29	7	30	12	8	22	15	8	5	25	15	47	27	44	63	20	11	9	44	10	7	32	11	20	4	12	20	25	11	17	21	4	12	6	31	32	14	4	10	1	6	22	27	9	18	18	8	10	14	20	23	1	4	18	3	5	6	5	4	0	5	22	24	9	19	9	51	25	6	2	6	10	5	3	4	7	13	4	3	14	30	6	16	6	11	45	7	15	5	3	4	8	7	16	4	0	8	12	8	12	21	7	7	1	23	1	13	9	20	16	19	8	8	4	18	6	5	4	0	2	2	4	8	1	7	1	1	1	4	0	1	2	3	2	9	0	3	1	3	2	3	3	1	0
ne0155	4077	3557	2337	2153	1946	1892	1802	1495	1568	1589	1781	1414	1589	1435	1667	1259	1285	1146	1160	1216	1235	1100	1057	1361	941	980	941	1128	1048	1384	810	1003	964	1048	922	931	992	861	1083	1310	942	806	658	946	758	994	917	1018	916	933	873	782	823	527	731	1057	790	686	852	850	830	817	697	803	689	892	872	840	716	670	816	675	758	888	810	821	936	763	731	723	766	649	741	577	550	682	535	667	834	782	577	599	675	761	656	692	697	570	661	634	770	626	519	644	732	702	520	748	643	570	532	655	755	772	628	488	693	630	448	644	684	632	477	600	730	541	531	502	656	630	579	579	395	621	620	456	463	417	592	556	580	593	522	559	347	749	683	416	576	594	509	438	762	477	593	404	666	543	581	457	563	454	571	592	546	449	522	643	377	556	521	511	601	749	552	459	512	523	367	361	257	689	444	436	536	338	548	533	492	447	434	632	234	503	453	467	401	596	475	643	457	398	298	573	332	474	426	368	615	530	530	463	312	464	407	459	501	373	594	466	506	353	305	573	607	460	419	507	415	485	360	481	404	333	418	455	551	455	409	395	502	447	790	308	348	458	639	341	395	411	449	341	418	294	470	493	437	546	303	374	304	382	371	510	360	453	329	379	350	303	446	348	424	390	438	313	314	372	369	327	385	351	328	251	451	185	522	389	318	376	415	414	335	339	334	295	446	434	414	420	404	317	378	282	437	451	370	329	398	287	391	352	330	347	309	340	382	175	422	455	335	373	340	301	348	303	339	305	337	279	231	421	432	365	422	377	378	353	430	431	355	394	522	266	373	344	341	521	336	260	370	276	233	235	323	427	292	315	334	228	396	233	360	321	304	222	352	303	341	359	209	202	348	333	392	219	314	411	382	302	136	485	282	332	347	235	282	246	311	337	213	256	284	192	325	236	230	303	172	301	275	446	322	350	326	281	232	284	403	237	252	229	302	380	183	263	330	392	310	257	230	214	228	449	257	464	255	346	185	249	348	322	207	326	298	305	216	180	258	288	314	212	274	216	282	295	244	291	172	241	245	230	300	261	214	234	289	232	183	309	207	164	224	202	193	232	246	312	244	209	115	298	252	270	226	207	223	284	190	133	141	310	349	224	245	165	209	291	295	272	220	268	227	162	202	215	267	207	218	242	166	269	187	191	288	220	182	227	238	289	274	243	297	186	265	189	244	136	263	238	211	266	237	289	299	209	190	205	239	240	230	284	305	238	276	197	201	214	184	206	174	236	190	174	200	84	193	198	190	306	159	274	263	184	230	209	241	177	121	175	247	296	209	241	226	211	189	268	197	260	195	229	186	221	213	192	218	218	252	254	235	190	195	247	199	213	228	223	340	209	128	261	267	156	208	157	238	185	255	171	165	256	183	146	192	186	151	309	171	105	196	213	166	127	269	199	165	178	234	143	119	207	169	313	200	215	218	162	231	147	188	173	134	128	139	176	194	162	150	160	140	107	195	174	136	122	154	136	145	192	189	163	200	212	175	181	198	155	194	178	173	278	133	128	225	197	181	164	207	128	148	160	166	174	191	207	175	146	202	259	148	179	154	145	97	150	178	92	305	108	161	165	244	171	126	134	155	186	187	144	219	171	206	144	155	226	119	134	172	283	140	169	172	191	219	192	145	140	146	108	148	121	208	137	112	121	133	183	151	126	173	107	167	150	132	155	99	204	230	173	135	101	196	165	183	168	70	160	153	106	64	152	130	117	95	199	208	138	70	90	110	181	175	184	102	115	136	198	145	196	89	131	192	132	192	135	170	182	215	175	197	99	159	167	121	112	91	139	134	128	129	135	82	160	115	115	151	141	144	123	227	106	117	99	142	122	201	173	85	160	141	63	101	209	180	133	126	107	154	121	186	153	40	108	128	123	162	77	109	144	122	112	173	138	136	127	122	154	140	148	102	110	132	145	126	139	151	129	127	102	91	114	98	156	83	127	175	111	95	87	128	150	144	152	120	140	144	118	129	85	152	91	65	171	202	95	162	119	88	128	133	206	161	141	108	89	149	93	78	125	100	123	106	114	133	155	129	184	128	169	100	115	132	88	114	168	135	135	87	168	204	131	146	129	82	74	97	157	118	98	203	170	75	158	73	116	115	125	119	74	97	109	79	94	85	105	126	126	92	112	90	122	87	153	107	117	162	145	92	122	140	101	52	99	87	78	63	115	77	87	120	98	101	106	87	110	126	142	123	53	119	122	100	99	87	96	107	92	112	127	55	113	112	118	107	171	152	88	78	65	60	147	89	73	68	111	158	109	101	90	89	123	106	111	92	143	118	68	116	137	95	103	145	60	212	97	72	83	139	161	109	99	75	63	103	103	90	109	81	48	89	60	97	123	78	98	97	77	92	113	69	102	102	61	52	75	118	64	105	146	99	72	150	120	76	105	110	86	90	88	73	95	146	100	55	96	90	70	77	97	124	101	90	100	142	153	82	69	73	75	70	151	56	115	83	123	87	72	119	77	109	121	59	74	132	105	58	95	81	63	81	103	134	148	71	102	49	165	75	110	44	51	53	89	105	83	76	107	136	49	50	124	58	114	77	72	141	63	39	122	100	109	88	109	80	46	112	35	62	85	53	67	87	121	105	49	71	43	60	103	51	93	66	54	89	58	73	92	45	109	93	152	41	69	71	53	47	64	62	53	94	76	36	95	129	66	94	65	57	79	105	80	107	24	77	47	54	54	156	70	86	40	108	104	88	98	84	79	41	80	76	85	60	89	35	52	49	73	33	127	46	116	40	53	47	46	59	49	155	87	102	131	86	57	59	55	65	71	86	106	66	76	91	100	34	49	68	74	116	52	132	66	60	55	42	65	32	42	23	32	54	47	79	73	53	109	96	94	91	49	80	76	52	71	33	72	69	69	104	63	88	74	90	63	44	67	48	73	59	83	86	33	93	48	55	44	87	55	68	46	84	30	49	35	78	52	100	60	54	57	76	76	53	92	38	49	76	52	45	44	171	34	32	26	85	29	52	43	44	57	36	94	47	41	39	62	41	37	64	39	39	79	102	104	111	28	77	48	30	68	33	47	40	44	91	27	69	37	35	41	53	63	69	113	44	52	18	34	31	21	46	49	31	22	38	62	52	72	59	65	48	67	48	36	80	71	90	39	23	30	47	30	67	26	55	56	34	58	41	59	46	28	37	50	93	97	25	47	34	53	23	62	61	22	42	46	31	49	58	56	43	56	91	18	80	35	73	43	33	50	65	35	45	43	55	23	27	20	35	38	62	46	26	30	30	35	42	27	30	14	59	55	23	54	36	44	94	39	19	21	81	31	32	43	53	31	70	30	32	50	23	35	19	50	45	41	46	62	41	38	33	34	51	26	55	43	22	90	27	14	29	39	59	28	30	24	18	41	41	23	47	22	36	26	38	28	43	38	20	41	50	37	47	55	21	34	23	27	47	35	43	43	40	12	47	16	30	57	27	44	40	67	30	34	15	26	36	26	46	23	24	67	32	41	20	26	13	70	25	32	38	48	58	38	30	25	29	31	24	18	38	34	28	32	14	36	30	50	36	15	27	33	39	25	19	30	18	31	35	24	30	24	18	29	28	23	22	24	20	45	36	20	28	49	43	29	23	44	19	47	24	17	12	45	12	41	42	25	25	26	21	16	38	24	34	9	13	20	20	17	50	26	25	14	45	22	23	53	9	17	20	38	39	21	56	19	11	20	15	14	13	21	6	13	20	18	11	19	27	17	28	8	23	31	29	36	17	19	42	34	35	11	21	8	21	27	11	13	19	10	20	10	11	12	4	17	12	11	24	18	13	11	11	13	14	28	22	12	8	11	7	12	12	6	11	9	7	15	9	39	21	26	19	11	23	8	6	9	19	7	4	19	16	9	9	16	3	9	9	10	10	11	5	29	22	15	6	22	10	12	11	13	8	7	9	10	8	15	6	24	7	7	13	23	6	16	11	5	5	2	1	6	17	11	10	10	10	5	5	8	11	4	8	8	7	8	11	5	8	9	12	7	6	4	4	1	28	8	5	5	12	10	6	14	2	13	7	6	3	3	3	2	11	11	2	5	6	5	4	7	8	3	6	5	12	5	6	4	0	1	0	1	3	2	12	2	0	4	0	0	1	3	0	1	17	1	4	5	1	2	7	2	17	0	2	3	0	0
ne0156	1976	3344	1507	1465	1544	1036	1157	736	953	1114	1097	833	862	638	1171	814	626	813	1095	596	839	896	803	668	587	646	884	970	1037	1147	645	760	628	503	1027	680	614	567	683	727	777	674	440	442	492	407	444	603	780	495	367	584	529	507	567	593	507	498	605	463	385	580	543	380	470	591	359	594	505	564	493	598	566	507	587	496	456	412	614	506	493	593	272	465	409	243	563	553	814	502	541	441	227	442	394	496	263	410	477	435	552	472	524	252	389	417	377	314	384	490	426	532	224	229	272	416	224	445	422	195	425	238	376	613	534	477	444	228	184	223	443	371	343	355	469	437	438	351	197	406	368	415	247	358	464	393	458	429	443	498	426	284	336	319	273	353	385	254	172	309	324	409	363	404	327	363	400	484	303	369	612	367	362	467	158	455	400	176	289	262	302	434	349	266	330	386	388	345	327	293	308	288	282	364	342	368	283	157	340	314	219	314	203	338	291	328	355	402	393	496	139	412	332	271	538	538	261	437	313	386	365	227	377	364	677	566	284	329	275	292	307	353	346	376	344	387	322	352	229	264	624	220	468	309	185	349	326	283	315	284	239	243	262	262	304	99	430	256	436	340	266	317	294	280	238	224	257	296	390	313	264	236	207	230	328	168	181	201	348	256	241	391	242	225	247	251	302	211	267	324	334	306	290	403	269	278	239	261	227	244	353	214	182	253	350	274	315	495	224	284	226	241	264	223	295	170	337	314	203	198	261	327	284	252	303	266	205	236	299	182	251	287	164	239	339	312	370	234	227	256	236	349	309	294	262	231	318	311	221	200	212	213	266	215	266	222	234	183	305	242	147	217	231	239	258	244	277	426	286	287	203	210	291	169	185	183	248	224	269	191	168	176	132	198	363	302	161	247	206	217	178	152	214	157	164	149	217	173	188	187	309	321	226	297	266	105	250	224	200	272	261	203	179	212	277	179	166	205	287	185	218	183	240	209	225	212	249	206	156	215	251	257	168	248	177	184	204	193	167	197	146	270	132	170	287	187	180	167	247	172	210	183	197	186	182	170	142	171	166	173	165	154	164	182	119	130	136	149	231	112	82	181	118	126	259	143	199	130	179	110	174	116	154	144	147	139	170	164	189	251	178	226	146	192	167	170	160	182	122	145	129	183	220	173	245	155	147	105	284	186	109	144	134	132	163	310	181	210	145	135	165	201	205	387	168	128	163	239	182	231	233	316	207	184	238	230	139	138	144	195	119	139	160	131	125	167	170	151	169	184	164	237	118	112	219	193	207	184	94	151	189	171	166	77	132	166	106	200	131	125	119	113	102	220	167	168	189	116	200	164	196	115	117	141	208	103	125	236	133	146	152	84	171	131	102	179	199	131	129	120	144	115	95	151	112	181	156	208	154	125	134	171	167	141	190	117	175	89	126	156	116	134	92	228	262	119	172	183	246	179	123	167	157	213	180	171	116	145	102	117	155	118	205	132	96	159	103	122	143	165	150	126	151	160	89	183	133	123	157	170	143	112	121	71	175	101	106	165	157	131	114	88	128	99	162	112	144	142	133	187	108	96	128	119	71	265	148	122	179	110	163	202	138	130	99	150	130	191	78	142	190	138	87	132	132	157	84	114	65	160	106	274	178	75	143	153	70	110	101	154	113	123	96	157	104	127	85	137	78	124	95	115	165	97	136	89	120	100	102	93	80	113	134	139	129	171	130	127	113	110	100	77	106	93	85	87	166	159	93	75	85	134	155	101	52	98	72	183	119	92	95	75	144	155	75	105	92	75	94	94	92	117	187	107	139	118	139	68	126	99	109	83	119	138	107	145	95	99	119	84	67	68	43	90	61	101	74	122	55	110	78	90	56	111	140	100	90	153	133	81	186	198	88	65	61	116	48	110	107	77	75	144	186	82	79	89	121	103	121	61	167	104	71	85	143	121	43	71	108	165	82	65	73	116	71	110	111	106	102	93	131	124	122	121	101	103	87	153	89	78	88	148	125	104	132	72	96	155	92	105	123	65	64	162	78	151	72	124	93	59	98	73	168	115	128	88	105	116	71	114	115	143	128	85	123	92	188	65	77	144	168	63	149	90	72	92	89	123	143	101	110	133	154	96	87	96	92	129	98	70	50	92	99	90	139	127	136	144	72	92	58	91	47	109	64	80	85	102	101	89	69	51	70	71	120	89	36	143	87	97	75	91	62	68	88	88	99	64	78	91	78	60	88	68	117	98	51	68	128	115	58	73	75	132	99	124	57	60	73	62	114	126	64	84	68	76	116	62	56	69	90	94	52	136	104	85	31	70	89	78	75	77	48	83	111	119	48	92	51	137	105	62	87	74	40	108	95	111	48	44	64	63	92	77	56	108	95	34	67	82	81	70	199	53	44	65	104	59	97	72	54	69	73	78	41	69	66	67	42	73	65	55	45	62	37	84	109	37	118	24	140	88	133	47	69	47	101	123	89	80	62	78	54	72	65	38	46	51	79	94	47	125	84	52	76	112	63	84	38	73	77	58	162	98	43	70	79	57	58	66	55	104	47	95	27	103	65	46	84	80	72	57	57	110	29	41	74	59	69	62	56	79	57	64	49	48	87	32	60	70	94	112	36	110	60	66	66	36	87	51	82	59	45	36	96	92	61	62	44	65	43	38	48	34	59	78	37	26	37	72	40	40	49	69	84	45	62	53	60	56	83	75	54	25	52	24	41	51	139	65	45	61	74	119	111	192	90	52	68	54	61	91	53	44	52	47	47	61	72	31	45	13	76	85	55	36	59	44	79	83	92	37	35	33	36	21	70	82	53	56	93	72	70	30	31	57	38	74	27	24	36	103	54	45	32	67	38	40	30	30	61	31	27	33	19	27	59	54	62	50	25	60	55	51	57	11	66	85	67	48	77	61	63	25	39	76	73	55	22	41	48	31	49	52	77	38	55	35	67	65	32	56	56	29	45	57	57	39	20	22	64	49	24	51	54	16	46	47	32	55	45	47	48	59	50	38	44	38	84	70	32	51	54	36	52	45	51	23	67	30	47	55	83	36	35	59	22	35	32	66	31	58	31	41	44	43	30	38	38	34	37	54	58	31	77	44	25	37	55	40	86	23	36	21	68	65	34	48	46	42	76	54	40	17	44	32	34	34	39	36	48	28	49	29	19	18	44	38	41	31	24	43	27	64	54	26	21	43	37	20	46	57	32	26	56	46	55	15	32	83	53	29	32	28	42	19	30	50	46	24	106	54	17	53	42	17	49	30	21	20	30	40	11	25	25	45	31	69	31	42	28	38	47	45	28	21	58	20	7	24	13	34	25	36	16	27	21	38	17	23	33	26	53	137	26	26	33	38	36	63	44	38	46	40	67	27	30	50	13	13	37	48	29	14	34	19	11	22	23	57	63	23	38	15	38	27	24	21	50	32	43	47	29	40	23	38	16	22	37	25	22	66	84	45	30	45	30	84	46	27	18	41	44	39	29	23	27	12	30	28	27	61	14	20	18	27	20	31	13	32	10	24	41	66	21	16	19	17	33	19	68	18	14	34	10	23	17	14	12	24	21	16	24	28	14	10	24	37	29	22	22	28	22	47	75	25	16	31	22	35	30	13	10	25	33	23	18	35	9	43	14	25	11	21	11	29	39	19	13	31	15	25	8	16	22	10	30	16	10	21	20	9	16	23	15	17	14	39	17	18	19	18	29	8	7	14	7	59	14	14	6	20	19	20	12	30	37	8	39	17	19	20	17	12	24	19	8	4	23	25	15	6	6	4	12	20	17	9	10	33	14	15	25	5	10	2	1	9	16	1	8	14	25	11	24	36	12	3	7	6	10	20	5	10	9	43	9	15	39	22	18	13	3	10	7	5	1	6	15	9	12	23	10	5	4	10	6	10	12	23	5	4	4	18	5	3	4	8	9	19	8	11	4	5	9	5	19	19	14	4	8	13	1	28	4	6	4	31	0	13	4	5	22	3	3	11	4	4	5	2	23	8	8	12	5	6	1	8	2	7	5	5	7	8	6	3	11	11	7	4	7	2	5	7	11	5	2	1	8	21	2	7	7	3	5	0	6	4	4	2	7	6	6	6	6	0	3	6	5	1	0	14	3	3	0	3	0	1	2	0	1	1	0	0	0	2	0	5	1	0	2	0	0	1	0	0	4	0
ne0157	4422	6773	3229	3946	3489	3062	2875	2432	2452	3043	2837	2208	1963	1969	1606	2494	1876	1976	2172	1851	1870	1970	2075	1855	1574	1516	1687	1896	1936	1708	1404	1477	1349	1391	1424	1743	1045	1516	1508	1221	1407	1234	1456	1204	1291	1166	1623	1106	1455	1258	1208	1252	1257	1403	1780	1358	1415	1356	1255	1129	1365	1267	1298	1104	1128	1093	1233	1333	1217	1301	1096	1396	1467	1178	1556	1576	1382	1363	980	1371	883	1153	1332	1130	1268	1029	1070	991	1551	931	1407	860	1068	1102	1110	1348	1003	976	1027	828	905	1401	1444	1007	1041	839	797	1047	696	1478	1106	1159	960	956	951	970	939	933	1043	1050	1046	1057	1021	797	941	870	850	808	830	967	942	833	864	810	986	870	863	805	1030	809	808	764	1042	941	831	750	834	724	692	862	888	928	706	591	817	1044	807	972	793	1314	842	939	790	684	835	967	743	746	827	1047	819	743	753	554	793	742	893	871	885	783	969	944	761	718	745	1032	725	861	854	793	1036	703	804	722	830	970	750	754	568	652	880	751	615	822	682	485	972	682	680	653	763	704	748	649	812	658	773	873	617	816	850	501	688	535	748	677	649	703	773	637	883	501	763	861	688	540	764	885	747	597	753	703	1162	713	640	580	483	695	774	807	639	797	657	680	919	656	597	741	684	729	1007	567	554	657	492	475	552	688	875	512	636	435	664	622	749	589	546	592	533	773	809	615	637	406	600	447	544	616	820	547	697	463	761	737	651	780	806	613	534	499	771	610	575	505	497	820	519	544	522	566	587	507	762	637	698	609	432	471	459	482	501	466	448	682	491	696	423	743	631	605	582	446	549	978	543	423	577	606	538	506	583	458	605	548	353	521	463	343	448	680	537	706	580	696	446	449	652	607	559	546	459	427	1073	571	471	627	512	771	567	409	723	476	599	511	367	430	393	256	421	407	639	522	373	311	525	437	477	526	355	448	627	468	560	311	431	401	494	570	472	431	578	516	385	517	505	381	626	514	364	496	499	662	477	301	366	401	510	387	440	661	508	445	460	468	364	341	336	470	412	440	695	508	718	416	534	428	354	442	298	340	337	406	472	426	576	384	464	325	312	453	368	320	623	343	489	564	447	506	375	357	457	506	576	424	374	498	429	449	373	416	454	416	398	438	390	424	414	537	441	463	457	297	424	416	379	341	362	398	674	394	408	345	372	323	427	230	357	476	336	375	386	484	340	669	594	396	424	465	492	404	377	426	351	454	267	350	343	385	436	408	320	436	494	377	369	301	558	476	363	584	509	303	397	337	562	414	408	518	388	361	473	364	479	485	378	419	417	398	373	471	588	314	356	322	335	435	427	367	416	214	407	318	346	284	465	442	269	350	347	387	259	225	325	342	212	483	293	326	492	382	328	349	453	420	356	189	346	377	268	334	441	206	317	330	241	334	239	257	301	343	240	419	285	435	225	341	483	378	323	335	350	419	373	321	379	349	503	234	486	375	256	407	339	227	484	338	328	378	397	257	286	412	427	257	381	360	253	357	321	380	370	285	320	317	335	251	281	250	322	235	196	326	343	274	192	273	308	404	293	243	387	309	336	238	292	198	240	405	296	274	222	317	265	448	307	212	337	330	347	239	326	260	318	354	296	295	378	310	211	267	268	435	221	276	231	353	346	284	334	269	279	336	238	298	235	354	225	338	250	332	319	430	271	257	368	331	157	250	302	153	241	311	212	284	373	299	200	289	166	376	246	321	348	215	277	236	262	318	219	281	208	338	268	283	195	189	332	274	267	397	261	183	287	183	321	245	277	333	219	238	227	210	238	310	315	205	214	289	251	371	268	152	253	241	242	236	218	235	156	255	273	186	268	190	245	383	270	131	268	195	240	255	175	211	240	224	188	235	250	218	190	276	234	286	127	328	222	216	203	231	183	234	191	216	244	175	260	195	307	200	304	215	237	171	255	188	164	194	304	191	150	226	243	251	262	225	259	176	261	198	204	192	344	162	184	278	332	210	257	254	233	273	220	262	217	202	201	303	212	269	225	165	206	215	238	281	190	179	252	206	226	185	228	201	240	320	255	129	226	238	182	119	157	174	243	216	206	196	240	148	199	157	206	251	263	255	223	249	161	204	264	282	166	164	235	225	437	132	231	230	203	165	186	196	229	196	245	217	216	178	190	220	284	275	196	165	230	170	198	164	222	180	135	215	218	163	290	217	153	168	222	167	182	197	168	192	194	267	251	185	169	217	157	127	147	202	132	260	251	169	172	165	214	200	309	231	184	201	232	183	147	181	239	214	208	172	158	242	263	244	157	188	139	151	256	132	177	257	198	177	273	160	128	122	172	129	133	199	208	139	173	173	112	220	153	145	193	168	183	137	247	141	139	195	283	162	213	154	127	183	168	153	131	199	235	206	157	241	148	168	153	224	165	174	112	151	132	140	183	136	127	171	309	172	165	109	268	154	145	154	229	174	127	192	171	213	173	150	97	170	151	191	144	115	202	193	253	126	178	122	137	241	89	141	196	109	170	136	143	131	136	143	152	223	149	85	136	112	127	116	89	136	181	246	110	134	126	107	146	183	150	178	217	128	159	123	117	126	161	183	133	132	102	186	205	135	183	88	155	207	135	100	206	116	140	65	197	117	133	158	137	188	204	144	138	113	240	150	144	130	127	151	125	96	186	95	142	110	130	157	136	172	97	105	265	115	137	83	184	116	113	175	110	144	174	183	115	86	186	126	126	239	125	125	88	126	147	118	98	132	118	134	164	80	101	81	111	115	119	121	100	103	74	126	146	132	156	99	178	215	79	156	86	80	152	188	113	104	92	145	109	67	133	181	126	127	140	128	115	103	97	116	102	87	109	158	145	159	167	94	103	115	109	86	73	117	106	118	88	182	117	86	94	108	85	103	84	140	127	68	130	99	136	62	69	72	135	94	109	73	87	143	155	108	167	159	59	133	122	122	108	67	83	83	91	78	150	104	137	93	151	72	124	105	121	72	113	120	108	110	83	122	100	156	98	246	75	94	132	97	132	128	97	78	81	144	100	89	96	135	38	142	58	69	148	104	112	67	88	80	78	107	68	74	113	88	82	100	63	124	89	62	125	94	100	93	87	68	120	118	83	88	110	134	70	105	94	148	94	70	104	108	69	81	151	72	76	92	56	95	76	85	76	70	177	98	85	89	103	92	90	106	86	100	72	84	113	53	62	57	64	87	85	73	161	109	62	141	78	81	71	53	113	64	246	88	88	110	60	64	104	101	74	64	140	74	67	114	81	107	107	109	72	81	74	53	76	85	103	66	121	134	59	62	56	55	72	71	73	48	89	100	135	54	37	84	65	58	49	64	57	86	57	56	63	60	88	101	94	90	196	75	92	48	85	73	69	52	90	118	80	87	77	55	63	59	44	41	59	43	56	89	89	54	57	110	79	79	63	30	97	39	55	54	54	62	42	57	47	86	45	113	69	40	52	113	88	42	50	243	90	88	47	58	80	33	64	60	49	52	126	70	43	84	36	71	41	81	59	63	92	77	68	76	41	56	54	46	46	42	32	47	63	91	51	54	60	66	91	47	44	64	64	75	76	57	47	40	38	57	72	38	52	50	34	21	38	42	50	41	39	85	47	18	31	51	33	67	40	32	41	45	40	195	80	62	57	45	28	75	44	46	33	62	38	61	55	74	52	59	83	65	39	30	63	61	77	48	7	67	31	47	35	34	43	22	62	37	38	47	34	28	22	74	72	24	67	25	42	44	77	28	55	33	53	40	46	54	50	30	31	63	16	23	51	27	40	57	35	73	68	28	34	33	33	31	28	18	39	25	34	37	39	33	30	60	40	25	25	28	34	41	53	20	33	42	27	32	20	25	42	33	43	28	26	17	30	26	22	30	10	42	24	34	24	28	83	34	11	35	25	33	28	18	19	26	41	44	95	10	23	18	34	16	30	31	22	29	36	17	47	30	13	26	34	23	19	19	31	33	28	27	19	16	20	20	25	23	15	13	27	23	17	35	30	28	30	77	18	15	9	20	14	7	15	21	12	17	14	27	22	11	18	27	14	21	18	11	17	18	9	19	30	15	7	17	11	10	24	9	11	11	4	15	9	11	22	21	17	22	24	6	20	7	11	11	3	14	10	9	14	18	11	7	18	5	4	3	6	8	3	5	4	3	8	13	9	25	1	2	0	4	0	2	5	1	5	7	1	2	3	1	8	1	0	3	1	0
ne0158	3497	2664	2170	1630	1756	1764	1606	1532	1502	1354	1277	1323	1377	1336	1279	1107	1214	1123	933	1161	1072	1119	904	1206	966	901	948	1087	851	1168	846	790	946	964	755	935	920	872	941	854	878	889	582	833	661	965	888	833	747	832	854	798	772	589	662	836	617	661	837	741	783	681	467	542	743	820	810	724	775	699	794	577	666	593	529	552	757	649	739	539	682	611	709	586	424	652	574	624	498	725	478	548	650	611	550	553	638	472	664	667	658	517	498	613	607	681	597	656	546	567	550	551	718	642	640	503	687	500	383	615	459	647	451	531	527	540	481	486	639	590	594	506	498	464	470	378	344	457	594	498	534	488	418	483	312	512	513	454	514	530	544	436	605	424	489	405	566	365	492	467	515	489	534	505	434	435	527	458	408	449	499	502	570	580	491	415	485	501	388	395	466	479	436	376	448	421	448	470	413	427	301	480	246	503	473	443	412	560	429	495	397	336	268	496	282	433	468	388	484	412	489	466	345	430	340	398	489	317	448	427	372	392	271	494	483	335	469	459	413	510	334	461	323	282	386	291	447	365	372	366	336	316	366	253	207	450	476	339	421	315	437	382	304	315	362	443	356	455	325	302	298	355	392	372	245	393	332	447	314	292	405	354	423	353	396	269	347	385	373	321	272	323	328	229	362	136	416	273	271	318	407	395	276	331	205	329	384	351	336	348	334	306	311	295	376	285	317	358	267	267	366	368	285	326	307	181	332	210	440	365	291	368	371	327	296	254	320	307	291	234	255	323	357	295	391	337	283	419	313	372	290	365	318	393	317	271	310	330	277	246	344	259	249	230	269	299	263	231	181	219	326	189	250	253	296	249	344	239	222	323	218	211	327	318	322	129	262	393	290	294	257	338	334	263	270	269	263	199	326	265	385	220	256	196	286	270	225	295	117	321	278	581	277	220	279	222	235	181	296	234	266	208	273	289	205	219	290	268	296	259	252	150	336	346	253	438	294	262	153	243	277	229	206	306	226	285	180	148	135	229	333	209	221	244	207	318	193	212	165	288	240	237	227	230	197	232	205	262	187	232	249	164	209	160	222	265	209	220	169	137	139	246	265	235	179	230	189	181	180	130	247	273	270	235	221	183	166	215	237	235	279	265	177	160	143	217	256	180	211	256	168	231	230	140	237	227	150	202	218	254	233	198	261	151	248	158	222	142	257	215	215	211	173	158	252	216	195	177	187	198	183	218	256	210	156	216	164	217	155	182	177	193	145	192	127	74	106	185	195	238	114	233	231	191	232	182	234	178	178	166	218	208	169	175	203	209	188	242	161	250	236	162	164	202	206	182	212	241	207	225	183	163	173	192	184	233	143	188	228	152	118	219	174	110	172	98	219	210	225	162	177	162	146	160	201	207	134	261	158	82	310	163	138	89	171	172	122	175	153	172	73	166	182	216	137	199	209	152	201	152	188	134	158	139	145	150	155	162	132	163	98	68	103	176	142	168	138	102	114	166	195	133	224	164	207	158	190	165	175	182	137	147	141	143	164	216	193	103	132	99	78	82	168	142	146	203	166	154	198	156	142	142	170	121	200	130	135	202	186	90	155	156	156	167	102	166	154	200	198	139	204	131	190	134	169	157	168	118	185	185	94	160	128	151	175	215	168	134	134	105	186	103	148	104	94	119	144	163	165	162	115	117	111	187	132	108	60	121	231	95	110	118	132	134	182	138	54	143	128	112	155	141	97	98	91	201	158	150	100	252	120	191	163	134	93	110	80	184	128	168	63	110	195	171	156	146	140	148	134	159	196	77	144	130	157	117	87	161	130	123	130	100	105	141	209	143	140	144	167	91	160	139	76	101	168	144	182	84	104	137	87	161	133	195	183	154	102	110	92	103	175	91	145	127	151	116	141	83	76	119	141	121	155	54	137	107	89	118	88	96	120	129	120	149	92	155	113	97	86	81	82	111	78	138	70	158	127	105	79	200	127	104	130	114	105	102	108	98	97	76	87	92	68	148	137	61	162	93	93	110	99	143	100	107	143	67	134	78	110	135	127	77	131	100	123	140	95	112	115	136	99	125	121	94	65	82	113	99	87	127	102	120	97	111	81	109	83	147	101	109	100	138	73	123	101	96	128	97	151	70	80	118	76	73	110	56	121	113	83	102	73	143	107	127	121	105	113	104	83	103	118	66	55	121	89	63	205	58	91	224	128	68	73	68	78	99	101	132	95	198	93	76	112	65	52	103	98	92	79	74	67	76	102	130	108	116	150	81	60	92	43	107	50	71	84	87	109	116	69	75	63	103	70	83	101	121	112	55	77	82	92	89	106	47	129	104	50	89	119	89	90	73	123	59	77	79	114	55	83	75	64	55	82	79	83	97	108	59	55	77	80	84	67	76	45	56	109	67	100	121	91	41	114	113	78	64	118	108	116	106	87	75	114	123	65	63	66	65	48	91	113	108	41	127	92	107	87	91	59	78	55	93	37	63	80	93	36	111	84	76	76	63	58	65	141	90	66	57	76	50	88	78	84	81	52	86	23	67	85	94	36	101	53	52	78	65	57	117	90	34	73	91	52	95	51	77	123	80	53	97	82	76	76	106	73	86	86	32	76	70	57	75	121	48	95	18	43	65	82	247	62	81	49	62	74	58	96	72	48	100	55	89	72	45	36	75	29	118	49	49	57	57	50	70	53	64	116	65	27	70	116	81	63	29	61	35	32	103	73	70	91	28	70	61	72	69	70	82	43	72	81	89	47	63	55	37	41	30	34	48	42	92	47	106	38	69	59	38	80	64	81	86	79	85	34	49	53	58	60	48	38	33	58	82	33	56	87	73	54	46	61	65	45	55	53	68	43	55	17	53	74	52	73	70	28	60	67	83	59	42	73	58	51	234	141	39	53	66	84	39	65	59	80	64	47	45	71	57	34	51	55	44	76	21	42	28	65	44	105	37	79	31	35	43	77	40	96	42	48	59	45	90	39	84	42	21	57	45	35	46	99	141	43	23	54	25	39	36	41	23	34	82	43	43	37	67	39	39	39	31	13	57	80	25	54	57	32	50	29	62	13	30	44	55	56	29	39	29	43	49	42	37	77	38	51	19	30	21	30	38	39	38	33	26	61	53	34	54	50	53	40	59	61	44	61	30	70	49	27	33	40	23	33	16	56	44	42	65	63	56	21	30	31	48	53	35	29	48	37	32	31	50	36	26	30	49	33	31	59	25	35	42	73	41	72	29	47	49	26	44	26	35	174	32	53	8	38	34	43	16	46	42	14	18	20	30	36	31	30	12	27	49	11	26	16	27	74	29	21	18	18	27	32	55	22	22	53	36	15	59	21	26	12	25	34	43	45	31	44	34	19	33	35	45	25	43	26	38	21	14	46	31	15	18	35	26	23	27	36	29	13	26	21	19	21	34	29	69	21	42	33	16	31	38	17	41	29	22	19	50	19	28	21	12	28	13	43	42	32	34	31	51	29	43	11	24	30	43	28	34	23	22	24	40	12	18	13	25	179	11	27	29	26	39	12	14	22	25	8	9	26	20	23	38	17	20	30	195	23	10	12	9	31	16	18	10	14	27	13	23	26	26	22	11	5	23	22	24	26	31	15	17	25	29	32	18	15	27	6	23	24	14	13	14	13	82	21	13	7	29	15	8	34	13	15	27	10	28	9	18	32	22	30	12	35	14	22	43	6	19	25	25	25	27	33	35	4	5	13	10	12	4	15	5	13	9	8	6	42	14	13	10	20	18	14	32	5	10	25	29	8	13	17	12	21	27	17	18	8	34	16	15	17	12	15	19	8	11	15	7	2	9	9	4	12	17	27	7	12	9	4	14	13	4	18	22	15	12	10	22	14	17	11	12	8	4	4	1	8	8	3	11	8	5	7	8	3	4	10	14	9	9	3	23	10	4	8	6	10	11	2	6	6	10	5	8	1	9	4	14	7	4	8	16	6	7	16	10	2	2	3	5	15	4	2	2	14	6	1	12	4	1	5	9	11	6	2	4	7	6	9	5	3	0	2	4	26	12	1	1	5	10	7	10	2	7	4	1	1	1	4	15	2	3	3	5	5	1	4	2	0	0	5	6	2	3	3	1	0	1	0	1	4	2	6	0	2	2	2	0	1	1	0	2	0	4	0	1	0	1	0	0	160	0	1	0	0	0
ne0159	3584	4436	2439	3191	2506	1889	1941	1384	1863	1962	1708	1399	1356	1138	1414	1226	1125	1338	1367	905	1418	1759	1314	1227	1056	1402	1349	1355	1595	1288	947	1059	1098	845	1120	919	988	921	1146	1060	1005	973	868	902	968	730	810	896	984	782	718	928	795	1118	1162	864	1126	761	849	778	779	969	769	841	724	976	635	1169	771	762	837	857	796	755	917	865	830	735	885	759	777	735	605	878	778	536	863	784	736	716	826	568	496	650	738	706	525	659	798	733	728	699	714	556	744	641	700	531	598	991	635	836	444	563	482	803	468	646	727	449	666	494	605	665	613	647	726	638	451	454	656	661	710	517	722	789	556	613	434	629	583	635	582	636	600	546	596	947	638	664	640	465	491	623	476	641	563	555	435	507	562	631	598	506	466	556	634	605	519	564	735	573	538	599	350	575	632	371	510	431	675	554	576	491	413	589	462	488	606	717	484	474	681	572	591	622	491	330	487	476	405	507	458	521	580	472	523	564	456	570	344	548	533	452	453	665	472	512	399	549	413	428	443	475	552	640	487	466	478	528	601	525	496	511	489	403	401	506	354	398	622	363	508	402	677	500	438	460	488	425	416	571	439	532	398	264	450	445	543	484	399	420	486	426	488	367	488	504	541	338	456	342	345	369	532	391	467	445	385	450	354	555	456	422	546	351	390	352	399	467	487	459	414	471	451	562	428	400	340	403	448	370	285	340	460	587	445	556	372	382	318	449	380	482	316	607	426	415	517	373	418	340	430	463	554	381	346	444	494	426	468	413	399	515	485	422	474	490	386	451	428	405	410	328	397	301	376	370	384	325	351	436	323	318	410	418	349	428	451	386	263	330	468	426	382	417	382	468	388	386	256	412	370	374	308	335	396	426	384	345	401	260	271	332	346	378	329	273	328	331	387	433	342	236	340	298	372	330	260	317	355	470	344	346	417	462	450	300	324	369	370	303	355	289	341	289	228	313	365	436	388	306	348	324	272	442	363	281	339	389	310	352	368	287	277	350	304	345	302	293	287	348	277	309	414	289	330	277	193	349	261	315	344	305	263	322	258	291	193	239	321	246	258	269	247	303	262	281	308	293	292	303	290	241	324	281	291	312	271	280	264	320	186	235	281	197	277	310	301	202	370	320	219	301	276	257	256	322	240	232	233	280	350	454	329	265	281	211	333	309	254	217	272	255	275	353	256	366	233	253	242	264	243	237	253	244	293	348	270	305	311	304	288	231	301	320	289	210	221	277	194	268	232	251	218	377	224	215	193	310	239	311	243	201	208	263	328	268	254	242	330	268	263	237	212	285	192	342	291	237	197	211	229	374	252	241	314	218	236	336	285	195	190	190	310	206	229	290	227	290	216	168	314	181	211	302	327	262	199	205	252	272	122	249	177	230	220	206	229	242	274	196	154	209	220	495	326	201	428	208	184	231	193	212	368	218	252	233	226	293	227	262	243	171	272	167	217	193	367	335	210	258	246	189	164	197	191	174	177	264	175	255	251	203	187	251	241	202	206	208	230	214	226	158	253	201	186	190	253	223	372	152	233	159	294	202	194	183	217	168	206	183	213	186	272	327	260	235	239	275	258	289	214	238	172	189	199	139	147	200	204	178	174	206	210	154	136	211	168	202	214	263	221	84	158	190	162	182	259	139	227	156	197	147	185	178	160	230	150	236	127	166	208	164	180	207	250	175	186	142	154	175	186	186	214	256	292	251	181	144	177	145	350	178	188	175	191	220	134	156	258	246	158	171	118	194	103	236	192	191	153	152	214	235	175	183	128	148	165	169	146	108	260	159	220	196	215	155	190	156	129	134	152	202	224	197	207	115	191	135	142	107	191	149	128	192	159	199	122	179	130	128	110	146	200	138	207	210	221	152	199	334	141	171	173	160	79	127	154	130	101	160	169	184	155	144	148	141	150	174	193	146	148	178	160	167	116	178	168	196	177	93	152	168	133	183	144	175	113	210	214	267	154	136	155	134	313	172	140	116	124	125	126	145	227	137	191	226	161	118	146	154	144	168	157	177	135	96	160	121	112	107	178	146	162	178	184	209	115	200	148	175	108	89	136	184	263	121	351	164	142	175	155	173	252	199	183	166	147	126	126	177	193	158	140	160	164	91	121	143	254	117	145	137	145	165	134	147	139	126	88	138	129	141	92	134	176	135	160	145	111	112	115	129	290	117	210	157	136	139	131	134	137	147	121	138	142	107	138	191	108	106	154	101	135	141	91	121	211	118	64	104	137	130	135	117	141	137	137	97	149	112	221	100	110	106	131	124	129	141	120	150	99	195	127	117	139	144	127	129	150	122	135	271	176	143	105	92	85	123	110	108	126	136	117	148	122	157	103	78	121	119	99	130	61	143	140	83	74	131	90	105	169	112	71	111	125	107	104	99	272	95	85	155	84	154	162	135	83	114	87	106	121	139	58	80	117	95	112	91	156	129	152	99	72	91	111	123	97	93	127	103	82	101	80	77	122	94	144	129	111	170	141	101	99	141	109	141	97	105	101	140	218	102	71	91	104	101	96	118	74	121	118	139	81	120	109	133	108	104	78	95	96	144	79	92	131	93	93	96	121	99	90	155	83	74	139	116	101	97	83	124	119	144	83	84	93	89	103	84	76	88	53	62	112	93	108	104	100	129	79	85	116	116	96	121	66	236	107	78	82	73	103	142	84	77	119	77	94	92	112	143	105	51	81	77	122	94	109	89	107	75	79	108	111	199	108	99	60	103	108	115	116	73	93	94	89	130	136	67	74	73	66	122	68	89	47	83	100	72	95	86	74	69	254	40	98	106	78	73	88	57	102	72	173	91	90	80	62	56	88	69	128	77	59	71	202	64	106	62	103	100	55	72	71	65	81	117	77	137	69	73	122	86	150	86	89	112	101	65	117	242	82	60	57	117	67	68	90	63	75	86	88	57	103	68	67	107	65	99	43	109	85	52	65	114	117	84	52	63	89	64	63	71	61	62	62	76	70	97	54	146	71	89	79	78	73	65	87	94	58	61	65	43	60	53	71	35	84	30	68	117	101	94	89	74	87	63	46	71	204	70	73	72	77	59	53	53	60	66	63	88	75	43	91	81	119	218	89	109	85	66	68	52	67	86	78	104	47	60	76	67	72	67	94	94	65	38	47	70	54	30	65	68	36	31	45	66	42	96	34	53	73	112	101	76	80	105	53	76	55	137	49	55	92	53	58	40	71	141	228	54	85	58	43	32	59	72	81	81	193	48	47	74	45	34	91	150	46	37	39	65	35	54	55	45	63	54	43	173	94	206	50	100	45	46	80	49	67	50	49	48	42	54	31	75	46	49	33	49	43	38	67	88	41	66	42	66	41	52	54	53	54	79	57	57	26	81	29	31	46	41	44	28	73	62	38	38	44	66	77	46	40	41	41	63	28	42	39	46	60	108	27	47	43	58	30	30	59	74	52	97	84	73	71	45	39	83	53	52	45	49	45	74	112	22	43	35	37	32	56	55	44	43	50	51	49	57	54	42	33	50	58	49	46	33	48	37	91	49	116	78	61	45	28	37	41	43	53	73	215	47	47	37	58	38	37	37	35	39	38	40	41	35	45	29	33	53	52	38	40	23	20	37	39	34	14	60	37	123	23	49	52	42	37	13	51	40	22	47	49	47	37	54	33	17	34	37	32	36	35	53	17	33	26	18	44	50	128	23	19	38	23	18	23	14	19	59	31	30	15	23	27	39	23	36	22	30	35	34	16	18	32	14	36	32	23	11	32	33	29	58	12	17	17	33	24	22	41	32	27	25	26	22	17	7	20	25	46	13	34	30	36	36	41	27	17	9	29	17	42	15	22	18	32	24	31	26	40	15	22	19	14	15	19	9	39	17	36	37	73	23	6	23	14	15	9	30	10	20	18	14	7	31	17	21	18	10	21	34	18	11	12	19	10	12	8	16	25	22	13	14	11	28	12	20	57	35	7	20	26	34	30	99	5	31	14	10	16	16	24	16	14	11	11	5	5	20	9	19	20	11	9	6	11	15	7	31	23	13	14	16	14	8	143	12	3	8	21	18	18	4	8	4	15	0	12	10	17	6	8	9	9	9	11	11	6	2	11	6	4	8	10	3	6	14	1	4	2	4	2	0	0	3	2	3	3	1	1	4	5	0	1	0	1	0	2	0
ne0160	3030	3263	1517	1754	2075	1411	1470	1060	1139	1289	1291	1145	991	995	1114	1035	866	1082	957	865	908	931	1050	715	810	798	828	945	884	912	997	682	931	739	826	832	814	705	819	669	695	910	971	570	583	578	616	742	642	815	661	835	648	565	802	732	774	787	613	509	615	718	898	563	815	569	598	629	634	794	497	735	624	508	739	654	475	526	561	746	679	496	489	550	634	476	706	745	614	508	614	474	441	476	348	632	447	485	519	399	558	541	652	456	394	675	417	472	661	465	526	478	442	424	470	472	447	521	1141	411	418	392	516	446	439	444	466	269	447	404	672	420	539	368	412	536	455	493	367	401	472	421	315	462	447	410	401	494	403	465	575	490	393	368	310	468	399	484	352	325	426	476	522	397	289	466	494	323	1038	336	371	444	525	402	346	382	440	357	427	366	257	486	328	316	281	764	293	370	427	404	268	349	330	561	366	439	373	345	282	400	381	412	344	320	364	403	492	447	303	407	331	333	322	360	269	328	400	530	379	446	531	184	452	383	437	340	416	327	372	372	384	358	406	558	361	329	347	451	324	397	381	316	372	292	241	438	301	321	332	326	257	365	206	301	355	284	339	314	320	347	372	279	311	330	399	211	261	338	510	265	294	234	296	304	268	334	344	275	296	357	427	358	311	267	329	466	368	199	322	279	380	390	338	289	250	387	295	241	297	251	365	192	333	300	299	305	293	268	243	329	297	272	295	298	407	201	305	279	113	260	229	306	318	351	285	280	235	321	305	237	216	307	298	136	315	283	285	263	248	341	213	290	304	150	327	235	312	277	239	346	281	248	273	284	243	255	214	358	334	386	243	284	254	397	261	230	286	365	251	248	301	311	409	200	265	298	261	316	283	207	146	270	198	270	281	233	232	241	252	283	192	224	174	148	157	206	309	261	433	158	276	231	272	222	233	220	243	215	219	224	359	374	217	278	234	153	213	216	180	185	285	488	202	232	188	257	258	192	187	249	235	299	275	211	193	154	236	211	263	188	203	250	266	216	266	217	215	137	158	145	212	98	229	201	248	211	105	299	239	193	206	468	351	223	239	176	151	216	267	236	120	223	159	105	190	214	168	204	251	193	163	169	197	254	162	199	144	195	238	211	195	215	287	253	206	196	104	182	159	182	163	209	209	181	251	166	246	135	225	149	132	173	180	245	213	212	142	162	236	159	216	273	219	157	177	121	201	157	234	257	206	233	168	180	184	270	215	147	152	223	119	293	201	204	272	293	170	157	127	224	203	214	144	162	173	181	201	242	124	148	177	209	119	223	138	155	170	165	315	210	82	113	226	297	203	181	194	66	175	249	192	186	187	151	205	93	135	180	149	184	290	167	198	227	117	185	192	202	107	192	184	219	148	134	157	209	132	276	237	114	175	180	179	201	173	147	167	128	142	170	184	175	196	170	152	141	212	183	123	193	81	138	168	122	157	174	138	109	206	170	160	195	155	177	168	191	172	97	163	179	125	196	218	171	131	169	136	163	114	164	140	180	190	81	186	137	91	165	161	146	154	193	165	161	158	137	225	172	90	134	138	112	184	148	97	85	160	210	181	152	222	138	142	177	160	125	170	125	134	190	116	121	109	136	160	120	89	111	67	159	127	167	176	119	172	174	141	190	125	82	153	193	89	167	105	143	143	150	125	126	121	201	169	124	107	118	158	110	113	172	118	186	135	116	105	191	217	135	125	202	75	124	165	150	81	120	127	139	112	209	130	120	100	100	95	212	126	119	159	150	260	80	127	150	148	138	86	137	161	164	111	61	170	88	147	228	111	133	137	96	103	69	104	142	111	132	111	102	115	171	63	85	199	85	131	101	98	95	98	98	90	68	69	118	181	87	112	93	124	88	120	190	74	81	69	123	65	104	128	32	98	127	126	138	136	135	119	122	199	115	138	125	120	111	128	132	47	66	122	248	108	57	73	94	139	144	81	135	126	98	106	147	136	125	73	156	120	147	168	158	83	120	138	81	128	130	117	154	140	65	78	118	80	97	84	100	103	103	86	101	91	121	123	95	114	94	80	95	89	99	118	97	133	103	138	153	109	60	190	103	119	65	88	75	93	80	113	113	139	143	93	79	91	61	116	133	111	90	116	163	125	75	113	111	105	115	138	105	76	77	270	95	88	78	120	101	105	87	116	81	89	95	158	65	156	86	138	108	101	98	56	107	88	100	112	69	92	86	83	93	91	65	133	48	128	115	65	100	102	78	53	102	75	106	113	96	46	97	106	73	105	112	81	149	160	122	74	77	56	66	111	72	148	126	143	94	74	89	155	57	74	78	52	84	62	99	115	119	88	92	102	107	102	77	72	115	25	104	71	99	134	130	70	81	95	91	102	59	91	71	82	64	116	64	223	70	59	138	77	55	199	70	81	93	67	100	59	96	79	103	56	72	51	68	59	94	61	92	61	44	133	79	58	73	55	75	71	85	58	74	100	97	66	66	110	85	147	75	89	68	88	105	97	61	75	81	90	52	66	106	104	100	108	72	64	81	53	61	56	67	69	81	94	106	45	138	50	78	72	101	79	68	67	106	41	58	59	70	63	72	44	95	64	62	120	110	125	55	66	64	85	77	56	51	120	27	63	53	96	165	70	42	43	108	94	68	60	37	41	57	78	72	41	76	71	92	35	59	76	65	137	50	115	96	89	84	63	45	71	48	35	54	84	50	78	140	44	69	58	49	55	32	72	87	68	79	101	42	53	65	57	74	37	49	121	75	38	81	54	51	62	26	73	67	61	56	81	77	92	64	86	66	51	52	67	52	57	62	72	46	73	58	93	31	43	73	41	53	51	48	77	89	57	81	98	94	41	66	77	73	54	75	35	58	100	58	81	54	80	44	30	84	112	49	63	30	54	75	83	49	62	59	54	112	38	83	65	57	72	74	80	80	76	23	59	47	68	170	75	52	33	45	61	46	52	60	41	54	37	70	47	54	39	62	79	118	56	69	34	51	39	59	21	107	57	60	59	70	87	73	110	51	52	17	76	50	59	50	54	34	48	64	64	52	45	48	42	104	162	75	31	46	33	35	57	59	44	76	49	67	40	66	75	49	70	68	30	57	26	39	45	38	33	45	32	34	29	43	50	39	53	41	20	29	76	24	30	31	35	46	33	42	34	38	16	32	34	51	34	28	30	26	55	63	47	52	45	58	39	52	42	49	41	56	34	52	111	38	50	46	61	26	31	50	50	36	42	39	63	29	89	54	19	60	56	33	31	11	51	26	32	33	32	39	55	42	53	30	24	32	44	50	56	37	35	35	49	52	20	71	43	41	39	24	24	25	27	23	46	50	33	27	23	30	52	26	10	43	36	48	36	42	45	66	27	25	102	58	35	36	23	23	26	63	25	38	22	28	35	56	50	30	37	111	27	22	43	30	41	39	26	57	31	29	52	48	18	22	61	55	13	47	35	26	30	59	26	51	46	32	35	21	38	40	20	20	29	14	25	35	16	26	38	32	26	27	48	30	22	33	22	30	38	62	38	30	43	22	12	21	46	22	33	50	30	33	40	57	14	41	53	25	13	25	21	21	21	25	18	15	80	18	54	50	29	31	21	24	12	16	31	34	38	37	25	27	8	27	22	48	21	22	37	27	54	24	32	18	33	37	23	17	19	55	13	38	62	45	16	28	15	19	13	11	21	36	36	15	82	35	15	32	25	7	26	11	29	38	15	33	79	15	2	28	25	32	19	17	20	21	17	19	18	17	19	7	24	5	28	18	17	13	17	18	4	28	27	15	13	39	15	42	27	12	10	10	19	19	11	15	24	12	18	60	26	22	24	9	24	26	10	18	4	7	13	11	13	6	28	8	5	16	8	9	12	11	23	5	31	49	8	21	4	4	22	11	6	15	14	24	13	11	1	15	16	18	11	16	10	9	11	8	9	18	2	7	11	11	13	8	4	17	13	18	4	21	6	15	7	10	23	2	21	12	8	30	5	40	4	10	10	14	16	5	7	3	3	4	9	9	10	2	10	10	26	8	10	18	24	5	10	7	18	10	24	5	2	14	3	12	7	7	4	9	7	2	2	8	5	1	5	3	13	3	14	9	0	2	4	0	4	3	0	6	7	10	8	2	77	0	2	1	1	2	3	0	0	2	2	4	18	0	0	0	1	0	0	0
ne0161	1193	1471	840	852	818	568	656	419	537	461	626	495	489	482	550	413	461	421	461	410	428	414	404	437	316	360	363	437	504	554	397	385	317	256	528	415	320	362	367	474	305	310	291	283	289	254	233	307	516	367	223	296	385	294	270	362	302	232	390	339	225	290	316	305	286	315	256	288	278	271	292	314	315	338	321	260	296	250	289	286	243	321	170	280	253	184	199	235	242	297	256	270	173	261	294	257	160	207	251	210	232	287	221	145	225	195	226	203	169	191	212	218	191	171	144	299	154	232	200	144	209	131	234	262	246	247	212	208	121	167	189	223	193	250	194	307	232	180	123	239	223	220	227	213	231	234	224	254	231	240	212	138	243	150	207	204	202	175	115	162	156	219	202	162	219	200	191	286	186	188	245	154	209	195	98	208	206	113	142	168	169	192	209	165	222	222	232	243	178	204	196	178	185	168	147	161	181	147	219	121	193	167	172	180	233	122	162	139	277	196	110	222	175	176	196	194	156	253	196	157	193	168	166	172	268	204	162	200	213	134	210	173	220	153	184	186	236	146	138	128	197	139	144	209	125	153	188	99	167	162	158	174	142	143	167	88	144	134	143	212	112	159	131	166	170	153	134	190	171	198	184	133	120	129	164	127	119	127	185	149	175	127	113	198	124	163	220	127	204	134	137	103	177	130	261	148	150	149	141	116	194	122	175	109	188	182	110	173	175	108	131	124	138	123	186	152	141	128	168	149	119	182	118	177	100	134	107	146	110	92	118	98	125	247	114	147	110	217	107	86	121	142	155	153	96	143	164	117	153	124	113	131	110	126	132	98	149	102	146	109	127	130	142	135	167	127	97	122	177	138	99	99	129	106	102	164	150	95	117	112	129	164	87	81	177	113	66	110	101	87	127	191	145	138	124	69	130	126	146	110	117	142	104	122	139	94	125	94	99	107	88	82	106	96	95	119	113	147	119	100	99	125	131	166	116	97	103	122	135	121	99	140	90	115	88	106	122	108	126	88	64	121	100	93	94	99	81	110	110	97	111	124	86	72	95	100	104	109	82	116	85	60	151	99	84	88	67	59	113	92	192	99	76	111	147	97	125	80	104	124	76	81	134	107	62	139	87	144	69	163	86	95	101	106	73	66	104	84	74	111	71	114	85	69	66	106	102	93	136	64	80	118	67	61	81	82	83	66	66	62	92	109	92	82	77	74	100	83	97	62	89	121	111	72	137	74	54	84	85	92	88	111	87	63	128	162	122	76	96	81	88	114	118	66	109	89	117	54	98	74	56	98	89	61	73	81	75	81	45	80	102	108	56	79	55	40	92	83	86	62	75	77	79	64	120	60	78	104	95	56	61	56	92	79	54	111	75	92	82	80	78	56	93	58	67	97	87	94	60	95	76	64	78	76	81	81	104	46	79	79	108	69	68	73	112	71	75	84	102	52	68	82	72	87	73	81	56	64	69	58	61	44	83	86	60	54	95	107	74	41	81	72	72	64	51	65	83	53	85	88	76	88	53	42	74	104	73	66	77	93	55	57	77	42	59	54	61	72	57	82	84	55	59	70	56	77	61	60	53	51	48	74	76	84	81	54	65	84	85	114	58	61	53	88	63	94	80	86	52	78	70	50	55	92	108	81	36	54	66	64	71	76	60	67	40	65	51	59	58	56	120	55	75	86	67	70	77	73	65	49	62	42	26	62	69	36	59	43	65	53	65	54	71	48	54	73	108	56	49	35	56	48	84	68	25	69	55	102	65	55	56	67	57	60	76	46	68	58	77	58	53	45	64	58	63	28	44	34	61	40	65	72	46	63	71	70	67	94	52	78	50	31	61	68	51	58	74	65	43	74	46	58	44	64	75	47	41	57	160	37	65	53	42	32	46	68	48	65	40	63	56	51	69	59	47	43	47	50	70	58	48	58	24	55	61	49	46	42	28	70	43	62	55	52	47	62	67	49	41	57	43	47	51	65	74	53	72	26	56	57	42	40	69	89	53	44	68	30	38	68	50	37	35	70	43	41	37	43	60	32	51	44	59	35	49	47	48	56	56	42	52	69	67	28	61	50	60	67	37	77	31	32	44	41	59	47	40	56	62	45	50	72	41	62	40	58	47	81	64	43	45	63	38	44	46	56	43	65	39	62	43	60	27	50	77	60	43	66	38	34	51	30	53	41	23	57	30	73	56	32	60	40	28	38	57	62	45	36	36	42	40	66	20	32	26	39	27	41	61	84	51	44	44	85	56	58	42	25	44	49	36	57	46	27	45	43	53	38	39	36	40	65	45	49	33	42	39	40	45	45	37	65	29	23	53	42	36	41	41	33	54	28	49	38	44	67	35	52	63	29	37	31	72	27	36	41	36	31	28	53	49	46	17	33	55	68	58	26	67	51	23	48	58	44	26	45	45	26	28	40	44	23	27	25	23	34	47	16	30	31	42	48	134	33	44	39	31	28	44	47	36	48	36	22	35	48	60	48	35	33	52	52	25	28	22	37	55	17	22	42	45	24	53	38	18	40	47	34	34	34	38	42	51	22	23	28	33	22	48	38	60	46	24	51	20	39	16	41	33	36	37	31	24	39	28	51	30	25	21	35	28	50	30	24	23	18	28	32	43	47	35	42	27	33	13	40	45	14	35	25	22	57	57	35	23	21	11	24	22	37	50	42	25	36	23	40	33	26	32	29	24	29	11	57	29	36	41	39	24	31	14	53	23	17	38	39	30	25	31	41	10	41	13	17	34	33	23	45	40	31	36	20	25	40	26	24	30	40	28	41	41	38	35	29	23	14	25	38	35	28	18	25	45	18	11	25	14	34	26	28	20	59	34	32	21	39	13	37	21	53	32	25	29	33	32	17	32	27	36	32	24	41	55	21	36	16	34	24	28	22	21	22	17	27	37	50	10	21	21	16	26	26	47	20	38	25	34	30	29	22	31	15	30	52	24	38	19	24	25	22	36	22	8	19	39	17	38	16	34	26	39	29	35	11	21	26	40	25	21	25	23	33	21	26	25	22	23	24	19	19	23	20	34	15	42	10	13	29	22	31	51	30	22	28	38	19	42	14	32	16	15	39	22	24	32	28	24	15	20	15	19	9	19	38	33	23	13	13	27	14	35	31	27	18	14	14	28	27	16	5	15	35	22	25	21	26	31	8	26	9	33	27	21	22	16	16	39	15	14	7	18	16	17	17	25	11	24	11	30	28	26	30	20	15	45	17	25	32	31	15	12	19	11	37	30	47	30	20	15	8	23	34	26	13	19	20	16	17	22	11	7	14	24	21	27	24	35	22	46	19	14	15	37	30	30	27	22	8	37	25	15	13	8	33	17	16	18	9	19	18	14	16	18	26	18	27	7	25	10	17	24	9	3	20	26	14	20	12	15	13	14	17	23	13	18	25	32	16	19	13	28	23	16	24	11	28	18	25	22	19	29	13	9	18	9	18	28	30	9	15	13	23	17	15	21	4	9	16	14	20	4	25	22	13	15	25	20	12	11	7	1	14	6	24	13	19	13	7	16	7	46	4	11	19	21	17	14	11	18	22	7	11	28	14	7	13	17	17	6	11	15	17	10	21	21	7	11	12	9	8	10	13	16	10	13	2	19	7	10	3	25	22	7	9	9	20	6	22	5	11	12	8	17	11	16	28	8	3	10	10	25	22	15	36	8	21	10	9	8	8	7	10	10	13	7	20	6	9	11	13	9	13	19	2	14	8	20	6	18	14	11	16	5	7	1	16	14	8	8	12	7	6	9	5	2	6	6	4	5	2	10	11	8	3	6	11	15	2	7	13	7	16	4	3	5	6	4	12	8	1	12	7	12	5	2	3	17	5	3	14	6	10	2	14	10	8	4	8	5	6	1	13	3	3	8	7	3	4	8	8	9	7	13	2	4	1	2	1	8	7	21	3	3	1	11	3	5	4	6	6	8	8	0	4	8	0	5	4	15	1	1	10	7	1	5	6	6	10	7	10	3	3	1	5	3	4	0	5	0	3	4	3	1	2	1	0	4	0	3	14	7	1	5	5	0	18	0	1	3	0	1	14	5	5	3	10	5	3	3	7	0	1	2	2	3	0	2	0	1	3	0	1	0	2	0	0	2	1	2	0	0	2	1	1	0	1	2	0	2	0	3	0	0	2	0	1	0	0
ne0162	1469	1302	1007	787	795	706	686	534	547	681	564	484	561	523	600	524	555	447	659	457	435	487	459	512	409	374	364	445	458	523	335	418	412	342	333	343	378	318	414	403	409	334	276	334	345	408	401	387	426	313	334	306	256	301	285	380	269	226	331	265	324	397	209	214	269	323	337	355	310	239	387	314	251	302	278	180	322	249	274	241	285	249	274	298	197	272	269	258	298	283	218	248	234	243	242	278	256	236	233	300	221	251	288	248	241	271	194	252	273	271	203	245	266	419	215	303	243	228	194	223	230	239	159	295	214	244	221	238	218	247	203	240	170	221	171	193	166	238	203	180	214	203	237	196	174	232	235	196	201	230	198	156	258	264	241	151	267	144	191	210	180	182	200	176	183	185	237	230	123	208	209	183	228	266	179	209	212	178	165	161	219	200	224	175	159	134	189	207	177	196	137	236	187	187	161	148	159	202	171	175	166	166	145	191	144	164	178	152	199	196	194	162	156	194	272	186	185	144	239	121	112	161	130	205	200	218	156	174	205	178	204	181	178	129	164	136	157	168	144	145	138	116	168	141	102	186	133	148	178	153	166	108	136	117	152	164	174	217	184	155	125	133	162	181	142	196	144	183	122	139	209	156	177	150	144	133	153	144	149	144	125	185	175	108	120	59	223	155	163	132	150	203	129	130	107	117	164	173	175	144	114	146	134	132	163	115	116	145	121	122	107	163	117	116	122	88	142	93	168	140	123	159	143	113	116	117	121	124	131	77	129	155	198	145	152	128	117	206	108	152	145	143	148	260	130	123	145	161	150	122	141	94	113	94	131	117	139	151	99	108	148	112	104	96	104	115	134	91	139	125	75	93	121	146	128	89	110	176	104	89	137	124	109	121	118	125	92	101	113	97	178	98	114	106	117	102	140	126	60	144	107	193	118	143	141	104	88	140	99	96	115	103	104	122	104	81	116	114	92	132	111	55	116	129	115	153	142	119	94	80	126	120	70	110	114	116	86	89	73	105	108	118	100	112	94	113	72	84	87	97	89	127	143	101	91	71	80	93	67	102	88	103	71	135	77	88	99	110	89	81	130	89	136	116	97	101	83	98	70	64	75	133	104	67	102	81	101	95	90	95	80	110	52	56	69	89	123	76	83	103	110	85	95	72	94	66	50	111	96	135	126	88	85	92	88	123	91	56	84	98	83	81	92	104	114	102	66	82	68	109	73	94	96	93	89	86	117	78	48	88	64	92	74	88	60	78	73	58	53	90	59	77	89	73	65	74	83	95	95	90	86	94	85	101	67	81	82	97	106	87	92	67	63	100	89	71	88	95	54	89	75	84	63	72	64	72	80	74	128	55	64	78	116	81	78	65	86	97	99	86	82	61	64	81	81	75	57	103	39	70	61	60	79	24	75	70	72	75	77	54	42	39	44	98	56	80	77	78	60	61	64	76	52	57	50	72	70	61	57	52	71	67	83	61	36	56	58	51	54	65	56	47	77	56	76	76	90	60	77	69	91	88	46	72	70	74	54	46	97	69	56	25	74	46	73	67	54	43	77	101	47	49	61	50	72	71	53	59	83	37	63	64	64	60	33	45	82	56	92	57	75	70	83	64	38	84	56	56	62	88	48	37	56	62	50	50	70	41	61	69	56	46	70	46	34	49	32	71	67	40	69	65	46	58	52	45	47	56	80	35	48	41	61	71	58	70	59	55	65	27	61	60	50	52	38	74	81	59	38	42	87	57	61	62	26	45	49	59	67	74	38	43	73	53	95	45	52	53	56	49	73	34	58	63	49	52	101	62	48	48	41	41	43	36	54	48	66	63	51	38	61	39	62	33	60	60	58	73	36	55	49	47	49	62	61	73	38	62	62	52	94	46	45	41	72	54	47	55	57	67	48	46	37	27	72	41	44	39	35	43	40	32	41	69	66	71	32	59	32	34	35	53	45	48	39	35	65	52	42	38	46	44	37	54	68	35	55	47	45	28	41	26	43	51	58	28	44	46	42	55	50	78	39	56	43	25	46	41	39	41	32	33	39	45	40	55	47	56	54	50	40	90	50	29	19	29	39	46	53	81	32	40	46	55	41	40	36	46	65	27	32	54	50	51	44	46	41	39	30	27	36	49	32	23	31	27	25	57	49	30	19	41	38	36	57	61	38	61	24	32	39	38	34	43	36	41	37	31	28	27	46	43	33	32	24	43	33	44	58	30	38	59	31	29	27	38	40	36	34	29	43	50	30	27	45	45	48	28	31	29	26	35	22	19	36	44	42	36	24	30	29	30	21	38	52	46	65	15	20	40	32	44	38	28	90	54	27	32	33	42	26	32	29	24	36	50	50	42	27	42	34	27	61	36	39	36	33	25	36	45	24	33	33	53	22	44	53	39	60	31	33	26	47	39	27	36	32	28	36	32	29	45	83	49	22	40	38	29	37	45	63	38	34	33	29	37	32	26	25	37	21	42	19	26	12	59	41	22	14	19	53	34	31	25	54	29	33	26	29	12	18	28	37	32	14	34	20	30	34	44	17	29	26	36	29	36	27	29	37	26	27	23	14	18	35	28	39	30	16	38	31	38	33	63	20	47	37	10	23	21	21	20	24	31	40	24	19	34	23	24	30	31	12	24	44	33	19	26	41	27	29	31	21	19	25	23	23	47	31	36	30	23	23	24	16	23	25	25	18	41	13	23	15	19	50	8	64	30	23	30	19	32	26	27	32	32	20	25	15	30	13	27	23	23	25	28	28	23	17	23	15	45	18	59	20	13	25	26	45	23	38	27	28	31	32	14	11	20	20	24	16	34	25	39	10	17	34	40	16	13	17	27	36	29	18	25	13	38	6	23	24	13	20	33	5	19	32	47	21	15	38	18	24	36	23	25	26	30	28	12	28	33	16	27	19	15	18	15	18	30	29	17	29	3	29	12	23	17	38	19	21	30	20	25	31	32	27	21	11	19	26	23	15	22	13	4	35	24	29	21	58	27	19	20	29	47	11	10	18	18	8	24	14	22	21	31	20	7	19	18	15	18	26	15	24	11	17	21	4	41	9	24	30	27	24	29	16	13	10	23	11	15	32	12	14	11	16	11	16	12	24	4	30	17	13	18	22	15	18	11	15	25	17	16	12	22	33	21	17	16	22	19	18	14	20	13	12	20	12	12	18	6	14	24	49	16	12	26	13	24	33	13	12	15	19	9	18	8	26	15	13	14	18	8	30	12	14	15	17	23	22	18	4	10	20	13	11	15	16	6	16	25	13	12	9	8	8	6	10	12	19	15	12	15	10	17	23	8	11	16	12	27	16	33	15	21	29	7	12	17	12	19	16	15	13	12	30	7	9	13	13	16	16	17	17	6	10	15	6	6	15	11	11	3	10	19	19	17	18	18	19	29	6	10	22	19	11	18	6	13	17	8	19	10	8	23	17	11	19	34	8	9	8	4	13	4	8	12	9	20	26	17	12	28	7	14	8	12	18	12	9	7	15	15	11	21	7	9	6	7	7	20	13	12	11	11	13	13	12	7	12	20	6	9	5	22	18	8	12	6	4	7	16	10	8	7	12	12	7	10	9	5	9	6	62	11	10	12	17	19	10	9	11	42	6	5	6	13	0	16	9	10	3	17	8	26	7	4	16	11	9	2	11	6	7	19	13	4	13	7	10	9	18	8	8	4	2	13	1	6	17	3	15	9	10	15	7	5	3	5	9	2	6	4	8	3	5	1	6	17	9	10	8	5	6	9	13	2	11	21	6	4	4	4	7	2	5	6	2	5	6	4	7	3	6	14	5	6	10	8	2	10	1	2	4	7	11	8	6	2	7	2	5	4	8	8	10	8	2	9	11	10	2	10	4	3	0	3	3	2	3	4	4	2	1	9	0	4	1	3	3	4	10	5	6	3	1	6	1	0	1	6	4	5	4	4	3	3	4	3	3	2	2	5	3	4	10	3	0	1	5	4	3	3	1	1	2	4	1	6	3	2	1	1	5	1	3	1	3	1	2	3	1	0	3	1	6	1	1	1	1	1	0	2	0	3	1	2	3	1	3	3	1	0	1	4	1	2	0	2	0	1	1	3	4	3	1	1	0	0	0	0	0	2	4	0	1	2	1	0	0	1	1	3	4	1	0	1	0	0	2	0	5	0	0	0	0	0
ne0163	3436	4282	2559	2672	2634	1639	2008	1185	1609	1503	1721	1226	1059	1131	1366	1148	993	1250	1363	1074	1272	1109	1185	1492	1058	1248	1160	944	1224	1263	1059	1166	958	676	1094	1205	975	966	1018	899	802	841	918	848	1056	715	684	837	734	900	646	821	898	990	865	759	937	905	817	859	609	935	1086	841	813	732	562	1104	843	847	936	732	801	858	917	949	944	658	790	764	634	729	591	812	835	559	680	747	741	761	811	655	404	616	772	603	516	872	976	1266	779	730	840	413	717	615	569	451	582	588	564	619	490	417	431	614	449	522	636	387	591	398	702	614	591	713	608	831	435	446	701	658	637	631	643	642	584	758	363	572	543	411	638	529	598	572	675	463	455	674	466	613	484	630	544	545	378	622	368	777	518	536	541	604	519	503	534	604	632	674	634	593	507	539	340	594	555	317	490	573	880	538	562	377	624	581	560	466	444	490	451	479	768	521	608	547	492	305	495	466	475	590	513	469	596	423	462	442	414	473	294	545	419	460	415	582	441	485	399	440	589	518	484	455	570	586	462	731	406	325	514	439	524	538	390	438	530	447	534	492	509	486	424	421	431	462	328	421	329	436	501	541	437	514	459	238	491	461	473	503	454	464	502	417	418	376	332	432	502	314	591	358	318	438	510	405	396	258	397	432	358	360	389	268	460	292	432	427	388	298	417	407	417	317	288	348	660	452	297	422	436	646	398	355	348	361	446	449	288	378	441	409	432	366	318	311	346	348	683	427	450	391	514	379	271	424	311	361	363	533	286	300	315	397	451	335	431	337	274	397	294	312	450	424	252	331	294	415	411	355	349	289	306	334	331	248	528	416	341	373	326	298	373	421	507	417	302	342	416	345	410	453	370	307	343	298	222	373	307	318	430	349	373	265	294	354	337	313	309	329	361	346	270	267	481	349	245	244	249	514	376	363	243	331	223	291	308	261	247	285	253	354	268	306	398	251	276	303	426	229	277	302	276	390	294	320	321	287	407	267	547	388	345	263	311	247	259	273	211	320	282	378	292	262	244	256	403	241	256	306	318	396	195	365	261	313	263	269	226	253	276	303	297	295	294	208	359	422	265	363	235	203	210	277	264	202	329	397	353	178	372	369	252	253	206	234	266	336	350	212	393	291	267	261	288	301	316	203	269	212	238	327	217	287	375	227	265	231	244	237	229	252	290	265	297	206	263	253	211	295	277	331	239	275	182	287	210	162	372	174	245	217	298	270	244	275	330	265	298	249	241	256	272	254	260	234	243	312	244	238	248	227	183	248	325	327	212	222	174	275	352	251	184	318	289	228	300	210	204	225	280	174	406	216	283	333	448	342	256	272	211	220	248	193	248	288	158	266	197	187	199	205	381	196	211	171	209	172	193	207	139	233	216	379	256	186	175	212	250	197	239	331	207	192	267	245	313	202	191	198	157	190	190	182	248	147	183	190	243	246	190	227	190	169	263	208	509	182	195	228	217	124	292	214	267	168	329	226	194	190	240	192	186	192	239	203	180	281	235	247	169	196	208	203	272	207	209	170	293	224	256	265	186	256	171	542	172	268	341	170	232	186	128	204	277	155	158	190	139	196	170	158	176	271	228	188	120	252	118	244	259	174	210	167	169	221	176	189	106	153	233	200	226	167	218	170	155	167	145	125	137	176	229	179	159	191	143	145	191	192	118	140	198	231	198	243	186	103	177	187	130	180	148	132	133	136	275	137	154	142	230	199	143	266	187	156	178	182	117	185	161	114	180	210	210	125	129	149	214	123	283	209	193	129	186	138	151	179	163	145	203	154	191	140	168	209	118	149	147	235	156	179	76	152	177	61	154	153	141	174	131	153	190	141	173	161	152	220	114	102	220	202	104	279	189	213	149	161	230	190	194	172	190	133	104	219	126	108	185	180	149	204	140	140	132	124	148	123	132	208	135	114	229	158	182	252	240	171	227	194	161	128	100	159	150	131	201	141	135	175	162	182	88	163	138	193	120	145	215	159	142	132	121	117	112	128	128	156	173	107	148	167	121	198	87	157	174	147	90	130	135	107	115	123	148	120	79	163	124	118	112	106	189	66	111	124	154	112	182	123	159	124	153	167	110	150	117	125	136	106	129	125	160	85	140	128	131	104	127	146	122	77	161	176	126	124	180	109	82	98	116	125	106	117	79	141	208	95	130	153	205	101	85	117	171	87	106	117	123	141	81	143	143	119	67	143	101	123	139	142	149	71	129	83	97	76	110	117	178	103	116	178	160	94	95	113	97	118	141	155	110	126	119	114	241	170	162	99	103	71	154	95	106	135	99	160	102	118	100	118	71	105	112	121	120	101	196	91	107	135	53	115	109	116	86	116	224	192	139	78	108	77	140	133	93	102	91	150	134	141	92	86	89	71	95	111	106	142	101	103	84	134	96	75	134	145	82	132	134	78	54	161	130	100	68	154	72	146	101	113	196	126	165	67	149	95	93	90	90	66	119	86	82	66	146	166	117	99	75	82	97	53	110	101	118	106	228	154	106	123	112	55	97	102	138	105	67	131	103	67	93	59	102	109	86	82	82	74	155	76	93	143	81	69	166	91	143	78	91	111	83	74	113	96	114	96	127	80	81	131	114	92	69	175	87	88	118	98	86	175	85	91	97	69	61	58	107	39	106	103	64	60	65	77	75	114	142	108	88	98	125	79	99	70	101	65	84	78	82	86	136	99	145	28	46	66	92	87	77	66	64	67	110	105	123	109	149	62	133	87	120	119	84	96	65	63	63	115	57	83	82	67	120	53	102	65	86	53	113	68	95	43	69	128	359	122	92	106	88	75	78	100	68	82	86	65	106	63	123	84	68	66	49	50	40	62	58	81	110	44	89	83	54	69	63	63	60	71	78	54	62	113	55	91	107	122	87	57	121	100	105	106	95	68	80	52	77	83	119	88	78	83	89	75	90	61	79	69	58	64	76	64	59	69	58	76	90	97	88	76	96	42	70	41	56	45	63	82	85	60	48	99	39	83	57	99	103	97	94	65	48	79	62	98	81	50	45	66	57	100	38	59	65	59	54	41	69	63	64	59	38	49	60	75	74	42	60	58	43	55	65	112	40	59	56	71	44	54	51	45	42	63	26	25	99	99	83	53	55	73	45	64	33	77	40	109	76	51	40	79	74	90	58	58	38	49	92	123	68	46	30	20	91	77	39	78	14	42	44	27	39	59	61	77	82	58	54	58	48	69	66	53	74	46	41	54	66	52	86	21	84	44	26	59	86	63	67	37	46	66	66	60	45	37	48	44	51	42	31	41	88	65	35	78	28	25	48	48	40	37	114	60	29	21	36	38	64	37	71	63	32	37	41	73	50	25	53	51	124	38	88	78	39	53	49	50	56	35	55	27	57	22	86	93	28	39	38	50	48	59	66	53	58	27	66	21	36	64	25	55	71	71	46	52	41	65	31	31	76	28	46	40	49	46	59	36	36	35	22	20	47	43	44	63	17	17	36	34	34	35	34	31	36	56	46	28	29	30	30	27	17	44	92	34	20	31	25	30	18	30	108	22	39	34	24	31	33	46	32	25	57	18	23	30	31	34	23	30	27	36	38	13	40	20	21	46	35	29	24	49	31	30	27	37	22	31	32	32	39	49	63	122	21	26	58	24	19	21	23	18	37	31	41	39	23	17	32	17	22	22	16	27	25	67	28	24	48	20	30	19	27	65	57	10	54	16	23	46	48	27	34	13	15	22	23	15	12	39	18	14	25	20	28	14	41	16	11	17	21	14	14	41	30	42	22	23	20	15	16	38	14	18	25	15	17	19	14	4	29	26	22	15	45	15	32	14	19	15	14	21	27	14	14	20	19	23	15	20	20	17	10	14	30	34	17	17	20	22	13	16	20	15	25	22	16	21	12	6	21	23	16	14	34	6	30	34	14	27	21	29	6	9	8	20	8	6	9	9	10	13	26	16	13	4	21	5	19	24	19	11	8	9	17	19	12	12	2	19	11	25	4	17	4	14	8	8	27	12	7	4	13	55	26	10	4	16	28	13	15	6	6	10	11	12	4	12	5	10	6	15	5	6	18	21	4	3	2	3	9	13	3	5	6	6	7	4	2	12	7	2	2	2	2	2	2	4	1	3	4	2	1	3	5	4	0	0	2	11	3	3	4	3	0	3	3	0	0	0
ne0164	1729	2353	1523	1274	1711	896	1027	671	1015	835	982	641	523	590	638	595	493	921	591	553	875	750	536	777	711	792	848	572	740	634	725	704	568	366	573	682	533	688	666	540	548	471	568	450	510	237	357	367	363	580	274	526	631	563	401	361	755	571	463	675	315	584	701	615	501	455	269	647	539	610	524	486	464	507	626	637	564	477	462	432	336	428	267	476	630	449	500	464	316	393	333	321	178	379	744	425	289	433	398	367	414	305	386	190	404	337	361	206	298	222	346	325	189	135	180	391	232	254	415	168	370	170	415	316	313	530	346	436	216	243	390	291	636	327	458	541	501	438	183	377	332	222	325	355	424	304	402	754	259	268	290	373	222	336	300	428	213	441	123	309	343	393	326	330	246	420	329	435	275	196	341	404	293	213	173	331	360	130	422	481	524	251	354	284	301	425	514	255	294	333	278	251	484	309	371	257	305	118	365	226	269	360	330	308	790	232	332	246	207	329	144	483	433	163	200	415	274	372	197	408	347	260	308	192	350	447	301	318	269	278	304	238	331	260	249	206	315	332	360	309	388	235	256	225	386	237	148	296	274	149	327	285	213	452	202	87	296	234	357	323	226	282	340	214	411	193	186	259	359	402	515	264	181	284	355	262	267	160	233	279	279	258	288	547	377	354	198	234	338	153	293	183	372	309	131	219	398	253	143	258	230	256	317	151	150	206	318	316	199	365	295	271	353	241	280	271	163	277	165	213	331	228	319	268	267	190	172	256	178	323	196	132	136	174	203	139	235	219	186	204	338	183	165	257	163	199	140	211	258	312	256	215	242	137	286	112	306	252	257	300	227	156	166	197	214	206	198	193	160	134	205	345	195	187	249	466	181	190	235	194	207	216	246	126	199	206	236	197	181	265	263	185	167	271	266	210	269	180	238	169	239	188	167	183	169	198	289	121	108	211	212	247	147	122	316	191	206	220	232	127	172	310	140	157	157	163	134	190	302	150	116	277	179	178	153	115	201	315	163	222	173	379	181	166	148	179	145	210	150	167	166	206	144	212	190	282	140	201	215	128	114	83	222	118	218	188	250	283	170	214	147	125	103	145	98	143	149	213	178	332	235	218	159	372	96	257	172	223	103	100	358	174	293	199	207	229	275	158	184	109	290	191	172	111	93	205	180	220	115	97	168	131	160	144	188	177	179	164	121	140	190	174	175	106	148	164	184	101	217	112	135	110	200	221	116	165	154	85	180	199	121	156	187	176	192	203	116	130	174	140	109	166	124	170	194	193	119	141	188	179	209	100	90	261	204	104	158	105	125	245	320	151	173	159	182	166	116	97	136	92	158	105	108	108	140	150	143	129	65	90	180	132	241	197	114	145	126	122	56	141	125	186	162	179	180	146	238	152	138	116	158	115	157	324	186	222	118	136	99	139	183	148	114	93	110	105	135	87	172	157	118	143	148	81	193	182	180	92	238	286	97	39	234	115	182	114	128	69	169	145	166	176	104	151	167	114	110	99	127	308	88	92	183	232	111	111	124	79	233	135	163	181	122	75	124	152	258	177	130	107	167	122	95	146	148	172	139	166	116	238	151	117	127	147	221	159	47	152	47	132	143	124	111	112	82	82	115	109	70	93	110	174	91	115	94	126	89	110	117	73	59	99	102	131	127	127	74	114	131	154	66	100	65	100	260	156	168	71	100	119	103	214	66	57	82	86	168	106	97	84	180	134	108	124	105	99	109	98	182	136	86	66	107	95	169	203	48	76	77	56	216	151	70	127	173	112	53	94	81	92	108	70	109	43	107	131	77	86	103	128	100	91	106	126	115	42	74	59	88	108	99	109	159	74	100	92	97	172	65	58	137	132	57	97	98	55	116	147	169	108	58	136	138	58	63	69	72	60	114	91	85	116	130	69	98	66	102	76	102	157	98	97	60	96	83	117	139	98	150	98	120	97	62	129	109	99	96	108	113	106	124	114	37	99	78	97	89	86	101	69	115	95	41	72	51	60	63	96	104	81	65	50	77	57	61	103	115	118	151	71	86	84	105	98	157	67	28	40	87	51	63	78	126	53	51	81	47	86	65	52	65	66	117	109	50	47	98	70	83	64	60	98	129	47	54	149	87	19	66	107	71	71	88	68	64	75	123	26	139	79	68	64	101	73	53	87	75	32	123	57	113	62	80	107	108	60	95	63	88	87	71	89	121	46	81	92	66	111	73	87	110	35	96	67	69	74	45	72	75	65	41	112	50	45	58	88	70	82	117	68	51	55	81	46	116	125	67	64	84	31	115	108	168	80	63	132	66	93	78	63	59	71	68	75	44	83	146	65	93	67	23	65	54	98	47	82	70	161	58	45	38	54	56	48	35	80	60	88	39	81	50	52	90	33	112	144	32	106	33	44	23	49	34	59	61	96	57	88	81	74	33	54	47	46	39	34	28	85	64	60	72	81	55	80	69	67	72	61	58	32	105	50	106	38	66	70	59	63	37	48	52	42	96	51	76	72	65	86	45	52	87	32	42	42	101	75	30	82	65	22	59	45	86	64	37	46	36	45	95	30	65	80	58	46	81	44	90	68	95	35	42	50	85	69	43	86	62	52	54	77	66	207	51	89	60	79	56	185	75	121	35	98	69	78	40	73	62	18	95	84	47	95	181	70	61	66	81	32	54	47	76	58	86	49	65	52	63	70	125	34	77	39	61	113	40	92	85	35	33	53	21	45	47	48	74	59	56	26	76	31	47	64	75	46	46	71	36	70	155	57	40	80	80	40	69	37	42	122	50	36	46	54	36	56	218	84	58	40	93	54	62	74	38	46	57	79	35	35	64	47	66	31	31	50	7	65	72	59	65	129	38	78	42	33	90	67	32	28	90	41	30	39	50	39	129	38	65	51	87	37	45	42	49	38	24	23	47	48	84	48	50	53	62	54	51	46	32	73	34	69	41	41	47	31	55	46	93	45	37	91	25	39	63	32	51	60	39	114	40	42	46	54	138	41	34	90	66	371	91	25	56	36	33	45	60	51	22	19	18	24	42	34	32	38	52	35	49	32	32	29	17	16	32	43	33	26	64	36	14	42	110	28	29	48	42	36	120	33	31	21	16	62	38	114	53	65	39	28	49	27	32	66	27	72	30	60	38	14	28	48	31	39	32	44	21	38	58	51	58	25	35	88	59	82	29	91	118	29	28	23	26	35	33	36	35	38	39	34	56	11	54	31	46	27	27	97	20	38	23	41	32	33	30	46	52	21	184	35	13	50	35	27	25	20	40	38	52	33	13	38	42	34	24	50	15	20	23	42	35	35	79	44	18	10	17	50	15	34	36	61	23	29	9	20	30	10	32	64	48	30	53	33	16	31	25	16	90	15	31	32	33	21	26	40	37	33	25	41	48	51	24	35	120	15	20	31	24	23	40	11	17	38	15	31	31	38	9	25	22	34	21	19	60	21	34	30	59	28	23	4	13	18	23	31	31	4	43	42	22	17	22	6	36	29	64	29	20	15	32	55	12	16	30	19	9	20	17	14	29	17	54	14	23	25	19	10	22	31	36	59	30	4	28	24	55	55	38	23	46	28	30	10	31	15	17	15	32	16	9	19	13	26	32	31	15	21	24	9	32	19	38	38	48	27	31	12	9	9	16	21	20	39	91	20	28	12	6	16	28	29	16	19	7	26	11	20	26	13	28	27	12	77	25	15	35	31	8	20	13	25	23	28	108	16	14	22	8	15	11	14	29	20	29	24	21	15	23	23	8	3	17	34	15	12	12	39	18	8	6	14	20	17	11	24	16	14	13	4	19	33	17	14	25	30	14	4	14	14	10	15	58	20	6	17	10	18	21	10	5	16	1	4	16	5	14	10	18	2	12	10	17	7	5	21	3	5	6	4	8	8	25	14	33	2	9	17	15	13	8	12	3	8	8	7	12	9	4	19	10	4	15	3	4	4	12	11	7	19	11	8	18	9	5	12	6	8	2	211	5	14	3	0	7	7	3	0	3	10	6	2	8	10	3	6	10	12	25	3	25	1	8	8	2	4	15	63	4	13	18	10	4	3	14	1	5	7	6	4	5	13	0	3	7	2	10	5	4	0	7	1	5	2	0	3	6	6	0	1	4	0	0	2	0	2	1	1	1	1	0	3	8	0	0	0	1	1	0	0
ne0165	5651	6382	3986	3663	3542	2599	2790	2301	2225	1649	2074	1709	1741	1801	1827	1649	1681	2045	2059	1652	2008	1632	1751	1633	1747	1594	1623	1721	2421	1791	1390	1743	1356	1117	1706	1696	1467	1289	1453	1636	1410	1424	2820	1172	1517	1202	1111	1196	1399	1364	932	1265	1527	1307	1619	1102	1449	1077	1319	1415	943	1156	1092	1496	1243	1217	887	1183	1140	1302	1428	1180	1425	1176	1190	1177	1078	1028	1254	1292	892	1153	676	1249	1032	885	1233	1157	1060	1207	951	939	638	1047	1274	1137	809	938	1057	864	1059	950	1051	830	1005	863	915	688	1414	1086	1034	1056	613	639	560	1133	641	800	945	541	998	770	886	1033	890	1007	852	927	607	691	850	809	899	777	1132	808	2263	963	699	717	925	709	1099	631	994	733	744	931	818	861	847	809	727	991	901	1197	685	936	527	735	714	970	795	826	778	713	813	1078	883	712	942	881	796	616	502	1069	770	512	714	927	1167	571	854	722	1053	772	841	762	780	788	930	635	1411	720	828	644	753	452	993	592	814	914	1081	760	993	533	819	799	668	802	430	813	1598	488	699	912	558	764	631	756	694	931	848	709	980	774	740	830	701	657	809	644	835	882	672	606	591	715	766	654	635	572	686	643	730	620	527	590	962	573	547	614	626	838	526	355	638	772	963	780	628	485	941	609	581	786	691	734	747	643	663	614	509	577	495	461	605	490	698	704	675	621	688	695	475	675	685	797	648	537	573	681	650	840	502	557	596	611	603	582	584	574	709	425	601	593	680	719	689	624	516	633	610	523	667	659	520	628	538	538	510	609	641	561	488	509	451	574	564	649	611	380	471	413	479	534	600	443	307	441	486	491	450	654	350	624	508	607	571	635	506	568	515	439	665	404	739	835	729	631	539	545	404	505	715	521	472	614	509	510	510	492	408	497	419	607	514	554	392	517	547	533	533	314	425	590	421	562	432	454	604	512	469	731	586	381	517	375	646	438	557	433	399	522	375	605	545	485	368	521	399	516	420	374	984	560	484	431	495	515	427	444	412	489	494	412	462	495	549	391	417	372	623	378	278	388	355	595	274	510	346	268	494	447	525	406	250	580	418	475	351	437	409	426	423	464	463	527	416	409	360	770	399	343	555	309	469	263	408	642	347	354	346	356	447	349	494	261	325	693	508	274	440	533	335	514	365	419	299	392	461	576	313	326	361	397	437	442	347	270	416	343	384	402	317	415	415	484	399	331	416	274	374	442	377	393	344	439	404	258	410	409	384	420	482	457	467	408	495	358	547	263	308	414	380	415	635	406	388	457	480	272	417	391	291	1120	398	268	394	256	366	368	389	397	449	457	327	321	462	347	326	246	384	460	362	440	344	392	420	365	372	473	518	311	404	325	376	271	356	270	345	378	328	294	406	353	379	324	408	289	336	353	311	353	220	314	322	250	211	309	381	344	220	494	289	239	353	242	243	261	330	298	331	295	391	336	286	256	237	348	397	240	343	291	378	388	394	316	265	511	314	272	383	310	388	404	266	343	578	369	364	573	341	289	350	211	268	406	347	306	315	385	293	270	232	404	402	252	340	361	224	203	293	234	259	378	272	350	268	343	255	322	347	164	223	309	294	319	367	274	306	335	256	321	479	266	257	232	229	307	322	365	202	265	324	176	261	355	250	196	223	280	252	332	311	311	207	266	201	196	193	355	310	282	238	257	263	227	310	228	213	246	263	307	232	297	189	183	226	205	171	202	241	184	356	190	196	225	238	655	216	360	218	221	215	271	569	205	316	258	313	229	250	761	222	213	196	260	371	172	370	210	312	298	196	140	763	200	416	271	402	273	175	222	208	203	253	142	233	218	168	324	218	335	167	233	501	250	181	261	250	247	352	226	214	267	279	194	243	178	157	227	376	245	241	286	193	276	171	223	278	329	177	252	184	205	200	229	182	274	284	269	337	170	246	179	197	160	300	292	138	250	168	138	231	172	170	270	228	351	241	547	138	207	144	99	214	280	280	147	157	319	171	154	169	262	208	221	227	280	229	252	169	225	239	218	153	259	206	196	208	234	184	164	99	196	323	277	237	246	210	210	275	215	170	178	134	240	345	128	285	165	128	220	218	177	107	138	225	200	116	247	274	99	200	200	181	240	338	189	176	122	168	209	197	123	186	187	200	170	112	160	223	194	193	156	200	110	183	140	235	210	248	241	181	168	212	132	216	193	148	148	126	144	113	232	234	171	147	170	149	112	118	230	294	89	173	151	221	266	136	105	195	170	197	195	178	149	164	200	199	134	162	167	198	175	132	197	163	131	149	166	178	234	102	272	123	130	162	211	183	125	242	134	229	228	160	211	137	119	281	241	104	144	163	198	126	174	206	209	175	143	128	312	133	203	151	149	140	191	133	155	160	203	86	200	190	154	159	118	101	200	145	91	170	219	159	214	84	180	124	172	184	154	128	71	139	206	164	240	202	190	165	147	127	117	155	141	112	181	68	215	125	112	61	72	188	159	224	141	203	146	183	121	204	118	136	98	84	429	147	156	213	77	62	315	204	161	121	122	87	142	237	104	117	87	151	153	101	80	175	96	92	96	144	129	170	139	172	78	139	161	214	105	147	179	58	98	148	159	134	147	218	126	169	124	102	204	162	81	87	141	84	150	116	103	85	74	87	167	150	109	67	150	171	275	198	184	90	112	81	123	178	166	94	91	255	42	258	121	75	117	225	120	112	187	192	111	110	116	156	107	128	150	165	109	138	92	76	147	106	152	86	184	73	82	98	111	101	196	90	134	157	139	162	136	157	88	148	96	136	164	123	69	83	187	195	86	213	161	138	60	93	191	159	162	119	254	72	148	128	51	91	148	75	142	79	87	119	116	156	170	56	51	122	97	99	122	178	79	112	131	120	101	167	179	168	162	240	258	103	155	65	105	48	133	125	137	111	89	129	100	100	101	117	164	151	189	63	116	118	77	51	57	98	87	84	77	119	113	159	87	113	79	82	58	82	130	140	129	114	129	78	121	101	105	88	101	78	131	82	107	48	84	123	33	66	88	106	109	50	107	227	179	89	124	123	105	138	89	90	156	114	120	160	60	43	77	66	63	65	74	95	47	61	79	136	132	103	57	90	71	102	56	78	47	112	118	113	98	115	95	103	105	114	135	317	96	87	69	102	55	93	157	107	115	116	45	73	61	94	87	60	98	42	54	81	92	81	127	76	68	50	94	109	68	146	63	94	39	41	214	101	119	80	69	153	56	51	122	61	113	65	55	98	80	84	95	59	57	105	66	66	77	100	85	79	100	77	108	86	57	73	71	74	72	87	56	58	199	83	78	61	84	102	80	65	68	69	91	62	77	120	73	54	47	65	62	54	55	84	80	126	77	50	47	44	142	41	78	26	68	268	103	68	70	64	46	59	98	89	64	86	97	57	77	62	22	60	40	85	37	48	46	42	53	79	38	28	78	89	69	117	200	41	63	73	38	68	38	57	40	71	60	56	75	30	119	35	120	46	50	54	88	50	51	75	54	70	26	28	51	54	81	33	34	31	44	41	85	74	73	87	78	46	33	50	45	56	164	16	27	56	50	31	83	56	55	65	21	34	20	77	72	10	47	53	32	24	82	44	22	60	95	52	51	43	76	34	53	37	28	52	43	43	38	81	47	28	50	50	83	80	30	81	29	30	27	111	11	61	133	47	33	60	25	52	45	55	50	23	45	110	60	83	28	48	32	64	48	28	32	30	52	39	26	33	34	29	38	23	31	53	17	24	47	60	61	122	103	41	33	99	41	30	45	41	11	39	27	36	36	35	25	13	29	70	16	18	15	7	15	29	50	39	42	50	13	12	20	34	48	29	23	29	21	15	53	13	34	13	76	51	12	10	56	48	13	20	43	20	37	13	31	16	18	39	28	124	36	15	14	24	24	15	36	13	33	22	15	32	17	29	32	17	16	14	33	33	8	14	13	23	18	9	4	24	20	10	74	86	7	11	16	12	13	38	12	39	7	27	24	15	19	28	20	44	35	17	33	10	11	43	16	9	19	6	23	10	14	11	124	7	28	14	17	18	13	5	7	26	23	5	11	14	24	51	52	25	16	1	10	6	15	13	9	9	7	11	21	55	9	31	40	14	6	34	4	9	18	6	11	5	8	2	4	2	3	12	1	7	5	0	3	6	10	22	69	14	0	0	6	4	2	0	1	8	0	2	2	0	2	0	3	3	4	0	0
ne0166	3056	3317	2266	1792	1488	1335	1830	1125	1149	1081	894	970	912	1017	1179	826	998	840	1157	982	1038	982	937	912	789	686	799	969	998	833	732	873	797	691	938	838	913	517	765	896	734	864	873	613	812	726	611	816	761	823	550	767	689	686	826	550	593	563	725	663	535	741	533	800	637	703	479	657	631	556	867	515	688	608	488	465	560	490	701	642	608	636	515	540	451	458	600	608	494	596	614	575	400	630	566	535	426	527	663	507	568	629	743	554	472	547	456	377	617	667	553	483	360	383	350	631	373	430	528	305	530	435	373	620	489	500	493	465	361	387	495	403	401	428	514	409	566	486	389	411	554	401	463	349	363	411	397	390	439	429	535	400	391	536	503	365	355	343	294	568	337	474	491	407	536	346	444	568	375	492	542	421	489	402	251	622	408	317	376	350	454	361	426	344	452	498	494	425	369	342	511	398	474	432	322	470	402	283	466	311	373	371	583	383	432	347	452	425	359	368	260	354	445	304	521	349	302	348	409	362	357	517	396	410	440	316	403	399	344	356	330	384	448	392	313	403	298	375	365	352	274	274	418	243	296	321	257	392	396	308	272	307	388	363	308	218	352	415	442	454	424	298	444	347	187	482	401	273	288	317	370	385	253	246	273	300	357	293	311	310	279	405	289	318	205	476	355	439	225	306	303	408	263	418	253	283	399	309	436	293	285	420	375	279	344	307	231	300	385	243	356	353	251	196	322	285	306	200	288	252	265	303	311	231	114	359	249	291	316	190	331	268	279	243	255	313	252	346	264	271	245	295	308	371	237	305	305	333	240	296	220	318	282	274	305	184	253	318	263	267	307	299	393	230	291	246	257	387	271	311	230	149	254	251	203	305	290	406	206	269	267	272	309	221	204	261	272	257	240	194	295	189	263	424	212	204	266	210	377	222	253	343	195	258	204	234	271	175	179	217	222	222	230	204	298	246	238	214	250	327	258	257	223	291	216	376	250	262	250	141	365	172	273	195	131	234	160	293	153	205	188	124	192	251	295	260	156	281	260	293	193	205	211	224	198	170	299	237	225	223	198	199	236	160	221	187	186	121	199	206	183	225	178	233	189	148	278	173	181	310	178	237	237	226	200	251	256	237	279	159	167	263	123	107	180	183	229	257	175	115	169	181	211	296	258	162	196	195	244	234	163	165	172	170	218	141	211	129	237	119	177	140	172	225	197	210	209	272	245	167	292	123	127	156	176	188	194	185	142	222	204	172	153	193	168	164	167	247	199	168	217	161	220	185	220	176	153	164	144	187	129	175	183	106	109	241	165	203	223	161	185	246	167	163	226	254	265	173	191	140	195	153	156	133	218	191	189	169	200	115	164	201	123	166	158	85	179	125	127	200	208	139	115	185	143	109	108	93	131	140	153	104	170	116	181	139	153	137	112	179	195	102	164	182	194	203	277	210	106	218	146	219	174	208	104	253	85	188	131	109	220	251	151	140	88	116	139	167	171	152	163	210	133	125	145	195	179	226	104	232	142	118	93	117	163	199	159	146	123	182	83	118	152	211	85	163	135	123	186	138	114	110	200	113	139	111	85	112	154	77	123	225	117	104	194	87	138	161	107	92	97	94	167	127	134	174	122	135	138	136	72	123	103	156	128	134	157	88	112	179	115	85	164	123	115	101	135	126	137	75	98	106	138	115	136	91	57	151	122	119	137	102	123	145	139	158	131	83	138	136	104	122	87	204	107	105	90	132	146	93	166	125	183	157	71	50	160	115	121	123	151	166	101	148	110	91	135	70	178	79	71	155	122	120	79	104	160	146	79	122	151	127	139	108	100	157	141	117	85	73	75	94	113	106	143	135	102	169	125	146	96	125	123	135	79	137	105	115	99	106	202	111	154	88	131	150	150	64	97	155	69	129	83	82	108	53	83	123	80	123	117	119	192	123	109	76	134	149	72	89	67	177	61	77	44	81	128	97	110	97	83	128	85	105	123	89	53	125	82	56	101	109	66	103	100	93	136	136	97	148	140	122	102	98	61	84	50	99	174	84	85	45	56	80	101	97	72	78	86	124	44	119	117	70	83	74	86	155	103	155	84	86	68	78	49	77	101	141	106	75	102	63	111	103	107	50	93	49	91	54	55	102	139	128	69	78	86	66	56	49	185	88	70	79	77	79	123	83	56	71	107	39	48	105	126	54	49	41	86	144	47	50	78	91	108	87	79	67	79	63	66	49	61	107	58	68	67	64	55	39	102	98	202	107	36	127	87	75	66	116	129	99	73	119	88	146	93	70	71	80	113	102	41	53	126	48	68	92	58	92	112	89	48	96	63	94	46	62	53	75	70	71	72	43	48	110	149	83	89	89	63	105	72	61	58	96	94	69	47	102	62	76	47	149	64	39	86	150	130	128	100	74	130	96	56	37	96	65	58	72	36	53	86	73	33	55	81	45	124	48	151	66	63	112	67	57	66	64	32	95	42	123	68	58	54	115	149	95	67	45	32	85	72	52	55	59	66	59	43	68	64	46	47	76	40	58	93	58	77	50	87	104	98	38	54	83	27	68	51	69	72	79	82	62	59	77	39	107	101	58	56	69	27	94	69	75	52	36	37	85	43	119	36	65	85	53	104	64	59	67	54	71	69	65	64	54	130	55	86	41	46	34	63	46	32	49	75	83	47	60	51	31	62	62	48	73	98	34	21	54	57	62	67	97	53	55	45	42	56	95	65	66	63	54	92	63	83	59	57	50	41	102	54	38	27	90	76	29	86	45	49	44	42	53	88	66	72	128	42	93	79	24	62	86	37	37	38	67	44	43	53	97	28	35	32	37	65	93	57	33	34	76	71	55	53	102	29	99	55	109	51	34	32	77	16	26	64	59	37	41	35	60	44	60	46	46	86	91	46	61	47	27	31	17	56	82	46	40	36	55	67	11	48	37	20	29	37	37	32	62	78	39	27	49	72	50	32	29	55	57	48	86	29	52	46	26	28	44	65	23	79	48	64	76	46	48	47	49	44	50	26	59	38	93	42	37	15	23	23	30	28	43	48	29	20	37	71	51	45	34	36	62	56	31	54	40	45	53	53	35	51	49	64	29	48	43	53	11	24	38	42	17	54	77	29	52	38	33	25	26	34	41	62	31	54	32	38	42	44	33	48	32	24	29	67	44	58	28	64	24	23	53	55	28	39	39	76	30	35	59	40	53	25	9	38	22	44	36	30	23	37	13	33	23	36	53	44	69	29	43	42	47	25	28	53	73	50	18	44	23	28	48	24	47	15	21	25	35	46	10	25	16	72	39	42	21	39	33	12	25	22	32	43	41	8	12	29	38	39	44	31	28	96	69	22	65	43	31	36	41	53	24	44	36	35	23	34	20	20	17	28	28	21	32	18	13	31	34	14	22	68	40	42	67	23	34	20	30	25	15	26	14	63	27	22	40	18	43	21	53	20	23	15	32	15	17	53	22	14	30	40	33	18	16	27	37	19	16	17	30	17	30	35	30	10	18	26	18	12	16	23	18	29	8	37	33	15	43	15	7	16	12	23	36	7	48	22	37	12	36	12	35	24	43	14	23	42	19	20	12	23	12	18	36	21	11	25	8	19	25	10	17	25	18	33	13	16	10	15	7	22	23	8	11	17	5	30	15	28	18	10	5	38	18	52	35	19	19	16	13	22	16	24	34	19	17	11	42	15	10	6	23	27	7	14	37	45	33	39	24	29	24	12	10	21	14	27	1	26	21	13	15	8	8	7	17	4	15	8	8	21	14	6	26	12	15	11	9	3	8	17	21	16	9	7	6	2	81	9	14	5	23	4	12	6	15	20	2	6	10	6	4	5	7	14	8	14	7	61	20	10	8	11	13	7	18	6	16	14	30	6	14	13	2	8	6	0	8	17	3	2	4	15	3	18	21	6	2	5	24	9	0	4	4	1	10	12	9	6	7	5	5	10	8	5	10	15	19	2	13	5	5	32	3	1	4	29	6	5	1	19	8	9	13	12	12	4	3	7	6	20	7	4	3	7	7	21	8	6	2	6	2	6	6	9	3	0	4	6	2	21	2	4	4	3	1	4	4	3	3	7	2	10	6	5	0	3	2	4	1	5	5	45	1	0	1	7	2	0	1	2	6	3	0	0	1	1	0	6	0	0	0	1	3	2	0	0	0
ne0170	855	991	520	372	288	394	392	329	263	478	243	281	332	361	330	327	328	220	281	291	285	238	250	145	173	247	233	296	166	356	212	168	192	205	258	233	210	126	180	195	200	201	133	135	180	191	187	212	296	250	171	187	113	196	124	253	122	221	181	117	170	148	163	135	170	129	178	139	184	141	170	179	202	164	117	164	146	149	136	149	154	154	130	134	155	145	142	183	137	127	121	171	149	154	108	136	123	98	137	97	138	158	144	171	111	140	86	141	164	91	146	86	151	143	131	155	147	157	85	118	120	155	119	105	105	113	106	58	132	135	154	142	166	106	134	146	89	110	133	85	119	153	82	66	130	125	113	101	104	142	132	100	142	126	109	95	126	90	121	119	86	92	118	110	137	111	142	110	162	83	140	74	136	126	119	128	101	104	76	70	147	123	64	93	69	131	71	115	100	77	93	133	63	122	78	86	90	112	91	109	107	84	84	90	138	89	155	105	155	77	117	83	91	97	203	106	104	134	147	73	122	63	114	93	104	95	95	98	105	79	98	69	57	107	102	114	67	103	101	71	66	99	100	113	54	94	113	105	104	115	52	64	94	112	101	100	64	134	101	58	82	86	74	121	54	103	101	130	68	90	64	76	67	56	60	70	76	93	113	81	96	108	49	140	92	152	104	77	74	90	92	75	73	77	139	94	65	74	87	58	81	91	104	60	65	62	66	101	72	37	96	66	71	67	84	36	62	79	39	93	61	118	52	131	46	69	57	95	83	45	74	90	74	39	69	54	76	124	68	66	56	56	102	88	76	65	58	74	48	84	56	73	77	96	69	77	73	75	64	52	79	100	71	47	104	39	62	71	93	56	65	40	74	57	65	91	45	77	73	53	112	76	62	69	105	47	42	91	49	78	123	62	51	70	38	49	61	66	84	32	72	139	71	75	57	29	51	100	60	68	81	50	44	67	45	39	76	67	52	44	73	37	126	74	85	38	77	56	62	53	32	65	59	57	43	79	54	40	78	46	46	77	73	58	69	45	46	38	75	49	70	26	55	28	65	42	70	53	51	69	60	52	41	71	42	48	49	66	59	56	55	70	63	49	67	48	52	27	41	45	30	71	76	61	38	48	25	37	51	78	83	61	47	33	61	43	39	68	42	68	27	47	50	30	64	40	64	72	74	47	30	75	35	33	40	72	42	29	32	39	30	39	63	78	37	43	33	66	62	52	55	123	53	52	56	53	31	48	38	48	53	44	57	52	30	28	39	68	70	50	66	41	36	30	50	56	53	51	47	30	30	55	49	40	42	44	27	30	22	45	26	27	44	41	38	44	20	18	52	68	53	40	37	28	41	19	22	71	49	51	43	42	44	50	25	32	55	54	67	48	57	31	49	61	27	59	33	33	39	34	82	43	60	44	43	23	22	28	48	47	51	32	40	43	53	55	43	65	33	30	25	41	34	51	15	47	7	34	31	28	52	68	57	41	36	38	42	51	51	47	29	45	43	46	23	44	29	22	63	10	52	30	38	31	49	57	36	41	34	36	12	33	27	18	37	23	50	27	27	58	26	21	30	40	92	24	39	99	30	21	40	46	34	19	36	19	73	44	41	27	27	47	35	29	34	35	45	25	44	48	20	32	51	54	41	47	48	36	30	52	14	38	23	45	35	20	37	48	23	22	56	27	29	33	24	19	18	22	37	22	43	22	28	42	40	40	15	28	19	44	12	29	26	33	35	42	39	40	27	21	26	14	38	45	27	21	17	35	22	51	23	24	46	23	28	36	20	26	27	28	42	23	35	14	30	33	15	37	10	16	29	25	20	24	89	41	23	33	17	22	25	20	25	20	38	52	45	39	29	22	40	16	43	5	11	23	15	22	30	22	21	27	22	18	26	27	36	20	31	27	14	15	19	31	18	36	28	27	31	27	22	20	13	33	16	42	45	22	31	25	28	34	33	41	32	17	31	21	37	69	24	22	32	25	26	13	21	26	19	20	21	29	24	32	25	34	13	24	20	29	35	26	16	32	18	30	27	36	29	15	26	22	18	10	21	15	33	13	29	18	43	27	19	12	25	6	38	25	13	25	17	11	10	17	21	24	22	26	41	13	32	29	16	22	19	30	17	63	32	20	15	24	30	22	20	18	31	39	34	15	15	26	22	14	29	19	29	37	15	20	30	10	19	14	23	19	14	21	16	9	25	27	12	32	15	16	24	22	15	71	21	19	8	17	25	11	14	12	29	41	51	32	32	14	14	20	12	12	21	18	25	15	14	11	14	30	28	26	16	30	15	26	23	38	23	26	9	19	9	8	33	30	7	15	25	17	11	30	15	32	26	26	16	9	15	8	13	22	40	20	20	20	23	21	29	15	11	19	20	13	11	32	14	29	12	35	35	48	31	13	15	30	27	22	12	8	14	17	18	13	13	20	26	25	6	29	36	16	26	15	16	21	21	16	9	17	13	13	27	25	15	23	14	9	14	17	20	23	12	16	20	22	15	17	20	6	13	9	11	17	17	17	31	33	11	12	29	13	8	15	25	8	25	13	14	22	10	7	10	24	14	13	22	8	22	17	10	31	17	25	4	16	16	22	19	20	18	21	8	25	13	18	15	8	21	13	16	14	8	5	18	11	10	23	8	11	18	23	10	14	13	9	18	11	7	19	18	9	27	26	8	18	30	16	9	15	15	11	25	23	11	16	12	26	19	10	22	21	25	11	6	7	18	22	18	8	17	19	15	27	8	18	6	16	10	10	12	12	11	16	22	7	9	8	15	15	13	16	20	12	16	13	11	5	10	9	9	31	16	13	16	21	7	8	9	16	12	1	11	5	9	10	17	15	3	15	6	9	4	11	10	6	9	13	12	10	15	8	16	12	11	19	9	12	66	4	19	8	17	12	18	8	5	11	19	11	11	16	4	10	16	9	6	9	4	11	10	10	12	10	13	12	14	6	10	9	6	25	17	15	15	17	13	10	12	7	8	5	12	7	21	66	15	11	14	14	5	20	7	22	2	15	17	6	7	8	31	12	35	12	7	9	21	6	20	5	3	9	5	6	15	8	13	0	9	8	7	10	11	18	6	20	8	19	11	11	4	7	14	12	17	4	18	9	13	6	2	7	12	6	4	18	4	13	6	21	9	4	13	12	22	21	22	29	15	10	14	6	11	5	12	4	6	2	4	7	8	8	17	14	19	9	11	8	8	15	8	8	11	19	4	9	9	6	11	13	7	14	8	6	10	12	7	1	6	13	16	7	15	3	8	5	5	14	12	6	2	7	22	1	4	5	5	10	18	9	13	7	5	5	18	7	11	10	14	4	6	10	18	9	20	7	8	5	10	6	4	9	4	8	9	8	8	13	21	5	7	14	6	6	3	5	8	11	7	8	5	8	6	9	17	3	1	2	6	14	11	4	17	11	9	8	6	6	4	15	3	8	17	9	9	9	5	11	3	4	2	13	11	13	3	7	7	3	6	8	4	5	21	5	8	6	9	5	42	24	6	11	3	10	5	4	3	3	7	0	9	2	29	11	0	2	4	10	10	10	4	4	17	7	3	3	1	10	7	6	3	16	9	5	0	9	4	5	16	3	7	5	9	3	13	6	6	2	12	5	1	14	2	8	3	7	1	8	4	4	8	4	6	4	4	0	7	8	4	13	10	7	10	7	4	3	4	2	1	3	5	8	4	8	7	1	5	1	5	0	6	11	1	1	7	1	2	2	2	1	11	2	7	3	2	3	3	1	0	0	5	5	3	18	4	0	1	1	2	4	5	5	4	4	1	2	5	3	5	2	3	2	2	3	1	2	1	1	1	4	6	1	2	2	2	7	9	5	7	1	0	2	1	12	1	4	0	2	2	3	0	7	1	2	6	11	8	0	2	3	1	3	0	3	2	4	5	1	2	2	4	7	4	2	1	1	4	1	7	5	0	2	1	1	0	4	1	4	0	0	3	4	1	4	1	2	1	1	1	0	3	1	1	2	4	6	2	0	1	3	0	0	0	2	1	1	2	0	3	0	0	2	1	2	0	2	1	0	0	0	0	1	11	1	1	0	2	1	0	0	0	1	0	0	7	1	0	4	0	0	2	0	0	0	1	1	0	1	1	0	0	0	0	0	0	0	0	1	0	0	1	0	0	1	0	0	0	0	0	0	0	0
ne0172	914	672	442	292	769	193	247	128	307	186	408	160	208	187	209	267	146	223	202	151	185	167	290	157	236	259	297	177	170	194	241	166	162	104	157	216	159	228	222	125	157	131	195	179	94	73	133	99	124	189	64	141	156	102	88	144	198	152	170	139	103	158	249	164	170	104	100	175	140	155	201	236	147	141	221	219	146	130	88	194	97	102	51	93	363	89	97	133	159	89	102	108	47	134	174	160	75	162	115	90	97	110	85	67	125	91	121	70	87	62	86	124	59	50	55	112	47	121	138	38	106	40	146	81	81	137	101	85	45	50	136	114	116	167	85	249	76	108	43	100	101	62	89	95	130	76	139	118	70	91	73	114	57	72	99	143	67	104	29	64	75	106	98	70	61	137	112	104	145	50	75	92	83	52	33	111	85	39	107	94	40	95	72	66	84	117	65	63	122	110	70	56	76	78	131	47	99	31	87	72	124	107	78	115	93	77	80	49	90	76	30	95	70	64	90	121	91	151	80	102	91	55	128	56	64	114	62	82	71	72	109	75	72	119	67	105	146	111	76	99	70	99	96	134	205	65	57	76	60	65	84	101	57	92	77	23	111	67	102	76	60	74	69	36	102	102	27	80	90	80	78	112	43	70	47	94	53	40	71	106	102	68	88	77	63	177	51	68	115	37	76	39	112	41	38	76	55	80	51	76	79	86	179	39	53	91	139	99	38	112	156	128	86	58	80	125	48	195	31	70	86	60	56	105	74	74	54	70	57	111	52	45	35	27	51	49	94	63	47	51	48	48	45	39	41	72	74	59	72	74	69	65	80	47	68	28	36	52	85	55	109	153	41	103	55	57	55	47	34	37	68	107	49	37	94	115	46	18	59	45	18	91	44	41	71	58	51	82	44	89	43	64	34	99	39	55	69	45	89	36	41	39	39	29	32	83	72	81	30	55	54	73	70	41	20	33	110	41	38	42	66	115	24	28	48	45	24	78	111	51	26	63	88	44	73	33	67	58	61	70	39	114	55	47	52	45	93	43	79	24	62	26	84	52	59	70	39	48	34	46	33	39	36	73	94	39	72	42	49	38	25	31	37	56	25	52	40	80	84	40	67	30	86	66	44	78	26	46	20	45	47	48	95	80	80	67	37	56	22	43	48	41	23	20	34	35	51	31	27	33	40	31	65	82	53	85	38	100	43	42	52	62	57	57	38	49	53	28	36	55	29	67	55	65	68	38	59	49	49	35	33	80	77	37	90	35	42	37	44	41	32	38	21	27	47	33	22	43	26	44	47	25	31	38	42	30	74	43	52	83	22	31	83	43	35	25	38	13	34	48	49	24	40	31	30	43	29	37	32	28	30	8	39	84	55	29	40	37	34	22	33	45	43	65	45	64	55	53	68	40	35	28	50	58	42	53	46	44	52	46	97	41	35	39	15	34	32	10	36	23	23	37	43	54	42	43	33	25	65	60	31	46	57	26	86	26	36	32	64	38	55	57	31	50	48	16	26	16	57	28	22	36	50	25	29	25	19	52	25	21	66	78	32	13	25	35	56	28	18	42	53	35	31	49	21	18	21	24	47	62	34	19	46	39	52	44	21	38	35	73	56	23	50	36	20	21	21	36	25	27	53	21	24	70	29	23	16	39	24	46	16	63	40	56	11	35	27	15	38	38	62	34	28	42	27	73	52	24	41	26	12	45	29	23	27	26	30	34	10	36	33	37	32	16	34	42	39	21	77	38	19	15	18	25	55	73	22	19	61	26	56	34	25	16	57	30	33	27	30	60	30	17	20	30	20	95	27	12	28	29	25	11	7	58	22	16	16	10	24	57	36	21	49	33	10	18	33	39	26	19	43	23	14	52	36	7	41	21	30	16	7	25	12	50	16	17	13	55	36	45	38	24	22	47	31	38	22	20	64	25	18	33	7	25	23	32	35	35	24	44	41	30	7	18	43	28	15	18	38	21	44	27	12	19	12	36	16	15	29	67	36	21	53	14	28	36	12	6	48	12	22	19	45	11	10	29	23	40	30	11	13	63	25	23	13	32	3	37	17	16	20	29	17	14	27	20	20	31	42	16	52	24	21	14	35	20	30	17	20	27	13	17	23	16	22	30	23	21	17	49	96	8	20	9	14	25	33	16	25	26	34	25	42	11	18	13	17	16	31	15	11	28	39	12	15	37	54	30	20	47	22	28	17	4	22	29	8	40	47	21	40	11	10	7	18	19	9	14	23	7	12	14	11	8	27	16	14	25	24	15	14	17	45	18	29	23	19	20	23	8	24	28	36	12	8	44	24	26	17	6	7	6	31	25	21	20	35	9	16	28	15	17	13	36	28	12	13	28	15	19	34	17	5	3	16	17	18	14	12	15	20	18	19	15	42	45	21	10	14	8	4	40	6	27	8	40	16	24	19	21	9	22	15	14	4	9	19	27	18	15	18	12	21	19	16	32	18	19	24	11	27	18	32	16	43	9	23	26	13	35	11	19	25	21	9	23	25	26	12	26	11	16	11	5	23	37	28	10	16	11	17	9	14	14	11	34	12	22	29	12	46	3	11	16	16	9	20	20	13	14	16	13	20	10	16	24	15	29	36	5	16	27	41	8	22	8	14	12	29	41	4	16	15	45	28	13	10	5	14	11	12	23	16	20	13	23	15	16	36	24	28	18	19	14	15	30	11	15	19	18	9	9	17	19	10	37	32	16	12	19	5	8	6	13	7	12	6	4	29	12	8	4	38	11	28	25	16	49	18	12	39	11	15	8	10	12	19	19	9	7	5	18	9	21	27	22	73	5	15	21	10	10	21	14	17	27	10	12	24	13	1	4	4	15	20	6	47	6	26	22	12	18	8	11	35	29	9	14	12	17	5	19	8	9	9	20	5	6	8	17	10	10	15	7	11	8	12	7	35	12	23	19	19	25	11	50	6	42	12	12	3	16	16	11	13	13	10	10	15	18	9	13	23	14	8	34	8	27	8	24	9	11	7	32	12	19	6	19	4	8	35	5	15	7	16	6	36	18	38	13	23	22	16	11	8	10	20	31	27	20	10	5	8	5	6	14	13	14	21	23	23	9	15	5	5	21	8	26	26	4	9	11	1	17	11	4	10	18	17	18	8	7	7	12	19	26	6	8	12	27	6	16	17	15	8	10	5	20	6	12	3	0	12	6	17	19	18	10	5	6	17	19	3	11	11	21	19	14	14	6	13	20	9	11	5	19	9	5	4	1	7	5	3	2	2	12	16	5	8	10	13	5	13	7	9	11	10	11	5	13	17	20	14	8	7	21	7	14	5	25	18	12	11	1	4	17	2	31	13	19	4	5	8	5	6	5	4	7	12	7	4	8	2	12	18	5	7	1	6	10	3	22	14	16	15	17	15	9	9	1	8	3	2	4	13	4	12	17	8	24	7	31	2	10	16	4	6	4	9	3	8	7	10	3	14	14	4	3	3	3	19	11	6	5	9	0	24	3	15	14	8	1	6	11	10	7	6	7	4	0	4	6	12	5	2	21	3	8	11	5	8	2	12	5	2	4	5	21	14	7	8	2	2	7	5	12	3	13	5	5	19	0	5	6	5	7	7	7	1	5	3	11	4	9	3	8	3	3	15	1	2	3	13	1	51	1	3	5	4	1	19	9	1	8	5	12	5	7	21	3	1	4	1	2	2	7	10	3	6	8	7	12	4	4	0	4	11	6	4	4	6	1	6	5	2	4	4	2	2	9	2	2	14	12	4	13	14	1	2	2	14	13	6	3	4	2	4	11	20	14	3	15	2	5	4	7	15	0	0	6	9	4	8	2	4	3	2	5	13	5	6	22	1	2	7	1	6	3	16	3	1	3	4	5	8	9	9	4	7	4	4	8	2	9	3	2	3	5	2	1	3	7	1	0	3	4	6	3	1	8	3	2	2	9	3	4	1	1	1	3	0	9	1	3	0	9	4	4	6	6	8	0	1	9	2	5	0	0	1	2	2	4	3	0	1	2	7	4	3	0	1	0	12	2	1	5	0	2	2	0	0	0	3	7	1	3	1	6	0	1	1	0	1	4	4	1	1	0	0	2	5	0	7	1	1	4	1	9	0	0	2	0	0	1	2	3	2	3	0	0	1	0	0	3	1	1	1	1	0	0	1	0	0	0	0	0	0	0
ne0174	986	856	507	644	341	634	767	507	440	515	264	445	402	359	326	309	334	246	332	378	368	374	222	352	238	247	286	250	212	292	163	251	192	261	255	233	243	182	266	211	191	197	317	206	311	275	242	198	184	174	332	210	186	243	420	183	160	233	206	202	243	156	134	209	150	214	260	209	168	127	179	146	183	146	131	157	166	171	192	120	170	156	493	171	117	183	142	148	112	164	213	180	461	148	122	132	182	120	202	196	195	191	196	189	173	125	201	203	191	255	144	167	216	239	191	107	224	145	206	206	156	200	128	124	148	212	117	152	209	173	126	156	138	113	164	70	129	112	163	132	126	144	143	122	62	127	104	89	139	97	110	96	132	109	110	134	124	107	166	195	113	114	100	156	146	109	104	169	97	210	132	90	119	142	169	116	145	167	97	97	154	116	96	184	100	147	105	83	147	89	115	92	88	97	114	193	118	163	118	166	73	88	78	111	105	167	78	100	116	121	158	159	114	130	83	165	76	74	63	114	77	125	69	128	127	135	143	95	106	85	93	119	99	49	135	88	82	99	118	92	118	129	76	122	79	80	138	94	83	92	88	97	120	90	79	147	65	90	98	89	124	138	88	81	52	140	104	130	86	67	118	91	134	82	119	56	98	96	102	76	34	82	87	49	93	46	74	67	42	102	101	97	67	106	94	46	178	94	70	89	275	87	52	84	96	74	141	133	84	86	86	87	82	84	42	81	94	122	124	115	80	77	91	109	86	148	73	68	105	82	79	98	70	137	102	88	91	114	106	92	102	108	82	75	74	62	89	67	56	43	80	67	88	87	65	121	52	50	52	72	53	60	135	58	74	53	111	52	80	92	40	42	62	94	61	79	98	87	78	80	123	41	76	74	84	77	68	81	80	62	108	71	104	115	78	47	57	42	51	90	81	99	77	57	90	54	86	40	118	80	60	59	72	88	60	99	54	67	75	96	45	20	91	74	75	99	65	85	48	47	123	79	40	70	57	81	44	44	59	50	91	51	48	51	74	57	52	72	62	66	45	77	48	73	60	48	76	40	86	63	75	167	37	44	50	82	55	60	38	43	47	57	63	58	78	38	74	48	39	32	64	48	45	46	95	32	78	92	126	59	75	60	49	33	40	41	58	51	56	68	56	72	105	112	121	62	26	41	54	92	52	70	44	60	46	51	68	81	66	60	46	38	45	46	61	52	79	73	50	65	56	46	74	60	41	49	62	58	52	57	58	55	43	33	31	125	39	70	59	68	32	60	64	45	68	41	53	35	42	47	50	51	54	33	53	54	39	85	21	59	74	60	40	48	42	130	62	66	47	50	62	43	33	38	66	66	40	47	51	51	34	64	52	42	33	34	54	35	86	44	52	37	31	55	34	63	40	50	20	19	81	53	42	35	60	32	22	44	36	48	42	44	34	25	69	48	44	27	42	39	53	42	37	57	41	42	30	26	69	61	40	24	67	37	34	28	36	55	38	48	33	36	36	44	35	38	39	98	46	36	39	45	36	38	51	53	35	27	60	36	15	11	41	94	51	50	28	38	57	28	39	55	22	21	78	26	51	67	39	30	43	46	38	34	22	39	39	42	28	49	42	59	38	54	55	39	59	52	64	26	16	54	23	20	33	50	69	25	37	30	53	23	41	29	65	27	36	46	28	22	15	19	45	24	38	18	7	43	44	26	29	47	49	32	57	40	34	28	22	12	41	28	19	32	25	39	39	36	34	26	24	72	57	37	28	42	36	46	19	39	15	34	53	23	32	25	47	24	26	37	53	41	49	48	50	25	45	62	25	39	241	33	62	40	62	31	42	49	27	27	40	31	25	37	61	27	47	66	38	30	22	51	48	18	28	37	20	34	78	24	26	21	43	29	36	22	52	13	18	22	17	21	36	53	21	24	34	32	10	22	44	30	85	23	49	21	27	25	31	13	27	23	45	33	7	21	19	15	23	60	53	20	39	27	34	26	10	24	11	19	26	31	48	50	28	17	45	21	23	35	25	24	33	35	47	40	58	24	9	31	17	16	37	33	28	34	37	19	26	38	21	27	39	24	25	18	75	38	11	20	8	26	37	32	23	34	11	48	34	15	26	32	34	43	14	13	20	34	43	13	16	28	35	25	29	14	22	39	29	23	27	44	34	40	22	16	39	21	13	31	25	16	4	40	20	25	14	18	31	14	31	16	21	30	21	23	20	17	12	82	21	16	25	17	21	17	20	27	37	42	32	16	49	22	15	18	19	14	18	25	20	42	7	10	6	15	19	16	16	23	15	31	13	17	17	29	11	7	11	34	24	19	38	12	29	11	10	19	19	26	24	23	25	19	12	28	30	57	27	18	17	11	28	23	20	25	30	8	16	22	18	34	31	33	16	9	30	24	22	16	121	27	25	23	18	13	14	22	16	19	24	23	14	28	67	16	12	12	22	18	12	15	26	23	12	19	27	33	9	19	16	13	27	24	4	25	14	30	31	13	16	20	14	23	34	17	0	12	19	8	16	30	25	24	14	22	26	11	22	37	8	16	7	20	24	17	9	31	18	18	6	14	23	37	11	17	30	20	12	24	22	15	20	11	14	14	24	3	12	35	11	11	9	19	12	14	12	18	10	11	18	13	5	8	18	22	19	33	17	37	20	10	9	7	12	25	7	14	22	10	4	23	2	18	8	22	22	17	7	11	21	11	25	9	27	15	10	15	18	7	41	5	27	12	18	21	19	24	11	36	56	8	11	20	5	17	18	5	5	10	7	17	31	12	31	14	10	12	20	5	18	9	21	10	7	13	10	10	8	21	8	6	6	16	19	16	26	21	4	9	12	7	18	7	17	8	22	10	23	3	15	25	29	14	15	20	9	19	13	7	15	6	9	15	55	11	12	5	17	21	12	15	18	2	26	6	13	13	13	8	11	4	10	19	10	9	10	12	14	11	19	7	7	8	10	8	27	14	13	10	11	21	8	12	7	11	6	11	12	13	5	60	5	8	12	8	2	10	15	14	10	13	13	8	2	10	11	10	6	12	15	9	7	5	7	11	12	9	9	38	7	9	14	15	18	6	7	6	7	12	11	11	6	4	4	12	6	4	9	11	21	10	7	3	15	17	19	6	7	18	25	13	10	3	7	9	17	13	5	15	6	2	15	4	10	5	25	6	22	13	12	17	21	8	11	1	2	13	4	10	14	14	16	4	24	8	3	13	4	25	7	13	4	16	8	15	6	8	12	15	14	14	10	11	15	1	1	9	5	5	6	12	7	10	7	5	16	5	4	8	8	9	12	9	19	12	11	3	7	2	9	6	5	10	2	9	24	22	1	9	2	9	9	5	12	12	10	12	6	6	13	8	13	5	14	10	8	7	2	5	6	6	7	4	16	6	12	5	9	8	8	2	5	4	12	6	2	6	2	15	3	1	8	5	16	5	7	3	9	9	9	11	4	3	2	3	26	24	11	16	3	2	6	4	11	3	8	6	16	5	3	8	6	7	2	5	3	7	3	14	15	11	7	3	209	2	6	14	4	16	8	20	5	4	1	6	18	1	3	4	1	4	6	4	5	2	16	4	6	3	5	8	0	6	2	6	3	9	4	5	7	1	3	1	4	2	4	12	6	14	1	0	6	10	3	6	22	6	2	3	2	11	2	1	8	5	7	3	3	1	7	6	3	2	14	0	2	13	5	1	5	2	7	11	1	17	0	5	8	3	4	7	1	6	4	9	3	0	8	5	3	3	8	7	4	2	4	0	8	16	5	1	1	3	7	2	1	9	0	13	3	1	5	1	3	4	1	21	2	0	0	3	2	3	1	3	1	2	1	0	2	8	9	6	1	6	3	3	1	2	13	5	6	2	2	3	2	3	0	2	0	9	2	4	3	1	3	1	2	4	2	0	2	7	4	4	3	9	1	5	0	3	5	1	2	0	1	2	8	2	1	0	3	0	1	1	4	3	1	2	4	2	1	2	1	0	3	1	1	1	1	1	3	2	1	1	2	0	0	2	2	1	0	1	1	1	3	7	1	0	1	0	2	0	0	0	1	0	0	2	3	3	0	2	0	1	0	0	0	1	3	1	6	1	0	0	1	0	0	1	0	1	0	2	0	0	19	0	0	0	1	0	0	0	0	0	0	0	0	1	0	0	0	0	0	0	0	0
ne0175	2755	2950	1849	1859	1092	1797	1384	1489	1257	1702	1035	1279	1248	1057	1056	1013	1131	914	972	1070	1048	1101	1061	870	827	778	751	902	854	953	520	710	708	828	910	684	744	573	840	742	725	599	735	689	798	847	819	673	668	635	859	628	560	770	568	656	624	683	490	601	732	570	411	556	435	615	851	696	690	518	651	427	613	666	478	476	592	514	481	608	596	485	705	590	369	606	515	579	500	401	579	489	712	555	454	429	637	398	564	678	505	514	660	650	544	458	524	561	517	482	487	396	599	735	594	487	596	477	420	642	469	641	361	398	387	676	448	577	583	533	546	443	412	300	471	320	475	415	569	419	458	519	418	381	353	404	390	431	373	434	463	323	380	398	414	385	364	301	511	606	335	438	337	412	513	348	376	482	293	456	361	385	429	446	533	483	494	501	296	361	554	431	338	504	341	377	336	362	383	320	413	395	453	352	316	393	377	488	376	404	270	374	418	356	362	458	430	370	422	322	484	409	470	349	418	418	290	340	315	347	303	335	288	320	470	470	343	363	412	390	298	275	320	304	405	331	302	319	394	265	439	540	328	414	281	336	368	279	378	317	279	301	375	283	268	441	369	277	365	290	253	360	277	295	216	323	311	358	341	323	378	328	400	286	333	230	358	317	278	279	209	282	285	256	288	280	387	283	207	332	337	271	266	426	429	266	411	319	270	316	267	344	206	249	243	491	363	319	279	282	290	335	286	311	217	277	231	385	347	344	196	211	269	319	322	375	269	285	369	236	244	297	252	339	396	220	269	404	235	363	300	229	286	435	237	251	177	300	168	213	273	279	290	253	264	330	234	221	216	217	220	261	248	248	272	196	340	250	284	191	189	138	286	250	216	357	298	297	264	228	360	170	262	257	331	371	205	267	196	198	344	390	278	284	215	191	232	220	241	237	205	282	240	238	283	230	237	166	213	287	241	236	277	247	292	291	206	234	200	272	187	120	268	236	312	298	241	237	139	215	247	217	120	216	199	242	170	197	259	212	227	148	153	209	274	177	197	227	209	279	137	233	158	186	205	184	284	174	157	177	242	181	164	251	224	241	201	203	161	167	425	216	197	119	267	187	252	204	134	171	278	185	112	176	227	203	197	291	185	232	192	203	152	183	172	177	207	203	145	172	153	172	328	184	194	192	171	176	209	262	232	178	194	135	161	195	204	227	205	186	152	199	194	221	205	158	179	272	169	264	230	257	224	147	230	188	154	201	149	194	163	180	177	173	142	228	155	218	183	268	163	189	203	143	141	160	209	135	143	190	170	163	154	130	183	189	136	200	157	134	180	184	111	173	185	211	225	203	190	168	203	123	106	144	185	144	142	214	178	186	146	192	171	127	130	186	190	180	170	116	136	114	106	237	115	165	120	140	136	215	197	113	151	100	146	175	145	134	104	144	171	126	114	153	227	170	156	100	132	192	159	112	136	164	117	149	145	140	112	127	162	143	175	119	92	137	109	188	144	148	86	151	157	126	106	175	130	138	171	120	159	146	133	124	142	176	154	160	161	131	40	73	155	146	145	162	105	165	194	142	98	149	122	96	202	181	181	144	147	87	122	174	103	141	115	116	144	135	104	109	104	139	109	221	144	195	134	212	143	143	75	224	110	67	132	140	149	72	136	102	94	111	136	111	173	134	129	178	97	118	110	77	131	79	138	71	66	132	115	80	115	111	124	136	198	129	114	130	107	86	211	93	81	122	129	106	112	177	112	93	89	219	106	152	96	58	121	123	74	119	75	165	127	99	67	96	191	110	113	76	126	155	110	158	149	94	85	134	87	135	117	140	271	77	174	132	176	100	128	73	125	99	116	108	122	121	119	168	91	66	79	220	123	52	74	107	49	112	190	98	87	82	216	124	94	96	105	64	72	92	56	104	87	190	76	94	120	134	71	51	113	61	121	123	111	136	146	124	77	80	80	101	131	99	68	91	137	67	94	123	77	86	98	83	95	94	79	138	95	72	77	94	137	111	119	64	88	127	52	102	121	101	103	151	177	61	98	144	97	72	83	61	74	83	130	104	112	104	96	98	80	84	107	79	78	52	193	116	44	132	40	111	146	106	62	114	55	316	92	86	85	85	177	145	77	87	86	179	98	84	84	96	65	103	95	100	82	99	80	79	58	132	86	92	70	61	90	109	64	80	93	71	54	79	120	49	60	94	95	86	85	75	108	138	51	50	95	77	85	126	58	69	116	86	88	75	49	76	122	113	71	93	92	78	58	59	96	42	48	102	100	94	35	42	82	64	79	57	51	100	80	90	40	53	72	68	109	56	60	84	109	85	54	36	140	70	78	80	95	75	97	81	76	107	42	82	159	135	118	63	70	50	64	76	67	82	82	60	74	55	63	80	142	64	32	51	132	136	74	58	81	105	56	66	48	63	64	64	44	59	71	81	81	101	187	41	67	41	84	68	77	64	79	49	66	54	71	54	59	82	64	52	66	54	30	73	168	106	92	87	53	80	54	60	83	70	52	49	43	43	60	65	69	56	44	43	108	46	59	76	39	108	54	80	76	58	62	98	32	78	32	61	76	110	54	84	67	89	69	79	69	87	41	61	63	26	117	32	61	57	58	28	32	67	58	78	62	54	46	43	54	64	45	30	58	87	37	105	78	114	31	29	44	32	43	67	55	61	51	28	43	84	32	33	41	55	77	42	36	21	120	48	50	64	49	36	41	39	68	54	60	117	60	76	56	57	46	64	57	97	138	37	46	50	36	42	45	35	39	35	29	59	44	44	49	51	43	52	112	29	54	32	65	33	54	38	61	30	34	50	47	68	23	61	43	45	74	45	30	40	45	42	42	51	51	53	43	56	35	42	55	71	66	46	20	45	55	48	57	35	32	39	40	63	103	123	51	50	61	54	46	46	55	49	50	51	48	34	23	30	63	35	40	48	58	61	32	37	23	51	76	80	45	59	56	28	57	45	46	46	37	37	34	61	24	16	37	42	55	58	58	96	28	31	54	54	62	31	34	54	43	42	45	43	26	38	30	30	36	28	36	14	37	23	39	35	73	18	31	38	74	23	36	28	48	29	53	34	23	20	25	37	50	22	26	35	53	16	70	39	38	28	43	28	80	46	45	17	52	64	79	56	86	31	47	37	57	48	16	34	35	29	32	37	41	36	26	33	34	56	45	54	18	42	51	22	30	31	21	42	42	35	34	24	63	36	22	39	20	61	33	52	39	23	31	39	20	32	71	46	33	39	64	41	57	76	8	63	21	78	18	19	23	37	27	44	39	19	40	53	37	15	37	34	37	38	28	16	119	21	15	22	17	27	13	32	34	40	16	20	16	22	77	52	18	44	27	39	13	26	42	17	22	49	35	25	24	22	14	53	22	11	27	12	21	23	14	45	35	24	47	31	37	37	36	43	18	16	26	13	21	24	28	25	11	12	27	27	32	16	24	32	29	46	22	31	27	27	18	28	27	17	28	18	25	25	22	20	27	13	58	48	14	22	19	33	15	7	20	38	39	23	31	22	23	15	11	35	24	26	26	12	46	30	5	22	30	14	29	10	23	33	15	17	14	9	16	17	21	6	15	38	16	12	66	14	19	20	27	26	12	11	18	13	35	27	22	12	9	23	19	25	14	37	30	12	35	21	12	16	8	25	26	22	29	13	43	11	3	11	28	19	16	18	15	14	14	44	20	15	15	5	24	16	20	20	16	23	13	25	15	18	16	19	14	18	17	6	59	7	20	11	14	7	18	13	7	6	16	24	4	4	15	20	27	9	5	29	16	7	10	6	19	13	9	9	7	58	24	16	20	10	9	10	8	20	14	11	18	9	6	26	13	4	8	13	8	7	6	14	17	5	2	3	11	11	10	26	31	7	3	231	9	12	11	16	6	14	7	16	7	8	14	12	15	4	4	36	10	33	4	7	6	3	6	7	5	14	7	6	12	6	9	9	14	4	31	17	6	5	9	5	12	5	1	5	17	7	12	6	7	6	1	10	7	28	6	2	9	3	8	5	7	10	10	6	8	1	5	11	4	3	3	1	2	1	2	1	5	5	8	24	6	5	1	4	2	0	4	7	13	1	8	3	12	1	3	3	2	51	0	4	14	8	2	2	5	0	0	0	1	5	0	0	1	3	1	0	4	1	11	0	0	4	0	0	0	0
ne0176	2657	2591	1752	1586	990	1666	1616	1397	987	1476	840	1191	1159	1022	1288	901	962	685	952	992	706	938	803	778	710	590	755	751	728	958	578	648	623	695	731	674	723	493	737	765	639	587	493	514	705	867	766	692	581	531	802	512	514	582	573	579	503	582	510	461	630	509	269	529	420	603	752	541	495	412	806	335	541	454	348	331	525	430	442	414	520	385	843	445	313	542	417	480	383	432	492	529	812	353	408	411	549	381	438	375	436	468	393	587	453	406	415	504	476	479	443	431	543	682	531	386	586	448	335	561	300	569	341	361	384	525	369	358	558	472	375	379	327	446	391	310	337	391	484	303	320	403	415	323	324	400	311	487	332	343	372	285	369	338	341	335	387	244	447	453	295	339	315	421	433	331	402	438	262	395	403	295	392	517	471	400	307	441	242	322	357	382	262	411	255	237	255	337	320	251	355	350	357	302	306	343	329	424	306	326	254	233	280	339	440	455	341	290	384	299	434	333	347	302	354	409	222	257	327	228	215	276	189	320	499	367	366	360	287	324	244	322	235	257	370	349	251	269	311	246	302	338	318	347	191	269	340	268	299	288	249	276	326	265	265	392	280	294	343	192	222	316	307	267	181	334	285	262	271	327	333	312	391	233	287	210	327	339	231	214	173	333	222	408	167	309	424	259	209	244	202	292	206	308	294	249	378	221	233	253	401	355	166	231	266	240	283	297	208	236	204	359	193	183	236	181	224	287	243	338	216	186	228	250	239	317	255	240	300	223	218	284	241	276	326	232	210	308	225	229	269	257	275	220	197	219	201	318	131	163	224	229	202	206	286	315	313	142	214	171	168	271	277	182	271	219	305	198	268	228	172	131	248	242	181	304	190	381	260	224	176	148	199	200	314	247	171	180	226	180	159	259	185	263	155	171	204	205	273	184	159	373	205	204	251	182	177	179	221	176	234	226	219	221	233	203	138	194	199	222	170	214	160	235	209	319	222	198	157	178	179	177	118	165	131	212	175	153	182	164	248	162	120	163	210	212	171	152	168	220	141	138	157	191	152	137	230	130	130	162	211	174	153	204	215	163	161	123	139	139	122	157	171	233	243	162	201	117	133	190	134	143	127	130	200	122	140	232	170	187	106	185	137	121	123	182	141	164	108	156	91	135	258	201	175	163	126	120	166	185	168	173	148	77	156	178	169	164	178	140	146	141	126	173	210	166	152	208	143	293	162	222	211	153	146	109	90	159	152	131	147	117	143	154	95	132	135	218	172	206	160	167	171	106	138	140	190	162	165	165	172	151	147	116	110	165	167	175	107	141	117	105	107	174	154	135	116	131	144	133	141	94	106	116	154	132	129	161	228	155	109	176	139	120	127	138	136	158	131	126	119	97	111	149	131	136	104	145	91	132	111	129	107	111	115	123	163	134	111	112	167	101	113	222	183	146	151	88	120	126	161	132	108	160	81	103	73	110	129	102	143	128	189	90	101	110	146	176	103	178	98	103	108	118	126	132	101	128	192	98	155	118	111	105	106	136	107	136	143	84	71	48	140	143	109	85	91	78	135	122	122	117	102	98	107	106	122	112	101	69	137	130	118	99	114	107	141	110	96	83	138	123	113	196	139	155	107	85	123	182	65	133	113	64	86	143	200	57	75	123	124	94	69	74	136	85	105	177	104	77	87	70	126	110	122	58	48	107	126	48	152	64	48	121	123	153	50	84	89	95	74	96	50	97	77	96	112	111	145	65	91	174	64	100	82	70	92	120	79	117	59	69	113	95	48	86	158	123	94	78	126	131	71	111	111	57	93	171	48	88	255	124	197	58	92	108	127	104	81	72	91	88	121	66	157	85	125	145	86	77	91	92	110	78	86	100	42	84	124	82	145	63	68	70	98	93	93	38	51	137	107	55	78	133	85	81	83	109	79	78	72	65	90	74	109	69	172	114	77	52	89	57	174	78	48	76	87	55	60	50	84	58	112	73	78	43	61	82	57	59	66	79	96	117	124	73	108	81	61	76	107	106	69	134	158	46	78	68	91	92	51	72	52	70	78	75	121	46	53	89	61	81	75	60	68	33	146	95	26	89	55	53	80	78	61	118	29	129	80	75	76	86	83	146	63	61	68	121	78	49	65	63	60	83	79	120	71	107	81	65	51	132	70	61	84	59	75	99	58	101	49	68	53	62	67	83	80	73	66	86	74	46	67	91	67	41	73	73	57	57	40	77	83	78	66	56	63	75	93	110	70	56	157	62	55	105	58	50	50	77	78	92	28	51	42	36	75	68	64	76	65	73	40	47	65	56	47	41	63	69	79	116	23	45	114	57	44	72	44	68	81	65	70	99	39	54	87	82	107	64	49	37	65	83	51	45	63	65	63	44	66	58	91	28	60	64	129	100	82	69	99	103	78	64	47	63	48	69	59	54	60	55	52	96	183	62	56	33	77	55	42	67	74	84	40	58	62	38	35	67	37	45	40	42	32	77	81	72	95	94	65	57	26	36	58	35	101	33	44	68	52	66	72	52	41	53	109	32	53	53	27	80	42	51	53	54	33	78	51	79	22	50	56	96	60	59	92	86	30	73	56	57	27	51	47	36	115	40	40	48	46	81	39	75	42	78	59	58	42	33	38	46	34	29	56	83	52	89	72	56	36	51	60	26	21	50	57	104	50	16	33	49	69	29	39	34	68	53	25	20	37	58	58	67	54	54	27	49	43	53	78	62	62	71	36	49	41	66	34	74	111	41	55	50	29	52	50	28	44	28	26	42	35	75	43	39	45	60	50	41	70	29	62	42	26	44	26	32	27	32	27	74	27	38	27	41	81	38	15	23	55	29	57	36	43	44	46	51	36	59	37	71	61	67	38	37	45	48	30	29	33	28	36	58	52	86	43	28	28	33	44	42	31	35	54	36	36	23	31	46	36	31	26	35	32	63	29	29	41	43	51	45	31	36	47	78	36	51	31	57	48	54	28	57	30	34	20	23	37	40	127	29	117	14	39	33	25	62	29	48	33	57	47	19	15	48	36	17	53	50	39	21	30	26	28	26	61	24	20	32	39	28	39	40	58	18	40	28	48	32	40	60	40	23	14	21	54	17	35	40	38	33	25	41	73	63	30	22	37	18	89	38	41	15	23	18	52	33	8	33	38	19	45	22	28	22	29	25	40	49	34	47	26	18	53	18	50	28	25	31	42	37	39	21	57	39	14	20	27	51	19	49	35	35	30	45	26	27	57	32	29	44	39	21	27	26	61	43	25	26	12	26	31	19	16	18	33	23	26	17	13	13	19	14	30	30	39	16	32	13	91	21	10	42	22	21	34	41	8	12	32	15	40	37	12	39	18	21	12	25	25	19	30	22	43	24	21	17	22	25	22	19	24	11	22	12	11	34	13	31	43	15	20	23	31	40	17	28	26	11	33	12	23	35	39	16	23	9	23	29	19	22	17	26	9	18	26	20	17	41	18	6	37	23	27	17	25	21	47	22	24	51	15	9	19	24	12	14	15	28	34	19	13	18	212	7	20	25	17	24	4	22	25	16	19	43	17	4	42	12	2	29	18	16	7	19	17	11	14	8	13	20	31	16	4	16	7	14	23	17	11	5	18	6	39	14	12	14	8	16	18	5	10	46	20	23	34	21	16	5	6	13	24	11	35	4	42	10	15	9	24	12	16	39	19	10	10	38	7	8	13	7	15	23	18	24	12	22	6	28	13	13	26	19	16	13	11	2	23	25	13	18	23	13	6	13	9	7	9	11	6	6	4	8	23	24	10	40	3	14	9	9	19	4	13	8	4	12	17	2	6	6	4	13	3	25	13	5	9	4	10	12	22	6	3	15	28	5	1	13	13	4	8	3	2	2	4	19	25	10	3	18	12	9	7	14	10	5	15	7	5	4	11	23	11	3	1	11	13	26	0	5	2	2	4	0	11	8	3	8	3	4	10	10	3	8	10	9	6	6	1	4	7	3	5	15	9	8	9	4	23	7	4	16	7	4	10	1	36	5	1	1	9	1	5	3	8	9	18	3	3	2	6	2	0	5	6	3	12	4	4	8	4	8	2	3	3	2	5	2	6	2	2	1	5	3	1	2	2	7	0	5	4	1	0	7	0	17	0	0	0	0	0	0	0	1	0	0	0	0	2	0	0	2	0	0	0	0
ne0177	3030	2554	1281	1254	629	1651	1277	1297	780	1278	496	1243	1276	1400	761	1133	1787	362	1135	1203	732	633	880	461	527	470	363	1176	835	657	301	999	727	877	656	675	566	247	413	708	510	457	441	340	586	705	787	948	1323	540	841	337	306	645	537	911	186	357	621	303	794	408	304	505	316	657	787	251	439	339	427	301	562	504	286	180	480	337	517	331	439	536	632	388	210	615	412	245	469	484	492	695	661	484	308	401	603	208	346	242	309	451	301	727	292	440	276	680	644	514	509	475	785	718	583	709	693	501	251	656	556	622	184	666	497	235	400	142	691	606	159	757	158	304	468	223	245	206	572	210	417	655	330	200	302	424	259	171	384	710	294	272	602	603	254	222	812	290	656	303	172	266	196	196	641	160	395	387	127	213	368	180	396	259	533	308	166	575	172	193	127	278	152	481	154	151	191	514	223	224	518	513	258	170	174	231	270	672	363	232	313	111	150	269	137	311	300	284	583	433	546	168	327	588	787	272	108	151	535	118	97	118	203	623	199	181	289	152	243	212	162	394	168	234	226	163	184	118	228	189	270	128	318	473	325	423	229	219	193	450	103	100	433	212	336	513	203	408	308	174	274	152	191	444	134	433	374	117	130	227	236	208	218	148	191	150	240	252	278	193	167	265	127	115	107	196	286	255	180	457	148	216	81	337	513	213	209	324	464	215	124	237	197	253	424	117	177	105	437	135	130	168	108	292	269	294	334	178	102	269	137	200	123	98	181	242	317	194	261	85	157	413	351	106	114	352	139	174	192	87	300	349	208	384	416	283	381	150	82	105	97	112	118	292	200	288	138	172	118	96	155	252	224	123	248	106	181	235	365	328	131	105	229	121	111	182	351	306	121	138	298	196	176	306	173	178	86	186	166	97	105	236	169	216	63	168	179	141	173	72	160	97	416	153	399	112	107	469	161	211	78	129	217	209	168	314	166	221	191	221	284	74	183	169	246	62	180	203	120	136	157	130	125	187	85	275	86	187	197	111	227	75	170	155	276	109	136	295	158	145	93	44	135	113	59	80	242	165	150	343	155	221	67	192	139	179	136	75	138	144	86	168	147	184	237	135	251	98	86	134	107	72	206	74	183	125	153	182	112	159	40	113	76	63	80	80	157	187	92	223	66	93	238	89	138	73	54	205	184	242	136	134	128	80	105	83	104	119	85	41	102	83	84	533	138	142	105	365	101	138	278	275	225	82	180	68	57	214	56	100	163	79	69	138	87	124	157	101	130	259	133	99	144	60	66	68	212	57	208	90	98	95	228	71	71	150	81	120	51	61	28	296	40	61	115	129	107	40	126	143	83	114	118	49	146	73	125	114	95	250	91	201	108	56	83	101	123	61	214	92	229	89	78	97	67	72	90	39	25	98	43	99	105	83	52	41	74	108	109	108	133	60	135	90	149	96	71	130	68	165	113	113	62	81	76	72	55	212	112	45	136	348	42	137	72	45	79	234	68	44	57	72	106	98	77	132	97	85	67	33	289	86	74	52	57	154	142	116	70	128	32	32	107	103	71	112	40	69	67	109	41	79	81	49	91	54	183	66	45	50	53	210	90	80	53	46	237	56	174	27	68	251	79	63	127	106	76	96	125	95	96	92	66	117	47	52	277	54	328	108	96	66	128	24	43	52	141	86	65	49	131	63	86	87	69	32	61	62	61	36	66	73	87	187	284	77	45	31	138	64	34	70	53	84	24	58	83	112	82	63	57	63	47	57	24	41	91	256	92	85	25	77	136	55	53	89	107	50	138	38	60	80	59	79	41	88	56	208	48	55	120	137	113	29	86	169	135	87	79	79	71	84	66	244	169	112	60	92	89	105	76	70	159	54	11	45	45	140	33	89	40	94	38	59	63	91	82	113	72	112	31	35	45	181	51	59	60	119	48	37	86	80	76	28	51	32	62	115	34	26	52	120	148	57	45	31	85	49	29	24	27	55	115	47	78	39	27	79	41	59	47	34	72	114	46	70	97	62	38	89	178	249	88	52	94	34	62	23	57	27	98	51	25	27	47	52	258	81	111	66	98	109	52	74	43	21	80	89	51	34	104	51	63	50	49	49	33	30	102	19	78	94	65	105	58	16	54	79	70	15	38	55	83	36	43	81	18	134	51	54	18	154	57	35	39	69	66	78	17	136	48	55	18	87	47	44	187	68	49	31	62	46	51	110	28	59	49	18	29	14	51	110	23	50	47	21	47	110	72	146	68	66	97	20	15	65	42	21	61	54	104	62	22	25	19	66	24	57	25	118	29	63	21	52	61	29	31	35	28	32	76	45	17	29	88	42	16	28	50	59	137	43	52	14	20	87	54	24	109	30	49	29	59	109	57	60	65	54	85	38	31	52	35	120	18	29	156	31	110	54	23	112	63	44	15	17	46	40	28	26	101	51	27	30	34	101	72	20	65	34	42	24	63	10	33	57	34	17	70	33	41	87	49	19	19	41	109	70	39	44	56	134	25	53	58	27	19	34	14	52	69	53	117	36	14	10	149	36	28	46	42	76	22	44	54	63	38	24	7	55	56	38	38	54	59	113	36	66	37	72	52	16	52	93	25	26	36	24	32	48	23	9	45	30	16	244	47	50	19	9	84	13	41	41	14	49	45	158	92	99	19	32	22	19	31	42	50	8	63	34	27	30	22	67	21	12	19	34	30	115	37	19	39	94	40	25	25	21	76	33	73	33	18	24	23	41	33	70	43	68	29	12	25	23	8	25	60	10	36	67	14	40	15	77	23	38	28	29	7	59	27	21	94	29	41	18	7	65	16	53	10	56	58	12	22	22	21	10	28	45	17	13	70	21	21	16	14	48	30	35	35	15	31	61	14	28	12	26	10	31	73	19	35	29	12	23	32	32	9	68	20	20	22	13	48	60	13	9	15	24	9	5	21	24	17	17	36	16	39	14	81	133	25	30	26	20	14	25	5	23	36	39	13	46	11	10	58	21	101	9	36	11	21	12	18	14	7	19	20	30	7	45	26	28	12	29	9	39	58	35	26	22	57	40	15	12	12	11	11	14	56	67	55	11	11	18	30	12	41	36	4	25	15	15	21	7	24	33	12	40	88	16	41	16	30	23	39	23	11	8	28	11	35	14	32	30	27	36	17	21	43	10	18	58	23	23	22	32	18	30	47	75	26	16	15	24	17	50	54	62	58	55	29	4	28	10	36	20	46	36	22	18	25	12	52	14	25	11	7	30	35	30	29	10	12	32	8	35	30	186	7	19	14	49	10	15	46	15	97	24	18	14	23	15	69	16	27	22	13	5	4	21	10	75	10	10	34	53	22	14	11	33	51	13	22	49	11	33	11	20	13	30	50	14	12	11	9	58	3	21	11	6	37	5	2	5	5	23	8	16	22	12	5	28	15	55	11	14	15	10	17	2	26	5	7	34	23	48	18	25	15	18	10	16	28	10	5	20	14	28	16	12	16	12	5	32	3	8	9	8	13	40	15	5	8	29	15	26	11	27	50	39	21	8	42	11	9	16	227	41	12	4	13	37	4	25	15	5	9	17	11	51	7	47	3	28	4	40	5	5	32	83	17	7	14	22	7	12	40	3	30	14	11	11	22	2	8	26	8	29	3	4	11	29	2	0	11	10	29	11	3	7	19	12	57	16	21	20	4	7	8	35	8	2	5	14	6	67	11	3	2	6	5	7	2	3	12	15	6	6	7	6	14	8	22	25	4	2	10	9	11	4	0	5	9	5	11	12	17	74	4	11	7	9	6	2	9	14	11	8	5	3	8	5	5	4	4	35	10	13	3	9	9	0	14	4	38	11	7	12	1	6	4	11	10	8	2	5	17	14	15	25	3	1	5	2	3	21	4	4	3	5	6	1	2	8	4	24	6	3	11	1	39	4	8	1	13	2	9	14	0	2	4	3	5	3	1	9	5	8	2	11	15	27	0	0	30	7	5	4	9	2	9	5	0	4	39	2	3	7	9	3	6	0	16	3	1	0	3	16	12	0	13	2	8	15	6	9	2	16	3	3	1	0	4	0	1	10	2	2	7	11	3	2	1	2	1	11	4	0	5	4	16	2	1	2	1	0	4	2	0	1	15	1	1	1	5	5	0	1	5	0	2	7	0	0	0	0	0	2	0	0	0	0	0	0	0	0
ne0180	1200	1714	878	782	704	579	540	516	539	471	572	477	583	393	565	494	590	425	662	449	334	459	540	369	382	392	442	513	628	609	338	511	316	301	682	339	373	378	360	357	369	290	418	309	339	258	213	342	741	285	189	219	353	500	288	440	307	251	326	306	265	242	293	247	207	361	229	289	306	310	358	392	376	204	304	225	173	286	260	284	266	308	151	244	241	160	289	172	342	261	302	342	174	176	258	318	182	282	261	202	245	224	267	217	272	159	261	192	321	235	307	237	154	153	157	515	123	314	277	107	195	135	218	320	259	190	205	148	109	126	161	231	202	259	230	281	296	194	131	186	107	306	265	174	314	243	211	269	255	264	178	148	210	299	156	236	309	138	118	228	230	261	131	174	284	162	144	218	213	167	320	180	174	204	93	235	218	105	176	156	188	187	209	172	196	179	200	296	207	205	192	167	285	138	200	176	209	107	152	170	159	161	198	212	253	174	160	152	279	199	100	200	278	139	406	245	140	199	218	177	155	172	163	150	258	203	153	178	213	143	198	156	172	182	213	234	150	140	115	139	191	203	180	298	93	142	161	120	175	244	103	170	215	142	122	70	134	211	228	166	156	127	140	132	170	188	134	160	155	232	115	177	155	133	121	134	120	206	266	163	146	162	160	248	108	223	279	172	195	189	158	128	121	143	289	155	135	85	153	115	166	150	159	146	210	167	152	217	79	177	116	162	124	212	172	80	143	221	94	139	143	163	94	166	158	170	129	171	117	101	171	166	88	109	122	138	139	209	147	90	132	123	148	219	200	200	140	92	148	92	95	117	114	141	141	104	118	139	129	129	132	192	137	96	141	115	123	131	129	121	146	102	151	113	96	194	105	81	124	110	312	95	104	141	254	127	103	166	74	125	167	207	132	208	81	70	128	117	185	80	185	71	128	140	164	106	126	191	96	126	83	85	130	123	117	63	99	122	93	159	183	157	123	135	158	37	122	143	139	121	86	87	91	145	104	119	116	133	151	95	71	116	129	91	138	73	105	62	161	102	108	92	113	59	83	89	133	109	94	123	101	137	183	151	111	80	92	63	100	121	304	87	95	112	213	85	144	71	190	153	85	94	98	110	66	137	130	112	80	196	82	68	128	125	90	56	114	102	89	84	60	102	108	99	75	99	90	120	95	89	112	142	109	105	83	148	82	119	122	101	87	62	66	190	89	78	115	140	150	57	100	138	95	105	151	112	107	152	105	129	94	119	103	79	82	123	156	71	98	129	96	136	106	93	87	145	115	141	115	71	114	118	137	72	91	92	74	67	71	85	39	42	60	65	38	70	78	47	86	119	79	57	84	55	89	81	181	65	85	94	69	67	62	86	72	152	82	60	104	59	95	109	86	90	55	102	94	57	52	199	82	74	62	105	70	57	101	59	75	56	128	64	69	118	135	101	92	88	88	72	76	53	76	121	87	77	68	109	101	90	82	159	94	79	80	64	86	165	91	54	56	59	62	54	40	97	87	45	118	69	84	96	74	59	84	97	69	77	70	73	58	51	94	42	69	57	54	71	70	99	80	81	109	56	44	76	68	52	14	49	66	75	95	76	102	66	116	60	127	60	93	95	142	126	58	72	59	109	81	78	78	100	107	55	60	73	66	73	113	113	50	88	76	40	57	85	78	91	38	90	167	64	81	73	84	56	47	67	65	69	62	88	49	94	86	48	59	47	97	40	41	44	62	106	49	57	94	92	111	64	69	67	46	61	44	59	91	111	45	74	61	49	77	70	62	59	66	51	70	67	84	58	78	72	60	61	86	48	58	82	78	47	79	49	38	83	59	101	70	78	63	28	54	107	28	46	57	59	29	78	51	41	56	22	41	38	23	63	63	50	17	69	40	46	62	75	31	94	52	69	43	60	35	96	46	64	59	59	71	37	74	68	25	33	90	31	58	56	43	81	51	61	52	53	33	48	103	59	37	33	57	51	43	54	107	23	51	38	26	55	135	64	85	49	36	43	65	34	56	65	71	47	55	49	46	58	56	35	44	24	64	39	53	43	64	42	73	18	43	49	69	50	78	29	76	36	90	50	18	46	52	45	56	50	55	61	40	68	62	60	53	63	35	50	63	48	61	68	48	57	71	56	66	57	95	107	54	93	66	82	42	77	54	53	61	39	64	95	31	45	39	39	50	30	22	90	53	79	90	36	49	122	46	42	50	36	51	44	20	21	53	55	73	61	39	47	38	59	57	93	70	53	73	55	39	48	48	39	43	64	58	48	49	44	43	47	39	55	36	59	65	67	61	44	36	51	55	51	27	37	33	41	35	79	34	43	29	46	46	32	46	42	52	52	25	43	21	43	59	50	39	36	55	39	68	45	42	23	52	45	53	41	52	103	38	52	57	51	59	68	27	60	69	50	30	16	49	33	33	56	31	36	39	27	22	47	49	22	49	29	44	51	56	38	19	41	33	36	43	44	44	57	36	35	122	35	32	52	36	23	60	56	36	39	41	48	31	32	38	44	62	51	81	40	21	36	63	34	51	24	42	51	50	45	25	38	43	35	24	40	63	27	37	33	41	18	47	56	30	36	40	20	24	55	19	59	36	32	39	41	74	29	23	29	37	84	45	23	47	22	38	11	29	40	25	52	42	44	43	25	27	24	52	28	17	34	25	12	47	39	28	44	36	39	43	29	42	39	49	25	32	38	24	77	29	33	75	47	54	28	30	39	25	18	42	41	27	31	45	72	23	49	38	40	32	29	46	28	57	57	37	31	44	27	42	27	64	61	17	41	45	18	36	27	41	11	17	20	32	32	55	22	32	30	42	20	38	34	29	241	30	22	23	44	42	34	40	22	22	36	33	25	29	57	40	39	9	11	30	74	44	37	30	32	12	24	20	31	18	38	23	26	27	29	41	70	21	32	18	41	9	37	23	39	41	42	25	20	39	19	29	101	41	58	30	23	29	26	24	33	28	35	27	24	33	21	23	42	87	21	28	4	40	13	11	37	20	48	28	40	27	25	30	21	25	33	18	28	27	29	44	30	36	35	20	21	24	22	25	20	83	66	41	19	14	12	22	7	42	18	21	23	21	18	18	9	44	18	15	14	19	28	38	35	42	30	19	31	16	17	29	18	21	27	27	13	26	20	27	24	15	22	39	18	7	24	21	15	17	32	73	26	21	21	11	12	36	22	13	31	51	33	30	45	26	17	22	20	39	41	24	22	24	31	17	31	35	28	27	28	24	33	18	31	18	12	42	30	16	23	10	16	30	22	22	32	19	31	69	28	7	14	10	20	26	41	24	19	33	25	9	15	15	26	16	21	15	33	14	24	23	14	10	39	26	36	9	19	100	41	17	14	25	9	21	27	19	37	103	32	23	27	22	18	7	22	36	24	7	26	27	16	23	33	24	23	33	7	22	15	18	10	25	13	10	6	12	19	15	19	14	21	6	22	19	21	14	24	26	39	12	18	26	18	27	18	8	17	24	21	9	30	5	7	15	21	12	25	19	27	23	10	6	16	11	18	16	13	59	14	8	16	11	9	13	24	22	7	14	28	8	28	16	18	24	23	13	25	19	15	3	27	13	9	29	11	10	18	16	3	23	29	20	9	14	5	12	8	8	6	12	19	15	13	6	19	16	11	8	13	10	29	9	25	21	38	19	14	20	2	9	19	21	16	15	13	10	20	21	7	8	6	13	13	9	9	12	23	4	16	6	19	19	13	15	17	17	8	19	10	6	15	2	11	2	6	11	11	9	26	8	97	9	7	4	6	13	2	14	13	10	6	4	18	9	7	9	57	9	3	8	12	8	4	7	23	5	6	11	4	20	26	8	8	7	10	8	9	6	14	8	4	3	20	13	7	5	35	2	8	10	18	12	6	7	10	4	5	7	14	20	6	16	9	6	2	9	5	4	17	4	5	13	1	7	6	9	4	14	3	6	3	7	8	5	3	14	6	1	11	3	7	10	2	4	6	6	4	14	3	14	3	3	0	6	3	3	5	4	1	4	4	2	3	5	3	2	6	3	27	6	1	4	4	6	5	6	4	5	5	11	7	7	2	6	4	3	1	6	3	2	1	2	1	0	1	5	1	4	1	0	5	3	1	2	3	3	6	0	2	0	0	0	1	0	3	3	0	1	0	0	0	0	2	1	1	0	0
ne0181	1868	1697	643	565	358	719	616	574	478	509	393	463	658	536	402	406	617	241	545	371	291	633	341	343	397	361	369	487	763	466	188	613	296	271	539	299	260	248	342	298	411	238	816	389	485	269	281	408	556	271	234	215	166	299	457	341	144	142	408	164	269	270	189	205	197	420	267	236	352	168	192	188	387	190	302	104	217	228	337	268	211	369	203	261	98	212	308	131	235	324	271	211	223	232	178	239	222	255	328	202	290	316	193	238	261	158	243	246	326	570	398	311	211	227	166	291	192	230	201	173	161	214	123	377	277	149	331	150	178	185	79	286	139	115	231	170	666	138	200	189	122	268	381	153	198	266	170	162	341	304	207	157	283	250	246	285	296	156	172	116	208	227	110	190	265	107	254	161	103	108	378	131	178	159	142	175	117	148	140	134	154	105	144	137	118	119	116	305	158	232	182	215	488	100	194	202	246	165	225	230	184	136	304	169	120	160	223	177	300	345	159	287	597	199	229	182	76	79	153	135	61	169	117	290	204	227	120	128	210	103	116	243	181	180	236	106	92	72	97	119	270	65	178	180	85	118	184	125	323	176	75	102	208	101	112	121	146	155	316	161	161	104	132	179	105	186	216	113	108	225	130	131	195	110	142	138	142	267	267	132	91	100	88	98	65	80	178	215	123	314	68	91	42	223	203	95	101	86	172	165	105	50	119	179	239	76	156	157	139	87	52	53	48	100	115	79	186	157	110	96	106	107	160	51	177	93	145	148	145	76	221	129	147	67	118	213	283	78	128	62	183	197	76	149	115	150	163	102	39	93	119	92	78	221	96	180	79	184	87	80	96	151	67	69	109	101	134	133	128	205	112	49	129	158	104	92	106	74	122	141	124	80	110	129	162	112	68	88	172	127	74	97	204	138	53	106	155	87	106	76	126	43	125	116	252	86	102	69	109	140	75	96	152	133	141	88	81	92	85	282	91	51	168	126	163	61	144	116	114	151	42	54	96	105	59	217	86	140	142	130	90	44	85	125	144	83	97	84	142	126	109	63	87	103	86	50	107	105	97	108	114	196	61	92	51	85	78	19	142	102	74	101	117	66	98	90	121	35	55	402	43	54	98	63	142	134	119	193	40	168	48	72	76	92	43	74	136	129	57	73	36	95	141	125	39	111	59	103	102	145	121	69	144	81	76	69	94	143	67	72	66	53	48	117	80	94	114	144	143	82	138	131	159	83	65	38	78	98	36	125	101	51	47	102	66	343	49	23	35	141	98	173	149	83	72	128	155	30	406	70	81	47	213	71	147	133	62	106	44	93	25	66	32	42	58	32	162	60	90	62	42	69	43	63	93	40	60	71	57	79	118	60	53	37	63	68	126	41	95	70	101	62	38	57	52	70	58	10	26	41	26	54	25	58	82	28	70	97	140	48	66	20	51	64	99	88	85	127	81	106	94	40	85	71	85	53	24	115	76	65	122	221	70	114	42	36	30	122	36	54	29	59	72	83	43	86	143	62	171	88	131	127	40	62	60	120	50	72	47	101	25	30	111	52	56	69	31	104	110	55	42	159	58	36	50	175	91	36	37	34	91	89	88	50	53	53	78	25	138	16	85	106	63	42	126	88	63	65	80	49	42	88	53	63	31	64	49	29	73	60	89	50	153	14	30	37	105	51	46	30	98	55	46	17	58	31	51	93	63	86	51	77	36	59	128	40	96	48	86	42	19	46	66	272	35	60	88	50	57	44	76	61	69	45	29	18	309	88	31	44	38	71	56	61	17	36	133	6	146	58	51	75	45	76	45	36	134	43	56	46	54	44	116	21	22	91	123	65	75	40	74	44	32	78	37	99	46	36	44	62	24	16	78	22	5	39	37	66	23	25	29	66	20	64	92	33	53	61	35	34	18	33	44	18	56	58	44	72	36	26	70	207	26	30	28	5	51	27	61	22	34	103	64	34	33	30	104	36	16	14	28	49	43	21	146	19	28	40	21	24	69	75	26	65	11	31	72	71	19	96	38	77	38	30	61	21	84	11	55	44	48	52	18	30	54	59	74	41	68	71	22	54	47	49	27	21	78	77	37	40	28	52	69	34	36	34	18	48	57	30	33	86	80	70	31	16	77	32	44	30	52	107	67	18	32	34	43	44	52	89	21	87	36	43	15	118	43	25	12	30	36	23	18	50	25	38	10	26	37	22	77	26	66	58	9	26	75	44	8	7	37	57	53	41	51	21	35	52	44	79	33	46	40	97	19	46	36	21	26	21	55	56	17	21	13	26	28	44	17	32	29	69	10	14	25	44	83	31	21	48	90	39	20	21	30	43	16	52	9	77	49	62	86	24	23	70	58	11	48	32	32	27	37	23	74	31	70	11	36	34	37	68	70	65	11	23	75	25	68	88	72	19	49	31	16	8	63	35	18	26	40	78	15	25	16	47	43	10	128	65	21	27	57	12	10	21	57	9	40	187	22	42	40	23	9	51	32	48	36	27	17	65	27	26	77	15	17	28	17	8	39	39	27	24	7	24	37	14	21	34	24	48	18	45	57	27	26	35	8	32	18	27	74	39	25	57	36	39	31	16	40	18	18	84	32	13	30	12	35	66	38	11	17	64	24	85	79	33	23	22	66	6	13	12	10	45	46	80	69	64	12	12	23	17	19	16	15	14	25	37	21	20	21	63	11	14	18	49	7	17	72	39	24	31	35	18	15	19	25	25	79	26	23	24	19	33	29	73	17	82	30	24	10	10	21	13	62	12	28	32	15	14	14	24	18	21	28	37	1	50	30	3	32	25	9	9	12	35	8	58	20	24	7	8	39	10	43	18	20	21	13	23	41	22	45	19	18	17	32	30	64	26	87	29	9	19	14	32	4	14	42	23	20	36	3	39	21	55	7	29	18	15	28	17	30	45	12	23	8	19	10	21	28	23	34	15	48	13	35	21	24	33	17	11	27	24	31	15	5	30	17	16	11	36	20	5	44	16	49	18	8	5	22	30	13	11	8	7	30	12	15	32	29	67	23	24	23	7	34	9	19	15	25	10	16	12	5	16	19	7	29	24	29	19	12	3	30	8	33	6	6	14	13	3	24	12	123	21	22	16	72	12	50	19	16	41	19	16	2	5	45	54	30	14	26	9	15	37	25	21	16	13	14	36	9	27	14	15	11	36	50	57	28	23	4	8	17	49	11	36	30	23	22	15	32	18	18	9	19	51	11	12	10	18	24	24	26	14	9	75	29	27	28	88	12	4	9	25	8	34	7	11	16	14	21	11	22	4	21	52	9	5	23	10	16	15	22	14	7	10	4	13	10	65	12	10	23	34	2	14	4	38	145	23	14	45	50	8	5	14	9	14	21	11	32	7	11	11	7	19	52	10	6	4	2	13	13	29	2	27	16	5	12	79	20	40	10	1	10	2	2	12	20	3	10	14	5	156	10	37	8	14	18	38	12	8	20	15	22	13	2	10	42	24	9	20	1	32	14	11	20	20	7	12	6	6	7	23	22	27	51	3	7	4	17	5	8	6	76	25	6	6	17	9	2	14	29	1	2	11	10	22	25	18	5	13	5	16	6	8	9	58	5	3	7	8	6	11	29	7	21	29	10	3	12	8	5	10	4	17	5	21	11	16	7	2	21	7	13	12	2	14	12	15	10	3	9	5	4	2	11	6	16	3	10	5	2	22	8	3	6	5	3	7	5	2	9	8	7	13	3	5	14	3	12	7	4	6	12	1	13	5	1	1	12	2	5	10	4	18	4	9	9	1	4	11	9	4	4	4	17	2	10	6	6	5	3	127	17	12	10	134	1	3	9	13	14	3	6	2	3	14	16	2	2	10	3	7	16	10	10	7	2	6	10	2	1	12	17	5	3	6	11	5	2	5	6	30	2	3	8	2	18	15	2	2	4	2	1	6	0	0	11	1	2	10	1	2	111	0	1	2	5	3	1	1	1	11	7	4	0	1	10	0	0	5	13	3	2	1	2	3	2	0	3	0	0	2	1	4	7	0	2	0	8	3	2	2	0	11	2	0	3	1	1	0	9	4	4	1	47	10	3	1	2	1	16	3	3	0	4	11	0	0	11	2	2	0	1	4	2	1	6	0	0	0	1	1	0	0	3	0	1	0	0	3	0	1	1	1	10	0	0	1	1	0	0	0
ne0183	4724	4492	2664	2754	1782	2307	2202	1701	1600	2798	1395	1662	1664	1714	1652	1479	1661	1061	1648	1438	1486	1596	1228	1395	1040	1218	1306	1465	1493	1376	781	1172	1007	1085	1323	1199	1218	801	1232	1176	1237	1047	989	910	1119	1076	945	1277	1323	1074	1067	778	756	1066	1324	1189	654	678	1014	769	935	906	648	679	699	1042	1027	1190	1145	693	777	749	1082	772	857	778	699	729	795	759	922	766	743	880	640	711	745	690	716	705	977	926	767	734	594	763	764	667	961	898	804	919	770	814	731	595	811	702	684	1104	923	722	847	835	684	688	673	872	600	666	710	776	511	704	646	839	725	524	657	614	513	904	677	618	654	540	512	540	620	551	489	750	666	512	524	798	621	423	572	666	623	531	707	610	503	509	723	590	577	620	488	532	552	590	745	678	518	532	452	865	834	470	573	683	500	605	566	528	356	420	852	753	503	485	458	538	549	601	532	513	563	708	618	469	453	593	595	583	496	573	592	338	450	569	368	715	702	526	794	522	485	667	529	757	646	551	473	642	487	414	452	462	689	616	611	563	511	589	637	505	568	514	402	539	722	593	455	371	472	414	602	466	518	593	230	482	529	458	544	597	407	443	576	431	670	446	504	445	559	345	472	486	372	516	278	606	625	502	395	414	479	481	542	363	396	335	393	525	502	471	673	395	404	310	481	351	541	427	408	561	447	573	567	564	433	431	512	374	499	363	392	324	729	548	462	334	379	513	442	335	293	359	389	415	412	264	393	330	534	542	420	476	357	476	314	469	482	400	545	330	444	546	544	784	414	397	410	586	478	367	574	422	632	591	434	644	403	328	264	382	383	648	632	593	296	486	305	316	340	210	409	363	404	280	315	394	472	481	411	399	339	275	456	357	352	351	382	368	310	348	494	446	353	427	482	499	216	353	282	318	551	289	330	343	373	335	372	374	291	332	342	515	411	392	558	295	299	233	303	364	265	312	306	409	299	240	369	410	312	445	584	242	585	478	340	421	404	502	292	354	450	255	303	412	285	566	257	294	277	251	312	283	330	352	428	302	286	228	326	467	287	390	266	243	302	241	308	313	235	386	398	304	284	352	253	277	295	376	226	240	202	439	266	300	394	240	454	249	210	233	408	277	338	226	407	479	299	369	385	311	356	258	229	427	250	232	307	358	239	374	190	294	391	219	416	226	163	300	390	475	260	352	239	242	244	253	288	178	265	263	208	193	309	310	262	213	341	422	219	324	393	243	380	229	242	189	184	346	199	248	294	288	297	285	197	185	220	198	253	357	295	232	336	188	301	218	341	177	264	218	239	301	322	196	288	378	193	332	234	232	270	210	191	176	202	236	287	360	262	221	303	169	267	252	302	238	231	246	247	310	227	270	263	207	255	185	331	260	375	213	266	183	194	219	204	208	205	183	154	190	374	199	230	199	265	115	267	282	267	255	249	185	231	198	346	205	253	354	230	151	216	192	170	249	144	236	132	184	164	199	351	148	209	301	179	197	173	353	216	151	163	160	167	168	179	195	213	253	203	139	250	245	180	180	190	379	265	226	215	188	90	116	156	213	219	247	128	157	278	199	164	148	233	170	301	227	255	313	224	116	153	320	245	178	118	175	264	173	294	354	229	267	183	237	235	237	263	226	210	265	179	257	127	233	177	168	244	162	193	204	210	288	237	186	107	118	191	249	163	130	183	184	195	200	204	164	127	222	172	141	157	149	214	224	328	163	184	175	188	166	263	143	134	178	110	183	269	207	123	136	144	357	213	191	168	113	210	290	112	221	129	154	321	155	152	132	274	209	239	143	240	175	244	182	159	271	169	200	134	181	177	183	265	90	305	187	197	203	194	165	208	154	111	161	186	204	160	230	114	255	103	304	171	95	146	300	105	212	166	111	256	140	262	152	198	210	136	391	133	139	142	97	126	176	132	143	141	142	84	150	116	134	178	119	177	111	146	110	81	365	141	151	155	199	105	119	171	115	135	258	118	120	120	157	170	91	112	109	106	144	123	111	117	210	172	137	181	113	69	211	145	188	158	132	140	129	195	141	129	106	149	130	110	136	177	189	210	170	138	242	131	170	133	145	126	81	258	188	89	208	124	158	138	135	137	216	81	192	143	86	225	155	207	128	204	69	128	166	147	337	94	152	127	143	197	74	81	204	132	134	87	214	98	126	116	121	158	152	101	138	130	133	65	132	82	138	55	256	63	96	179	135	104	155	94	103	143	130	107	270	130	181	66	102	109	86	135	176	151	158	185	192	120	118	89	154	162	76	102	120	143	141	49	93	49	132	121	138	106	115	105	135	72	148	124	120	140	100	76	91	198	154	103	76	138	130	57	127	132	119	104	153	110	72	72	141	172	100	144	128	121	92	138	115	117	117	121	47	76	93	126	82	79	126	49	82	186	96	177	171	65	163	221	164	70	81	230	105	127	81	75	84	128	137	126	159	133	71	146	80	158	93	113	139	84	110	115	84	79	115	110	98	219	101	50	116	45	206	121	68	103	136	56	88	152	78	32	60	59	142	96	102	140	107	72	102	174	97	57	123	89	103	75	105	138	88	63	103	79	107	315	60	115	116	66	113	105	139	71	237	137	127	90	152	84	88	130	61	77	83	66	79	52	97	110	85	80	78	55	72	141	64	47	41	64	115	65	217	90	122	109	73	47	51	56	66	28	117	93	90	57	98	67	81	78	60	123	91	62	45	148	74	93	91	93	75	45	156	87	59	179	51	100	85	135	87	131	231	37	178	133	91	63	97	74	63	92	54	53	91	35	104	53	170	70	69	76	52	96	115	108	42	179	66	55	61	43	92	74	91	75	69	84	95	60	45	84	54	65	61	72	52	96	77	79	80	46	77	51	52	91	72	96	151	34	62	93	84	35	74	79	66	47	102	222	63	61	115	107	135	78	94	63	52	88	82	65	44	41	51	85	41	65	49	64	33	99	54	95	79	117	99	57	107	48	81	66	47	47	55	77	90	74	92	46	41	85	61	142	52	70	223	49	41	84	54	60	28	52	58	63	120	56	78	60	74	49	59	56	43	45	69	73	45	56	45	39	46	38	42	39	84	85	47	91	47	52	55	46	33	35	118	74	64	70	27	30	42	35	65	73	37	58	31	65	45	73	54	36	50	101	44	63	30	65	44	100	81	43	78	38	58	67	62	49	53	59	52	64	65	66	56	51	33	46	26	39	111	61	82	92	45	38	22	88	46	43	61	56	57	33	50	54	58	71	73	80	43	46	35	72	82	39	31	72	50	32	74	65	22	35	63	77	39	33	30	55	56	38	42	37	23	23	41	62	65	48	44	101	40	31	42	19	111	26	55	75	42	32	47	32	68	64	93	48	97	48	45	33	37	24	42	58	83	53	39	16	82	19	21	65	41	31	39	18	20	36	26	67	47	35	29	36	8	58	63	24	40	23	23	51	24	46	28	19	62	31	23	39	36	35	55	25	42	39	26	44	50	36	70	32	47	45	36	38	43	32	62	51	34	19	56	20	13	29	18	17	47	35	45	119	29	40	45	68	17	25	17	31	31	30	28	45	44	34	68	35	33	19	25	30	73	35	27	14	25	22	23	41	33	24	50	41	43	12	19	21	29	31	31	55	26	16	33	40	7	33	53	23	28	25	19	14	33	14	48	38	20	31	47	23	16	22	14	58	22	29	24	12	28	52	42	48	64	34	8	28	81	13	11	13	30	14	46	29	47	12	33	17	43	11	11	16	21	21	55	19	12	38	14	38	29	10	18	27	25	14	18	25	60	18	12	38	9	14	7	32	12	27	16	11	13	15	16	17	6	23	22	34	11	8	11	13	10	18	18	29	14	10	11	2	14	31	21	20	26	14	12	26	32	38	19	11	22	15	16	10	12	7	8	10	19	23	9	12	12	12	30	19	14	28	8	15	15	51	6	5	17	28	3	5	11	6	1	8	29	20	16	13	7	5	14	11	21	7	2	11	23	12	3	11	11	15	7	13	6	26	5	3	7	15	6	11	14	13	15	3	5	2	26	6	8	8	11	6	4	3	5	20	2	3	7	5	4	4	10	3	4	1	9	11	19	27	9	3	5	15	9	4	5	17	3	3	15	8	1	8	33	6	12	1	9	5	7	4	1	0	1	0	1	0	1	2	2	0	0	0	1	6	5	0	1	0	1	1	0	0	0
ne0188	2107	2740	1515	1299	1370	1377	1104	1170	956	1503	1071	1094	915	849	663	1029	861	837	978	860	752	891	762	699	646	672	697	775	842	700	580	591	641	733	620	657	580	569	678	548	612	606	609	525	511	619	715	549	620	542	657	519	508	541	566	557	619	538	512	504	619	529	490	398	492	488	652	531	526	504	584	469	533	383	525	526	481	524	452	540	474	525	597	398	388	518	398	418	459	402	415	393	553	354	590	490	492	344	481	420	341	446	484	532	413	388	367	510	361	393	417	512	520	519	467	391	466	368	464	549	423	500	385	395	394	436	449	405	431	473	342	381	334	332	451	367	334	395	482	410	271	354	353	412	296	332	401	319	355	343	348	338	323	277	361	355	417	394	429	431	330	346	328	300	408	384	327	247	353	343	340	368	348	302	432	322	331	432	347	334	446	272	315	315	316	423	280	331	376	319	299	301	263	329	263	365	304	416	227	234	315	338	267	404	287	316	370	299	310	279	394	275	264	323	339	264	310	283	278	306	252	264	308	287	302	303	330	235	329	297	296	270	317	298	374	203	264	308	280	241	412	313	258	273	216	247	229	278	328	326	296	275	325	305	313	357	195	291	296	310	299	207	214	281	201	199	239	290	314	217	250	206	292	237	268	183	196	229	238	380	274	267	360	178	190	153	206	255	219	277	303	280	301	340	241	279	268	177	230	239	288	236	211	283	236	284	213	238	189	270	245	299	300	228	208	164	238	193	243	180	227	186	170	218	260	210	241	272	240	246	220	262	237	272	260	211	271	239	231	200	253	233	193	259	194	238	218	172	233	226	211	271	239	265	219	218	286	199	210	249	170	193	268	227	240	262	220	281	264	230	192	176	228	199	183	159	139	127	216	159	181	203	238	211	173	213	206	177	169	175	285	188	184	144	209	178	236	222	187	184	254	134	184	210	252	191	182	214	163	213	209	256	216	182	163	158	164	181	173	243	183	172	208	160	138	117	164	171	153	230	204	194	230	208	235	229	124	145	121	163	147	219	166	203	288	174	172	108	136	249	156	152	210	175	172	271	186	202	168	125	160	195	159	229	207	247	193	181	142	116	208	188	160	181	183	171	152	142	152	144	190	150	162	157	211	154	169	159	182	144	180	132	151	126	136	140	160	174	147	173	175	227	144	171	162	170	191	199	216	173	144	150	142	165	139	150	163	177	173	153	154	167	169	96	158	145	199	255	179	208	245	159	148	127	169	124	157	189	130	145	192	139	153	154	118	138	97	101	133	239	153	120	124	156	157	186	223	136	121	115	135	124	173	118	141	173	118	149	207	127	144	78	158	163	107	119	125	137	141	149	146	147	142	164	152	77	107	143	103	144	131	83	133	105	111	101	171	130	138	141	123	144	97	156	96	114	148	106	112	85	129	128	132	111	165	193	143	126	187	114	98	120	105	102	151	149	146	185	135	117	125	151	122	92	119	132	121	113	109	129	150	106	111	175	109	112	113	87	101	113	99	93	122	155	96	115	101	106	105	115	197	128	159	111	114	115	158	110	97	118	50	127	131	120	119	128	118	142	123	123	114	90	103	139	141	173	180	111	99	104	105	218	87	127	94	121	113	106	128	116	107	157	76	147	80	139	84	108	169	142	101	186	92	85	138	122	77	105	114	70	105	141	85	107	134	120	63	110	90	135	83	112	97	78	102	63	110	145	73	71	84	108	154	168	145	84	97	105	136	109	130	87	123	104	134	83	106	119	99	110	87	136	130	109	117	58	107	110	143	174	80	67	114	95	134	130	99	82	63	76	94	108	144	112	107	163	102	68	120	77	133	129	92	127	106	124	116	87	83	89	79	111	113	103	70	105	70	90	107	110	91	117	108	91	93	83	116	123	96	94	122	68	103	108	108	74	95	75	88	108	43	127	97	104	81	95	123	99	71	89	99	83	89	81	95	69	169	128	114	74	106	111	115	111	68	87	71	105	83	109	105	85	95	95	100	95	74	65	91	76	97	72	65	81	48	73	72	62	89	96	107	72	70	58	123	60	106	64	92	92	75	59	89	93	132	100	120	87	117	115	98	79	96	114	97	101	146	101	78	80	58	69	91	57	75	97	71	115	98	80	68	64	75	109	97	69	82	63	62	67	78	88	65	50	73	72	85	157	101	80	109	66	58	86	60	100	76	109	79	69	81	77	48	69	54	80	57	78	83	80	70	59	97	96	92	71	79	68	87	86	58	77	80	94	81	80	56	102	113	79	77	94	56	76	95	66	108	86	49	80	91	71	74	40	69	60	42	68	57	69	75	71	58	107	50	54	87	47	67	90	75	106	81	61	117	72	63	52	70	82	73	53	47	89	103	100	51	78	59	56	64	74	76	64	48	97	63	71	108	59	27	81	116	63	55	50	126	81	46	77	114	59	42	87	64	123	97	89	46	59	52	67	66	57	102	108	75	44	56	75	62	63	43	55	72	44	50	62	72	77	40	75	49	93	45	52	55	68	56	49	41	74	70	78	46	58	50	48	56	59	66	56	75	33	59	44	47	51	39	89	46	63	83	121	88	55	83	42	40	89	57	68	88	55	65	35	63	81	39	72	71	61	94	58	46	51	113	40	57	74	51	55	32	53	51	30	55	56	57	51	65	99	46	33	82	48	48	60	30	50	47	58	32	36	81	66	58	32	74	77	40	91	42	44	37	46	67	51	72	75	88	55	51	30	48	39	42	56	30	42	47	33	20	57	68	68	53	81	46	63	57	73	49	43	47	44	38	39	23	48	48	43	36	38	53	52	51	46	50	45	48	58	39	32	69	58	62	63	30	37	33	51	54	51	51	62	36	56	27	32	38	39	43	38	74	33	72	39	47	44	38	39	44	25	27	36	46	55	60	59	28	42	53	50	52	59	45	55	47	60	42	38	41	25	25	53	66	40	41	26	47	23	57	45	48	45	50	63	51	52	61	31	40	42	29	39	45	54	51	33	32	59	41	37	34	24	80	29	33	31	24	53	23	37	51	49	29	30	30	37	38	41	27	26	35	41	40	46	34	35	47	29	57	39	58	40	62	53	42	43	26	18	62	27	24	41	32	34	37	34	50	46	30	27	61	22	14	38	33	51	52	24	36	29	44	41	29	36	50	17	48	32	30	46	30	29	38	24	27	36	39	30	31	69	67	57	25	37	37	33	23	16	23	24	59	63	32	60	28	27	44	25	30	20	33	22	21	34	28	39	53	24	36	16	36	21	37	30	40	38	25	68	30	37	37	18	32	56	23	26	22	34	25	24	7	34	35	16	19	49	22	36	29	24	11	26	44	35	43	22	89	37	35	17	27	26	21	28	23	36	26	31	16	22	24	31	18	12	16	22	31	37	34	36	30	41	33	20	23	20	24	15	57	18	32	25	26	18	27	22	14	44	16	16	21	15	28	23	13	14	16	16	25	26	27	18	18	48	19	22	37	37	32	43	17	23	20	42	31	65	29	27	17	30	38	21	34	32	19	35	21	30	19	29	42	6	21	20	34	34	38	44	25	32	25	23	27	25	15	26	22	34	16	31	16	11	8	16	20	10	20	30	19	8	9	12	15	32	12	7	10	29	19	18	16	26	21	3	7	13	27	19	15	15	24	17	16	33	13	17	30	19	4	19	27	16	35	10	7	19	9	24	9	16	9	12	11	16	11	20	11	14	19	29	31	11	22	14	19	18	30	10	14	16	15	20	13	17	26	12	13	11	5	14	12	16	18	24	23	16	27	9	26	15	16	24	23	11	15	17	6	8	20	10	14	20	15	20	14	8	14	7	27	9	4	18	8	35	12	5	7	35	11	3	6	8	14	6	11	13	2	10	15	11	18	6	16	6	5	12	11	9	8	12	12	8	2	10	13	18	5	11	29	5	5	9	12	22	12	11	10	6	6	6	9	7	414	19	12	3	10	5	13	9	4	9	8	13	12	5	14	9	10	9	16	24	9	6	2	13	1	18	7	2	5	8	4	5	5	6	5	5	11	12	3	11	13	9	7	5	4	12	41	6	4	6	2	6	3	3	3	0	5	4	5	3	2	2	1	6	11	5	4	6	3	3	2	2	7	2	5	2	2	4	8	1	3	4	3	5	0	4	1	6	3	6	1	2	2	0	0	1	0	0	15	0	0	1	0	1	1	1	16	2	0	0	0	0
ne0189	1364	1643	959	1035	1053	1029	748	872	807	709	762	767	677	588	516	661	549	609	542	594	663	672	565	367	506	468	574	513	532	689	497	321	382	454	445	532	345	532	449	337	366	369	420	367	435	362	422	289	383	352	394	392	548	554	291	366	420	525	328	483	409	323	365	390	342	307	409	383	324	389	294	436	373	328	431	506	379	388	239	427	274	256	417	346	429	347	274	325	295	228	295	236	376	260	392	346	343	240	261	221	256	265	409	309	276	256	255	341	197	277	232	204	315	348	343	255	320	234	313	372	425	327	398	182	257	386	223	378	289	311	317	199	285	212	366	270	262	254	312	240	262	229	296	237	230	214	256	275	217	255	242	215	177	163	255	294	218	288	279	251	287	312	240	215	249	319	191	325	239	185	225	247	251	170	302	214	226	260	304	196	357	199	264	338	340	308	222	236	278	253	257	188	262	229	268	160	193	271	239	181	206	272	232	267	281	163	214	193	234	141	274	255	206	141	211	378	227	311	166	262	255	263	193	96	248	274	227	216	197	184	240	98	279	238	204	178	217	284	213	179	265	235	156	456	236	173	182	182	192	174	241	235	170	191	155	232	152	212	233	273	176	212	166	148	157	144	164	251	239	148	202	127	209	172	273	164	157	203	176	222	215	160	227	173	207	158	134	224	199	189	206	118	311	217	378	173	223	175	130	131	243	195	192	123	102	189	223	204	192	204	204	141	286	182	191	177	84	306	120	208	155	126	132	226	247	237	97	193	181	132	143	121	110	89	159	93	168	236	135	148	161	100	113	229	101	155	96	89	158	217	142	182	187	125	131	119	197	189	198	174	119	140	134	193	164	145	143	154	274	80	169	155	127	116	131	155	172	80	131	114	282	127	115	114	222	166	142	141	77	139	211	318	202	180	113	99	171	146	150	106	143	97	114	163	155	137	186	165	99	156	161	172	124	109	109	210	139	153	119	133	133	142	128	104	137	58	94	117	133	157	117	185	111	125	134	98	94	98	102	102	113	165	122	121	156	104	105	158	110	110	132	97	123	110	143	213	109	143	129	113	140	125	164	129	130	200	164	134	88	137	268	116	134	119	239	137	82	180	171	152	185	101	81	163	121	151	100	143	100	149	132	94	105	109	119	77	98	124	86	95	137	106	79	105	82	129	153	94	125	84	89	129	147	118	70	133	66	186	153	114	86	154	135	70	129	87	140	102	123	125	118	125	137	109	166	112	125	125	165	129	92	89	130	145	96	101	108	77	154	102	97	124	98	103	95	115	104	130	115	78	102	120	104	94	128	108	77	82	82	138	89	129	108	89	62	135	75	55	122	89	98	114	109	112	105	107	96	120	82	85	143	72	110	113	54	140	77	81	84	83	72	106	122	61	72	124	138	119	110	230	119	84	99	108	95	193	109	58	106	104	113	175	105	68	114	104	127	69	111	84	79	79	128	61	114	100	109	75	94	126	96	111	138	94	120	110	72	87	107	93	63	101	81	76	54	93	95	77	120	94	76	87	117	82	67	55	103	81	104	102	95	72	93	91	100	77	116	93	72	85	105	84	108	125	142	116	187	82	31	96	82	93	85	112	88	120	82	101	64	102	88	73	115	125	55	72	87	94	86	83	89	117	67	56	102	103	72	77	64	45	53	83	61	102	146	133	61	85	49	136	107	84	72	87	94	70	105	67	73	87	57	86	102	66	58	64	74	81	85	79	128	44	111	69	140	70	96	57	162	93	94	59	75	77	105	73	31	106	41	64	86	81	68	70	71	85	53	53	53	83	84	82	46	64	103	80	56	62	100	62	86	92	85	113	92	56	50	69	81	75	76	81	69	65	37	82	61	89	82	45	118	109	83	72	66	25	62	62	119	118	24	65	108	43	59	31	65	62	82	46	38	93	94	167	51	68	71	66	85	49	73	51	61	71	68	88	62	49	81	63	62	65	97	90	69	93	57	80	65	89	73	50	53	77	83	75	62	54	88	78	105	73	131	59	37	67	58	48	54	48	58	27	101	77	102	95	78	71	77	60	56	63	62	88	86	53	42	57	37	50	50	55	72	41	60	83	53	56	37	73	51	42	85	48	82	51	88	60	53	86	29	74	76	63	42	65	46	95	56	62	95	46	61	30	99	97	58	45	53	50	77	33	52	59	31	50	56	31	88	40	75	50	75	30	52	103	54	80	100	44	89	94	75	60	67	46	64	81	47	58	63	28	85	66	55	59	38	53	59	94	61	61	25	61	88	46	43	60	54	45	60	45	57	66	74	45	39	55	63	37	59	45	37	67	37	69	60	61	41	56	58	38	54	49	39	41	34	59	47	41	55	55	37	80	73	53	41	95	37	65	47	56	55	32	34	70	34	87	46	54	54	26	92	58	57	45	57	41	45	48	64	51	23	75	50	56	50	33	36	56	52	59	29	38	103	28	50	40	45	31	42	57	85	69	77	53	63	51	47	52	46	47	34	46	61	20	77	24	40	48	25	38	47	34	35	51	44	41	52	25	42	47	52	29	43	50	25	35	54	49	43	40	64	68	49	22	61	29	28	77	57	47	41	52	93	27	41	39	38	32	29	49	46	48	39	37	53	55	39	31	27	32	29	50	52	19	30	24	48	36	27	88	51	41	35	57	46	20	45	44	30	40	54	37	58	57	83	27	40	45	36	47	20	29	38	44	39	60	24	44	31	37	43	54	43	31	56	45	37	39	15	45	22	44	33	36	36	24	55	49	38	40	23	29	45	49	28	29	14	46	28	28	37	30	51	23	28	57	25	31	30	30	14	43	48	45	42	40	36	29	25	42	19	27	43	46	25	20	32	106	47	39	17	39	22	17	60	36	41	38	34	33	59	15	34	55	42	29	25	111	23	27	39	22	40	56	26	25	41	24	42	21	25	31	51	24	42	36	36	19	39	15	34	36	37	48	36	24	20	46	47	27	47	65	35	24	24	43	59	61	25	38	30	19	30	32	26	35	41	60	15	32	18	26	39	31	25	21	28	36	32	28	30	22	26	34	25	19	19	23	35	28	26	31	25	35	14	17	34	30	80	16	23	28	24	24	28	20	25	24	14	19	17	26	23	17	33	27	35	18	14	19	26	45	64	23	34	32	50	27	26	30	33	42	16	20	31	25	29	13	24	26	28	21	21	34	35	34	41	26	25	26	27	28	22	21	42	28	13	13	20	29	22	17	24	35	7	28	31	22	29	40	33	45	16	33	28	12	40	16	29	35	7	21	23	26	15	46	11	8	30	19	24	32	9	27	40	28	29	55	16	30	31	7	19	12	12	27	32	27	53	19	30	6	17	19	8	61	22	26	10	37	41	24	16	18	25	8	47	12	25	14	13	9	18	38	14	16	56	20	21	15	24	10	28	19	27	54	34	28	30	33	21	19	20	25	21	19	13	23	19	14	10	24	8	4	31	26	18	15	34	18	24	16	16	34	29	19	14	10	15	19	15	22	85	9	12	19	22	12	19	13	13	26	13	11	16	8	13	21	7	21	12	11	12	23	17	16	17	12	16	20	20	20	10	11	14	12	14	13	11	20	13	8	23	9	23	19	5	16	13	12	12	14	9	15	20	11	15	7	6	16	13	10	10	22	9	3	13	9	32	24	22	16	11	15	12	12	3	10	12	29	34	16	21	8	6	12	13	10	10	7	10	10	9	1	7	5	33	13	13	13	11	8	5	29	8	20	17	8	20	16	5	11	13	7	7	14	14	15	14	24	5	13	12	18	16	4	5	8	5	42	21	18	13	29	13	15	9	6	13	1	9	6	6	14	20	12	16	12	17	16	12	4	158	14	10	7	5	13	16	26	9	5	8	3	5	12	1	14	4	3	3	5	12	10	18	16	9	39	9	7	9	21	13	7	2	4	4	3	14	4	5	6	9	7	13	16	7	15	6	5	9	4	5	10	9	5	10	1	10	5	5	8	8	2	1	13	7	10	3	7	5	6	7	3	5	9	9	11	6	2	23	6	3	18	8	7	12	0	3	10	18	7	3	8	10	7	6	19	5	2	1	6	4	1	2	1	4	4	6	9	2	13	1	4	3	1	9	3	3	3	2	3	4	1	1	3	1	6	1	0	9	1	10	1	158	2	1	0	0	1	0	1	2	0	6	1	2	0	2	0	1	0	1	0	0	0
ne0191	4916	4680	2827	2777	2093	1884	1751	1669	1550	1644	1595	1407	1663	1313	1204	1499	1628	1269	1560	1159	961	1848	1348	1070	1199	1119	1130	1277	1893	1191	916	1552	855	895	1465	856	878	1066	1359	951	1044	770	1679	1092	1336	864	987	872	1373	876	747	661	865	1438	1500	920	965	594	1054	921	752	913	686	970	629	1190	961	942	972	752	1032	737	1140	688	999	690	592	764	847	1165	685	968	634	1122	649	733	1033	597	884	814	819	713	732	629	824	906	642	802	801	727	666	891	801	796	804	448	786	662	797	1415	713	828	608	759	626	1058	564	583	783	634	522	735	474	814	748	684	644	818	506	596	469	660	643	604	720	855	1119	745	683	644	451	728	1003	640	699	658	519	888	904	607	628	575	564	714	822	712	604	738	544	535	577	801	444	510	785	541	571	493	561	610	895	535	548	481	464	674	450	508	542	580	728	534	660	430	666	580	722	686	575	648	527	335	1418	392	536	556	617	527	520	523	401	499	964	569	781	423	693	397	657	662	466	725	1025	384	730	546	394	480	454	339	315	518	399	529	385	526	357	410	631	432	458	525	546	596	668	452	541	391	368	410	573	381	572	702	472	358	455	509	625	610	333	440	647	669	325	404	426	467	658	523	491	459	541	281	392	427	593	552	430	722	476	398	432	381	422	415	567	585	575	574	389	496	440	736	463	820	492	526	420	749	344	357	285	627	745	488	540	304	422	395	333	362	329	358	492	338	513	397	279	406	376	400	273	506	516	385	452	456	446	339	331	369	412	519	593	511	447	543	611	432	649	349	400	387	498	434	413	439	327	282	567	421	400	577	309	490	402	287	365	425	340	483	367	431	421	373	306	663	451	551	243	540	472	312	499	402	511	383	333	432	402	258	375	381	287	492	336	243	360	364	610	261	314	317	431	441	315	288	302	329	488	584	458	469	382	272	519	433	574	362	392	222	399	279	592	321	477	416	345	403	324	376	475	320	483	284	278	364	314	581	323	505	424	403	396	244	481	405	467	401	243	217	366	391	270	462	332	361	527	241	193	298	481	313	410	248	338	288	315	377	293	293	273	320	267	247	356	389	395	339	347	498	357	357	287	303	311	171	292	541	579	193	375	388	464	361	326	193	283	788	258	269	197	308	347	374	309	380	232	343	324	329	331	250	213	191	311	451	248	225	311	220	439	857	185	239	393	401	212	307	288	294	332	321	215	255	275	353	266	206	294	224	215	433	347	371	379	416	273	353	415	343	353	275	391	218	323	291	206	346	405	323	217	410	346	625	439	223	192	440	268	387	345	272	221	258	462	220	509	182	325	195	500	197	450	461	284	316	356	266	189	209	269	289	215	170	424	250	267	188	188	122	192	266	272	214	259	216	166	243	346	167	186	171	229	386	278	225	204	209	454	232	206	303	188	223	260	208	169	434	177	195	156	351	184	188	233	209	186	174	388	200	219	225	402	253	238	216	207	310	356	214	306	226	240	138	202	260	224	285	315	562	207	316	229	153	114	418	167	226	149	296	192	158	149	288	280	213	313	348	317	233	215	211	208	264	176	281	205	259	184	146	300	102	164	245	199	176	378	128	219	260	188	153	204	296	218	266	84	119	221	299	221	231	294	160	264	125	274	142	198	329	164	282	247	225	221	237	313	192	149	168	180	118	108	178	186	168	366	235	231	229	221	114	144	225	274	249	153	227	254	245	227	162	190	187	138	186	176	397	223	209	102	212	279	201	340	190	229	120	187	141	214	570	156	186	220	324	257	178	307	226	146	137	136	158	295	286	258	225	147	213	133	224	121	127	220	106	219	199	162	164	207	213	157	153	420	148	187	173	133	179	235	161	215	208	364	243	196	178	135	222	276	261	75	318	156	138	182	212	82	157	199	132	101	110	147	162	132	149	107	113	197	147	295	116	140	198	160	226	87	175	142	327	100	129	147	215	156	223	183	215	63	84	138	70	179	220	146	164	123	168	156	113	120	181	167	138	63	135	129	125	121	118	268	106	115	187	112	147	103	147	262	160	115	133	199	181	128	214	208	146	202	160	158	117	128	73	294	108	169	176	158	109	122	157	206	133	137	209	134	178	144	83	106	173	225	244	133	172	121	94	164	189	129	192	159	187	130	158	136	122	188	277	132	130	117	168	139	112	163	197	134	131	183	317	70	180	171	142	155	212	121	146	102	133	163	157	103	116	96	100	87	128	147	176	152	199	109	148	166	77	156	167	134	104	132	120	125	124	167	122	168	113	116	104	74	181	139	281	174	126	204	167	106	78	119	111	97	177	133	134	150	149	102	88	116	104	100	131	194	151	116	75	136	141	108	154	81	140	268	108	81	135	204	164	97	128	72	80	119	135	147	207	104	162	188	116	167	147	170	160	135	101	238	141	97	53	101	114	150	112	82	163	102	196	200	232	177	144	202	95	113	83	47	175	181	128	80	114	116	150	81	86	68	108	109	51	195	93	96	95	126	79	56	121	102	86	94	190	125	94	176	62	78	159	143	137	128	93	64	168	114	144	104	78	135	79	97	95	130	102	138	139	93	116	120	118	142	90	138	159	143	79	103	115	94	73	73	125	90	89	210	128	48	137	133	129	124	94	140	75	81	158	82	78	121	77	109	73	112	120	150	66	114	277	100	175	111	92	132	53	106	79	76	163	146	104	211	102	53	114	74	94	114	98	60	83	136	78	103	110	129	60	100	105	79	130	88	83	104	141	24	247	93	143	130	120	353	61	115	140	81	53	67	110	75	116	101	141	77	57	122	98	67	135	138	113	159	129	92	54	86	119	71	105	110	199	49	85	109	48	71	110	101	80	98	65	82	94	80	58	75	41	86	65	83	156	118	119	124	114	67	128	136	121	86	80	109	187	140	91	105	103	76	98	63	100	99	94	71	97	87	74	74	124	86	75	52	85	100	73	51	73	81	132	42	60	32	85	78	80	122	109	36	69	84	70	99	74	60	130	66	114	48	113	84	45	65	102	60	69	63	74	60	60	61	63	123	69	41	58	180	99	43	115	64	117	53	45	72	60	62	128	140	103	83	52	47	57	95	23	54	44	69	65	78	94	80	65	266	91	78	39	58	68	54	86	142	79	55	47	89	70	47	46	114	27	55	68	86	74	103	132	68	96	79	48	75	41	132	47	97	95	36	64	108	89	48	50	28	72	52	64	35	85	53	27	50	81	81	105	91	102	116	51	118	97	74	63	136	41	50	43	170	42	52	36	52	115	59	100	59	59	67	64	62	57	79	292	29	75	129	74	32	111	103	102	40	119	43	59	86	88	61	92	81	31	167	85	31	31	81	63	52	116	47	78	74	24	30	67	43	97	48	44	71	99	47	67	97	91	153	102	42	99	58	42	22	29	41	34	62	46	54	108	45	40	65	82	65	45	26	34	33	45	56	38	42	61	45	47	48	341	65	108	47	35	89	23	36	58	35	38	35	38	33	51	48	79	70	42	40	102	36	32	48	78	77	80	37	36	41	39	50	62	31	43	31	88	18	118	37	42	56	95	39	49	82	76	64	35	9	59	28	42	82	22	120	33	62	108	53	39	46	61	49	21	54	40	41	114	64	71	47	28	38	32	38	14	44	99	33	19	39	25	35	28	35	33	61	47	82	20	30	19	24	30	13	3	28	52	54	62	18	6	26	136	59	23	38	75	53	58	60	25	66	23	31	21	42	34	32	99	54	62	25	35	32	32	32	11	28	20	33	31	130	26	33	52	39	58	35	26	26	29	18	32	26	44	54	42	8	29	25	21	20	40	15	42	17	25	43	30	30	27	38	25	21	16	31	59	27	38	12	24	28	83	19	32	28	34	23	16	17	27	48	16	31	16	43	25	48	11	19	12	66	8	41	34	16	3	9	34	21	61	21	299	45	40	20	28	12	19	13	25	25	41	23	20	22	22	32	44	11	10	12	4	20	14	26	6	23	10	17	29	29	33	29	12	27	36	36	14	34	0	42	43	74	31	3	19	38	7	12	25	21	15	23	11	89	25	10	12	13	50	3	5	19	13	21	4	4	10	25	18	10	18	16	148	7	4	24	4	10	23	5	3	23	10	40	33	5	10	11	7	15	10	11	11	15	13	5	11	2	4	8	1	9	7	11	4	4	6	4	10	5	13	0	5	1	1	4	5	2	4	7	3	22	3	1	0	1	0	1	1	2	0
ne0192	5605	3061	1995	2404	1809	2038	2168	1885	1615	2142	1325	1315	1618	1615	1371	1241	1618	1247	1162	1053	1322	1396	852	1484	1234	1145	948	1305	1134	1210	766	1021	1048	1218	828	927	1144	856	1082	1023	1071	889	980	1215	1055	1127	1022	1303	870	795	944	856	921	932	1082	938	685	527	797	893	873	1141	426	778	763	1019	987	926	880	608	560	612	706	722	525	553	813	736	755	537	949	558	971	873	450	754	834	674	629	722	838	411	819	692	614	575	672	739	711	725	718	738	725	759	813	683	767	768	536	822	602	609	714	765	725	650	684	675	428	759	712	736	339	570	525	767	561	550	657	702	570	542	532	425	563	351	570	511	660	463	641	814	711	418	347	675	448	525	541	587	600	478	678	611	643	393	778	384	718	663	626	383	514	616	395	572	513	513	400	690	527	480	537	640	606	396	464	583	403	405	592	523	419	520	538	353	487	459	434	410	416	564	473	517	489	651	417	587	559	628	445	398	382	508	303	580	607	588	474	425	569	511	420	439	412	531	480	287	465	374	293	531	311	494	424	410	344	451	550	548	283	444	412	278	712	430	313	374	292	475	458	290	448	548	364	430	501	289	477	345	462	350	316	305	271	548	448	493	341	370	441	365	397	469	355	480	547	407	294	328	428	388	559	374	472	290	287	550	320	288	260	356	358	248	437	234	380	492	267	532	328	497	282	323	688	351	491	460	474	342	313	276	288	308	442	287	373	290	531	290	215	308	293	277	297	329	325	341	480	574	292	286	331	350	477	539	406	276	431	313	424	563	498	444	630	322	319	426	388	385	304	346	370	457	526	345	311	400	238	197	361	281	273	279	384	461	328	255	252	263	341	253	396	241	269	297	355	311	532	325	231	213	260	347	243	208	374	303	397	307	430	311	279	474	219	340	291	187	428	257	337	481	369	340	282	282	255	409	167	401	253	339	497	397	483	339	199	227	406	230	321	188	273	448	240	383	252	319	271	414	244	209	486	329	315	472	427	387	193	273	387	245	256	307	222	269	217	294	277	247	187	198	249	415	244	209	275	301	246	313	261	267	315	235	145	241	219	262	214	229	251	312	205	276	234	293	312	207	214	188	273	351	234	206	382	232	266	141	183	161	245	353	230	153	241	256	326	372	384	189	267	305	199	185	159	245	207	230	261	214	194	277	244	375	358	252	137	170	283	323	308	234	339	162	235	162	200	222	298	264	181	217	121	229	230	198	178	274	163	222	254	328	256	261	143	221	195	178	114	165	158	124	145	169	214	256	144	170	163	263	155	229	277	212	171	123	269	255	273	199	168	215	277	182	263	291	165	248	186	217	238	268	200	214	224	316	257	301	182	298	138	208	148	179	409	341	229	163	247	247	162	180	197	99	349	201	325	273	209	228	365	203	152	186	175	149	147	195	137	188	217	184	100	135	137	174	198	152	142	157	147	204	133	188	193	222	177	164	142	221	228	152	150	163	150	122	161	175	220	160	168	129	140	181	128	124	156	157	101	218	142	207	174	211	233	205	187	303	131	136	186	321	154	141	144	151	174	190	170	171	241	134	268	280	201	197	124	111	241	157	98	168	214	140	234	180	237	197	201	100	207	200	221	130	76	127	165	137	208	116	182	163	246	214	181	220	247	155	222	136	118	112	130	163	130	112	99	108	172	108	165	95	233	83	51	143	214	161	154	102	163	155	142	209	95	94	83	282	201	138	114	111	175	153	186	203	104	106	80	118	157	130	129	215	105	185	168	127	143	91	221	176	129	155	76	71	152	205	177	128	53	254	106	111	83	195	278	126	254	138	219	134	144	241	139	91	161	90	138	133	94	114	140	181	203	281	260	138	191	130	136	102	99	125	95	139	193	178	146	154	77	183	176	221	148	149	117	128	155	63	121	193	165	154	217	180	201	87	79	101	164	90	148	241	145	125	89	161	108	85	149	100	280	121	142	116	102	104	113	61	136	104	158	167	89	129	98	72	56	194	116	121	202	80	177	111	137	152	78	98	134	76	125	221	175	92	159	120	86	158	109	172	146	172	135	66	117	58	108	120	81	77	70	125	68	130	205	127	118	133	92	175	133	91	55	132	133	160	156	113	91	67	99	141	90	135	70	97	78	99	120	155	122	126	109	93	118	71	121	59	98	126	152	131	103	73	46	80	106	132	70	113	119	166	107	74	157	92	93	181	72	92	36	141	126	75	60	104	79	122	149	92	69	124	98	67	111	93	80	225	85	140	80	76	74	81	95	131	72	152	67	80	93	75	84	131	100	78	82	64	75	143	118	76	55	49	120	103	106	125	84	153	36	84	80	89	59	64	69	111	71	111	67	75	138	87	56	101	61	116	310	107	118	92	86	79	173	79	61	91	69	69	86	123	83	101	112	45	48	95	120	89	38	137	52	59	130	47	88	73	137	55	128	91	82	52	106	53	145	102	87	106	64	135	77	61	84	59	83	75	77	58	94	94	75	98	101	59	67	111	63	113	71	121	96	132	92	69	216	74	84	97	50	65	169	52	37	42	82	63	71	118	76	74	58	51	59	73	68	120	30	102	64	56	85	88	83	106	72	49	46	85	105	228	62	159	67	76	65	101	110	45	66	83	88	60	63	32	80	67	55	89	76	59	71	59	74	66	50	47	62	93	48	41	91	99	117	80	85	125	124	43	48	64	52	51	35	71	46	44	63	67	66	73	85	51	64	59	41	58	90	61	71	58	79	52	46	55	60	99	68	99	110	83	45	58	73	62	33	114	94	46	55	109	27	46	97	37	34	104	48	71	14	74	29	64	54	66	110	43	66	42	65	126	42	42	33	63	29	62	27	71	33	38	54	81	72	52	76	62	82	43	99	45	105	44	94	67	98	49	64	44	71	42	30	86	40	67	50	71	73	51	49	94	154	56	93	37	34	53	52	61	96	26	63	46	50	37	45	34	33	36	54	59	40	40	83	65	65	54	53	83	41	57	99	68	90	43	40	51	65	43	43	77	34	32	33	46	66	34	69	143	44	70	32	39	26	38	34	60	24	78	54	135	46	65	52	60	57	23	32	73	48	18	39	42	50	41	23	39	78	76	60	36	86	38	70	37	36	46	76	84	91	81	25	55	48	21	38	21	92	35	42	31	34	37	44	71	30	50	89	38	79	31	52	26	69	78	43	79	96	18	34	37	17	68	44	52	56	86	27	52	25	76	64	39	24	51	56	42	38	89	55	26	61	62	24	20	28	56	30	35	46	34	35	68	74	26	54	66	88	30	33	14	49	63	33	69	36	34	38	60	19	17	28	32	42	24	50	55	16	35	28	10	13	33	51	32	55	16	44	25	21	48	23	40	68	54	25	26	9	58	57	56	32	68	94	25	50	32	42	18	18	30	38	37	10	31	71	19	35	40	27	10	41	21	15	87	16	12	50	21	11	15	49	48	24	91	20	37	33	21	40	32	18	34	24	28	40	38	58	43	61	24	23	15	22	16	16	30	17	35	16	27	24	26	38	38	39	31	31	142	27	21	14	16	10	20	23	27	28	21	23	29	44	48	46	45	77	34	18	22	23	36	15	36	18	23	28	27	23	50	37	19	17	31	21	12	30	13	25	54	7	11	17	14	12	21	52	33	35	25	29	17	36	8	25	45	38	93	15	9	27	29	20	32	46	20	16	16	10	21	20	12	17	10	21	3	7	15	36	22	13	20	28	9	37	32	22	13	9	12	20	21	18	12	14	22	41	15	7	21	11	12	26	17	11	12	8	17	13	26	35	9	21	31	32	10	39	18	26	41	21	11	15	8	15	21	15	11	8	15	10	8	11	12	14	0	43	12	46	14	8	26	12	35	9	14	11	4	7	18	19	15	21	15	12	9	20	14	18	23	10	3	4	18	54	16	5	21	15	9	11	19	6	27	16	21	10	18	29	2	33	7	6	11	3	20	11	23	1	9	5	5	10	4	5	18	3	2	16	15	5	10	16	8	11	6	12	10	6	7	19	2	18	3	10	8	7	8	11	6	11	7	10	7	5	5	6	8	3	3	11	9	0	2	19	3	0	13	4	15	3	3	1	4	5	14	1	1	10	25	4	4	4	7	7	1	4	4	2	3	1	5	2	1	0	5	3	0	0	0	3	12	4	1	0	1	4	0	0	0	1	0	0	3	0	2	0	0	0	0	0	1	1	0	0	1
ne0193	1939	1302	716	1301	648	767	784	726	612	730	429	507	502	581	483	500	646	392	509	403	436	580	272	551	458	394	432	392	499	406	256	546	324	434	364	287	418	323	378	363	374	298	443	512	538	437	402	396	287	233	345	232	333	388	586	293	264	213	315	327	293	307	134	312	184	418	410	401	354	177	210	283	272	262	210	194	301	262	383	147	346	238	378	311	161	289	331	172	174	266	398	158	335	278	222	256	287	344	357	343	256	245	277	287	356	186	326	262	235	534	235	265	248	319	281	308	263	236	152	269	232	291	106	239	212	258	163	254	243	252	135	167	205	133	177	115	379	165	250	252	198	303	389	187	133	270	175	192	262	227	202	162	188	270	236	130	190	131	242	279	227	173	157	232	175	238	172	213	157	313	243	155	158	239	220	136	175	210	173	118	248	212	146	223	228	136	162	172	189	193	174	155	335	138	169	317	207	209	216	224	162	161	168	159	137	192	234	154	150	181	225	261	166	133	183	190	158	109	160	151	84	218	56	175	163	193	139	141	198	163	90	190	207	141	262	91	116	137	90	187	245	83	136	190	141	125	168	84	176	128	153	110	162	101	103	195	163	129	100	174	184	177	132	127	200	177	163	163	156	119	173	121	217	119	221	120	138	167	251	101	97	146	125	92	204	65	150	185	98	146	84	159	118	114	250	138	221	186	143	129	136	150	104	100	181	118	178	97	167	114	57	80	140	101	112	100	145	195	184	145	119	92	150	150	197	241	160	82	144	133	231	188	153	243	246	149	121	150	160	118	130	170	134	181	197	108	122	107	107	119	151	102	97	119	128	156	119	86	77	84	108	65	193	89	88	153	134	108	179	166	112	72	120	132	88	90	147	110	117	119	199	108	106	176	88	123	150	64	147	82	133	186	206	175	97	110	118	143	65	171	85	165	219	120	196	101	91	80	150	83	96	84	102	160	121	153	81	121	140	229	118	80	174	118	132	132	134	169	83	125	156	91	76	83	81	122	80	130	84	99	87	82	68	104	86	79	73	106	99	169	78	100	170	105	55	91	79	79	92	77	96	172	45	92	68	110	151	104	75	74	162	90	82	76	129	92	123	65	46	142	90	95	85	54	113	97	184	234	138	49	102	93	79	62	66	100	97	99	96	69	91	82	91	249	151	128	38	66	105	146	122	81	117	86	74	53	66	131	90	109	60	108	34	115	87	81	74	78	57	113	73	54	107	99	63	51	125	63	34	80	82	53	37	49	42	173	57	96	61	111	75	102	177	237	71	39	76	67	270	81	97	67	111	70	128	118	55	118	59	71	83	82	83	81	83	134	174	101	112	77	37	41	66	65	117	131	130	66	124	74	54	66	82	25	106	93	118	91	91	67	113	58	58	81	48	41	81	37	39	72	80	67	23	46	45	100	69	79	62	53	48	77	75	58	150	65	66	57	72	73	86	31	65	54	62	25	137	79	73	39	64	95	57	57	34	52	22	99	21	72	64	52	44	74	79	92	103	137	80	79	83	136	56	32	57	57	70	109	72	60	84	32	86	117	77	111	45	30	125	43	43	95	89	42	124	142	73	82	66	36	62	55	92	60	36	52	63	44	72	54	55	59	75	97	91	77	155	85	87	47	56	64	29	54	61	69	47	29	130	39	45	26	97	19	29	79	117	75	53	29	35	51	36	56	44	21	36	112	68	59	52	43	59	74	64	63	55	59	21	77	57	47	40	89	37	68	62	82	58	42	61	103	28	53	43	19	87	91	38	27	30	92	63	31	53	65	138	70	108	46	79	51	45	89	60	31	147	44	32	68	36	65	62	52	75	93	91	48	63	32	50	42	30	71	35	55	52	80	56	65	39	58	64	97	45	49	41	51	87	48	45	80	57	47	120	55	71	69	31	30	50	38	90	40	47	42	38	69	54	30	47	35	118	50	50	65	53	28	34	13	49	46	65	88	36	58	38	12	24	66	50	59	72	28	113	45	40	76	35	21	31	33	52	65	85	43	68	41	36	67	30	36	74	68	54	28	45	14	46	41	25	20	16	66	46	36	70	42	36	47	45	31	27	29	21	22	108	56	33	55	26	24	73	54	35	40	29	49	19	38	54	61	67	69	36	33	53	18	53	26	43	59	41	40	49	26	36	30	42	47	16	52	53	76	32	25	73	46	55	64	33	32	9	67	41	19	36	24	32	24	60	28	21	59	46	23	47	44	26	98	30	37	24	45	32	17	37	32	43	81	26	47	43	81	33	54	27	17	27	17	42	54	22	18	21	18	52	25	31	40	45	29	16	53	21	28	18	19	16	78	33	35	10	30	46	49	24	43	8	28	67	39	43	31	29	24	102	56	17	48	27	20	22	50	60	30	53	33	22	27	52	26	35	73	27	7	62	33	13	21	76	42	51	31	27	9	33	10	44	45	40	44	12	57	35	26	17	32	34	34	24	34	66	47	25	36	78	10	24	43	18	41	23	50	46	42	24	41	67	36	27	30	31	21	55	23	17	26	20	39	15	69	62	14	27	15	27	41	21	48	17	39	47	40	35	24	44	33	39	32	14	41	45	65	36	81	32	19	29	40	39	13	36	42	25	24	22	8	32	37	13	11	17	33	17	69	18	19	9	23	35	34	14	13	22	33	29	21	40	72	48	20	12	10	74	21	33	50	13	15	18	23	19	22	27	23	24	35	18	10	66	35	10	27	22	50	35	11	23	34	24	51	16	17	18	51	22	21	29	29	51	16	17	43	11	20	30	13	8	40	29	26	8	32	3	18	22	28	8	55	28	12	36	35	18	20	12	22	12	22	5	27	14	8	16	56	30	39	24	38	31	16	30	17	29	18	30	24	23	13	50	17	34	28	10	31	16	35	13	50	24	19	26	39	69	30	18	9	29	21	26	17	73	10	27	10	8	7	14	29	10	14	26	19	9	22	28	28	18	33	20	61	30	18	41	49	59	9	13	26	26	16	15	32	9	11	8	17	19	27	36	57	31	14	10	43	7	23	28	9	13	30	10	67	10	21	17	38	7	4	15	12	27	18	8	18	16	10	8	22	32	49	23	12	22	10	29	8	28	8	39	28	37	17	7	7	33	21	24	15	16	13	19	14	7	18	26	12	2	21	59	26	41	8	15	18	23	36	15	22	12	4	10	11	9	16	17	21	27	38	14	19	9	42	21	24	8	23	14	17	15	23	31	9	36	7	7	7	17	23	19	12	20	14	20	16	29	9	17	59	23	4	18	6	19	16	9	49	6	62	11	11	17	14	18	9	16	24	21	30	17	18	30	15	15	22	20	3	31	4	16	22	16	11	7	30	22	21	2	11	3	23	44	16	12	21	45	13	8	9	19	20	18	7	22	16	15	19	36	8	36	5	3	3	22	16	13	21	7	15	10	8	4	15	9	21	8	23	14	10	21	8	21	7	8	11	11	19	13	8	27	9	29	6	11	15	14	16	14	13	11	22	18	19	34	12	20	17	12	12	20	27	2	11	6	7	13	0	14	12	10	9	17	4	17	10	25	14	21	15	2	10	11	4	2	21	8	5	3	6	30	17	18	13	3	3	6	9	22	4	13	17	4	2	44	20	5	7	19	15	18	11	4	2	6	5	19	12	4	13	14	7	11	22	6	10	20	12	4	2	5	6	14	56	13	7	8	3	3	11	7	11	12	19	4	2	6	8	11	4	12	2	12	24	11	2	12	5	21	1	1	14	4	8	21	1	6	1	3	12	1	10	19	6	4	12	4	2	11	5	11	7	10	5	5	5	1	1	9	2	5	0	6	8	3	10	7	24	22	3	1	11	1	14	6	5	5	3	0	3	2	13	4	1	3	10	6	8	11	6	14	2	3	7	2	3	1	3	3	17	0	5	4	8	1	14	2	4	1	1	6	0	14	8	3	0	2	5	3	10	2	6	3	5	0	4	0	3	2	1	24	1	4	2	17	12	22	1	5	1	14	0	2	14	2	1	6	3	4	0	7	3	7	2	4	2	3	1	2	3	5	6	0	0	9	2	1	1	0	15	2	3	1	1	8	0	0	1	1	0	23	23	7	3	0	0	2	2	1	3	6	0	0	0	1	0	0	2	7	2	1	0	0	2	2	1	5	5	0	0	1	0	0	0	1	1	1	1	0	0	0	0	1	1	1	0	0	0
ne0194	1094	801	525	539	485	434	429	314	412	475	408	323	325	343	380	289	269	311	247	232	327	307	229	272	270	265	293	263	250	281	221	224	243	209	183	254	235	239	291	232	223	235	219	263	239	208	192	226	170	237	176	252	239	212	208	198	188	185	175	205	170	156	182	175	238	196	173	228	205	190	167	214	181	170	166	296	190	175	176	146	193	125	197	210	165	155	192	212	155	170	183	123	148	145	142	199	131	145	172	164	185	162	167	132	161	180	165	143	107	162	120	135	147	131	149	116	134	141	123	122	146	130	111	113	133	166	118	149	125	123	201	137	156	110	115	107	120	144	127	143	150	110	148	121	97	148	100	129	90	153	159	117	160	142	162	104	141	185	113	154	117	137	156	164	92	155	123	93	148	130	104	121	131	167	107	116	142	102	115	100	158	122	104	131	127	144	98	99	126	97	73	143	95	156	120	153	88	105	107	165	106	124	88	110	91	113	154	131	126	84	103	119	75	102	100	128	138	145	116	156	152	79	102	103	103	102	100	118	133	137	103	85	92	102	112	120	135	157	126	96	126	85	82	76	57	125	129	109	114	85	124	90	83	95	89	90	117	112	84	82	86	118	104	113	79	98	95	100	127	89	112	95	100	109	124	64	51	91	88	83	100	103	94	63	166	50	93	100	60	84	108	113	131	65	93	107	112	91	108	67	109	79	87	82	74	83	104	96	73	63	98	69	134	72	75	48	73	153	92	108	84	101	104	98	80	100	76	77	105	99	55	82	105	50	108	59	60	99	101	126	95	74	107	99	82	84	60	85	73	83	92	70	91	74	77	85	76	96	118	68	88	35	91	71	69	68	79	85	112	70	69	77	106	65	67	57	67	83	100	58	102	110	59	69	57	91	76	84	74	62	91	78	92	78	61	64	79	83	51	75	78	87	76	100	78	55	73	59	98	76	89	87	59	64	86	56	69	97	116	53	41	47	85	85	80	91	96	76	37	55	90	59	52	62	60	67	47	41	82	49	57	92	70	83	46	59	53	51	71	72	56	45	63	74	65	64	49	63	57	78	73	68	86	47	65	86	70	47	53	51	60	70	49	42	74	52	47	47	51	48	56	54	81	64	64	39	51	67	87	34	105	81	63	33	67	65	47	79	53	65	57	64	51	66	94	64	52	41	72	82	49	65	50	54	66	57	43	65	58	75	55	73	73	66	63	45	57	59	53	99	40	54	51	66	49	57	54	35	31	33	30	62	76	61	40	43	37	49	69	75	43	32	56	49	52	43	75	72	35	44	52	66	61	51	69	54	42	49	43	51	36	28	53	59	70	96	56	33	54	64	75	36	53	34	50	67	67	35	56	46	53	54	47	59	52	45	63	59	63	44	56	55	39	66	45	38	40	77	65	38	81	41	57	38	44	71	38	39	48	70	28	89	35	39	29	42	47	38	46	62	37	48	54	50	48	54	52	36	44	27	58	35	45	56	47	41	44	34	56	61	52	59	47	52	52	65	36	69	49	42	20	54	49	39	37	36	27	41	51	25	36	46	27	73	52	45	40	54	69	53	38	31	25	51	64	46	44	62	41	47	63	33	46	39	40	52	34	70	27	40	46	35	41	42	40	37	52	29	45	18	40	30	25	53	55	47	26	34	44	31	33	25	37	64	17	46	36	53	33	45	20	34	43	47	31	40	50	37	46	41	11	38	45	31	36	52	26	29	20	29	37	31	42	27	36	36	37	40	74	34	26	29	42	40	37	34	24	40	30	25	35	51	38	27	37	41	27	25	35	35	61	32	48	27	52	30	34	25	50	40	25	18	15	79	58	46	39	37	38	28	35	44	14	32	29	31	42	42	37	19	44	43	41	41	55	51	34	28	40	29	51	31	37	19	24	43	49	24	31	19	21	36	36	29	39	29	31	20	37	33	31	24	60	31	42	37	31	20	28	18	39	23	18	41	40	27	17	10	48	71	49	22	45	34	31	51	34	54	40	20	35	21	20	47	38	29	23	43	31	26	18	42	47	38	19	28	33	42	26	34	25	15	44	31	33	40	29	37	31	29	38	41	50	15	33	53	38	32	22	32	43	26	28	34	27	33	20	32	14	31	38	30	32	18	13	22	23	20	30	13	22	15	28	32	33	17	35	21	25	30	19	21	25	28	27	19	36	28	36	39	34	19	21	26	45	33	14	24	19	30	21	20	10	22	36	21	16	16	20	70	16	18	10	20	17	34	23	40	19	22	21	38	12	29	32	30	24	15	22	15	13	27	29	28	27	23	35	16	35	20	24	34	25	29	14	19	26	20	27	28	24	32	40	24	22	28	14	22	29	17	30	22	35	22	17	16	36	27	23	11	37	24	10	28	25	15	21	22	17	26	21	10	27	17	24	13	24	16	11	14	33	11	36	30	27	23	36	17	29	25	21	43	18	28	18	36	14	30	24	12	21	15	24	29	31	14	19	42	23	10	25	28	20	20	18	20	16	21	26	13	22	19	22	18	36	25	20	23	26	17	17	21	19	16	30	14	10	35	19	27	10	25	14	38	13	22	16	24	23	11	16	24	19	28	23	30	15	11	16	20	18	16	18	10	28	8	38	18	20	22	5	17	19	15	28	15	20	17	20	24	27	33	24	23	25	13	14	20	12	23	24	26	11	16	22	19	16	23	10	14	22	19	6	10	37	10	24	15	8	26	18	15	20	21	18	15	28	11	23	8	7	14	20	30	21	16	17	14	17	24	10	19	17	23	14	15	14	22	6	40	20	19	17	17	10	9	34	14	43	9	11	22	14	21	16	30	8	22	12	8	9	21	21	14	7	33	27	15	36	10	38	20	13	11	10	8	61	9	10	12	17	12	20	8	14	65	17	19	15	15	15	17	19	13	43	17	19	9	22	13	21	20	26	9	12	6	29	13	12	8	12	6	16	26	10	24	20	24	24	16	11	18	11	18	6	13	26	9	11	18	20	20	13	11	12	16	7	9	16	17	9	38	4	9	13	15	11	12	8	10	9	17	12	22	5	11	11	6	8	8	7	19	17	14	18	20	16	7	4	13	9	8	12	12	21	6	19	19	13	8	23	18	17	30	14	8	7	11	17	4	19	16	5	11	21	11	15	18	15	9	12	14	22	8	13	8	21	16	4	18	16	12	17	9	6	4	12	17	16	14	5	4	7	19	25	18	13	13	7	13	11	15	14	2	8	9	5	7	9	18	15	19	18	7	12	8	18	18	13	4	18	8	12	8	16	11	11	8	2	11	9	9	8	2	6	17	14	9	3	6	6	21	5	4	7	7	14	6	7	12	13	5	3	4	5	11	22	12	13	9	4	14	14	9	7	3	15	12	19	8	10	9	5	11	14	5	7	14	8	7	7	9	9	13	20	4	4	57	8	2	17	8	11	7	17	7	10	14	8	16	12	16	12	14	6	6	8	8	11	6	4	12	8	17	9	7	8	10	1	11	4	6	8	14	12	3	18	7	14	12	10	8	8	12	4	8	7	9	3	2	4	12	5	28	10	5	3	5	6	8	6	4	15	6	1	3	0	14	3	1	15	9	7	4	4	5	5	5	8	6	13	1	3	3	4	5	8	5	4	8	6	9	9	14	12	3	6	19	1	16	14	14	3	9	5	22	6	5	4	2	0	8	9	2	6	2	5	1	3	8	3	8	8	9	6	3	5	9	9	10	3	8	12	6	4	2	2	1	2	2	2	0	2	3	3	4	4	4	6	20	5	6	16	8	6	6	2	4	7	4	13	3	1	6	9	3	6	6	11	5	5	1	5	3	7	3	2	5	5	14	2	1	5	8	4	3	3	1	0	3	4	18	6	4	2	4	6	2	4	2	4	7	4	0	3	1	3	1	2	3	2	2	8	3	1	5	1	3	1	6	4	1	6	0	1	1	2	7	1	2	2	1	2	15	3	1	1	3	0	6	3	2	5	1	3	2	1	5	0	4	4	1	3	1	5	1	1	1	1	3	1	0	16	2	4	3	6	1	2	1	1	0	5	3	0	0	6	4	0	1	3	3	2	5	7	0	1	0	1	2	1	7	2	1	0	1	1	1	3	4	0	0	0	3	1	2	1	5	0	0	0	0	0	1	0	1	0	1	2	0	0	1	0	0	0	1	0	1	0	0	0	0	0	0	0	0	0	0
ne0197	2260	3922	1476	1660	1358	1564	1207	1340	1068	1263	838	1072	1103	954	1292	749	1031	989	1156	950	905	858	843	800	832	724	934	927	930	1138	751	709	630	634	1118	877	626	630	648	720	591	674	660	629	580	663	459	774	840	622	582	660	634	618	517	691	621	793	536	581	667	481	685	598	634	604	548	497	524	694	470	474	561	509	478	581	416	469	544	576	537	621	409	563	503	389	578	555	421	525	627	641	429	459	376	387	379	304	409	354	561	607	520	392	479	416	465	386	512	458	513	368	421	385	446	358	333	533	495	384	401	347	700	425	352	467	572	211	320	383	419	449	449	482	487	621	448	364	341	391	298	472	413	359	397	598	355	512	379	539	389	341	481	299	330	357	514	232	351	408	470	506	326	498	496	363	410	480	389	326	583	342	359	538	268	383	492	346	360	351	376	535	310	324	280	398	333	405	381	451	336	431	263	278	318	421	397	295	391	368	387	403	375	372	431	416	324	342	384	376	262	411	443	357	270	487	335	426	370	385	444	387	459	292	530	357	409	408	322	283	431	251	417	360	401	367	329	365	302	307	357	467	260	437	207	316	364	218	295	402	175	249	361	208	245	212	205	376	357	383	327	348	289	340	318	332	312	345	322	343	226	213	303	218	206	323	258	290	480	285	252	303	272	478	278	569	362	279	237	277	354	356	349	354	371	360	272	258	274	246	419	470	342	373	259	331	244	444	263	354	333	310	306	234	288	233	230	272	154	302	283	357	239	261	174	345	236	240	333	160	267	310	291	264	318	208	375	333	296	227	264	187	335	217	268	245	208	339	337	181	203	335	313	275	230	343	223	192	259	303	245	332	238	314	326	230	294	331	316	181	326	148	259	187	174	271	269	327	276	240	216	252	211	250	438	232	252	257	231	213	211	405	290	236	160	125	228	263	319	145	362	331	232	368	258	252	197	239	281	332	245	174	202	265	217	203	233	193	198	216	207	341	240	268	191	219	279	245	294	318	247	247	146	355	180	197	273	221	238	128	178	267	187	194	252	181	154	156	227	163	277	181	140	153	272	184	234	234	271	184	211	218	227	232	205	230	121	248	306	165	162	180	209	128	318	195	249	271	194	184	188	387	181	207	181	199	199	262	253	301	182	211	323	244	215	111	185	180	222	182	192	247	244	172	248	157	294	211	244	198	141	258	218	114	137	317	194	92	165	130	128	199	233	165	186	103	208	210	330	187	198	235	179	170	183	224	107	224	241	257	211	183	168	111	190	129	177	297	246	129	211	220	252	167	284	294	178	152	120	97	147	219	168	105	133	197	157	203	207	153	118	189	170	171	85	218	132	102	138	192	196	127	146	145	232	121	93	206	231	242	153	115	179	236	134	185	154	123	172	206	145	126	206	175	79	98	140	105	134	208	132	171	167	255	215	93	177	63	145	190	154	173	237	265	192	145	177	209	130	150	133	119	130	159	154	241	119	146	167	122	192	209	185	184	128	228	134	168	213	146	193	74	169	148	49	117	200	143	170	227	131	158	86	126	229	143	179	201	99	203	80	160	149	136	104	114	117	200	84	199	116	150	183	134	129	126	155	223	114	86	159	153	131	113	213	123	77	167	131	141	95	128	139	203	195	127	134	150	140	187	156	156	211	119	214	145	126	182	127	119	177	201	178	166	177	141	202	173	56	130	171	124	240	76	90	125	72	136	128	77	159	131	97	138	127	114	120	84	140	161	128	65	155	131	172	110	123	129	125	83	126	159	183	143	75	160	206	135	97	139	93	120	121	137	60	90	188	237	155	87	151	126	190	124	109	44	72	112	120	89	150	153	168	92	153	141	130	185	196	157	87	111	80	101	110	74	90	128	93	178	94	118	94	74	62	142	54	123	138	118	154	109	97	50	90	125	98	103	56	66	127	121	66	137	85	108	172	132	144	83	149	137	111	88	117	276	86	69	107	145	94	75	128	79	105	101	196	165	125	100	127	113	140	109	118	75	89	80	80	146	102	200	201	109	181	91	163	129	101	126	120	104	56	171	126	119	81	133	73	89	123	134	144	116	115	46	114	96	104	127	158	87	149	113	160	59	116	91	127	84	72	120	90	93	111	112	97	175	151	104	144	104	58	122	112	84	66	124	112	127	112	102	95	93	99	136	92	114	106	122	84	113	122	93	64	106	134	95	63	103	103	113	121	85	64	137	68	103	145	71	82	84	89	131	126	126	86	71	65	84	92	153	125	92	92	103	67	121	114	115	143	50	130	147	132	120	90	68	60	118	86	81	100	53	51	98	122	63	40	106	63	76	135	99	91	82	47	133	63	85	69	78	45	80	66	53	82	108	78	103	129	92	118	87	89	104	38	105	78	77	92	46	118	94	70	123	59	79	55	85	77	118	118	114	99	123	76	45	103	119	70	77	104	123	56	58	101	47	60	85	85	61	70	63	135	76	44	27	81	65	75	89	94	155	50	76	83	109	57	87	70	60	62	57	111	78	45	56	92	73	87	91	52	96	92	76	76	62	46	49	119	81	95	127	31	100	96	63	60	73	108	91	87	54	87	69	99	72	53	91	80	70	57	90	47	79	55	92	86	92	42	45	41	73	54	36	39	131	52	132	109	133	39	77	32	27	85	91	94	65	82	57	72	75	61	103	65	58	65	54	58	51	57	37	88	50	57	153	57	66	51	45	79	80	70	84	90	95	76	52	65	75	107	78	37	91	42	86	91	75	71	102	81	84	127	68	101	77	110	64	98	80	67	60	47	60	69	96	105	34	55	40	72	73	92	87	45	70	40	94	120	108	62	38	40	19	32	82	92	64	59	75	73	37	54	39	70	102	31	34	55	83	85	62	53	82	53	61	30	48	60	40	75	83	96	24	45	31	80	64	54	68	63	93	76	40	116	115	44	62	87	66	29	63	73	89	65	90	70	85	26	87	38	51	53	61	87	26	42	39	49	34	53	101	61	32	46	46	73	36	72	86	19	34	69	67	56	80	43	49	88	66	32	60	35	49	97	40	37	70	73	69	50	38	41	33	53	66	55	45	38	40	50	31	38	42	37	34	51	42	72	53	66	56	50	46	61	30	28	58	25	51	69	30	105	33	17	30	43	64	39	35	39	58	64	47	32	57	34	32	64	56	37	38	52	43	27	37	69	59	66	49	46	30	22	56	54	18	40	26	47	38	23	53	27	24	44	53	54	35	56	59	29	67	40	36	51	56	36	53	24	55	41	27	37	23	48	73	77	20	51	87	46	65	50	57	35	29	48	8	33	43	62	58	42	41	41	56	29	30	29	16	55	76	30	28	36	58	25	15	24	39	49	37	83	24	22	36	48	27	83	44	38	45	56	56	36	28	28	66	46	50	44	42	50	24	17	52	34	36	27	55	21	54	16	37	11	59	30	19	36	15	57	64	33	32	33	11	52	23	50	41	46	41	31	51	50	39	42	22	22	46	20	60	21	41	40	43	24	35	16	38	36	20	30	30	10	41	42	32	19	55	40	16	22	23	13	36	12	24	19	29	17	53	23	20	28	32	30	15	16	40	14	58	90	53	36	17	31	28	10	31	29	33	20	18	18	42	15	21	30	28	34	40	35	28	33	25	32	17	27	21	27	16	38	22	23	20	26	12	17	12	15	36	12	29	35	22	12	70	25	47	25	20	14	14	31	13	27	19	42	23	27	24	34	31	31	31	29	15	6	11	19	31	16	27	38	38	12	13	14	22	12	31	16	34	37	4	26	11	13	39	7	4	9	13	8	28	16	14	40	3	13	16	17	15	13	15	34	4	24	8	38	14	18	7	20	42	13	5	20	22	16	6	17	9	17	10	38	11	13	16	6	11	18	15	21	14	20	23	17	14	6	7	6	20	9	32	48	9	2	29	11	5	9	14	21	8	10	6	12	21	7	16	10	4	13	11	30	30	13	7	8	3	12	28	34	9	21	13	24	7	1	19	24	7	1	5	0	9	4	11	11	5	10	23	7	12	21	13	20	14	6	3	7	2	3	3	10	2	7	4	2	13	33	8	16	9	12	2	5	5	2	10	9	5	2	2	8	5	3	8	2	8	2	7	3	1	8	4	2	8	4	1	8	4	5	1	6	7	5	5	1	15	2	3	6	2	1	1	0	1	4	7	2	1	1	1	2	0	7	0	0	2	8	0	1	0
ne0198	226	250	142	155	211	118	84	89	170	103	107	109	130	87	161	88	73	139	92	78	84	77	88	106	111	118	114	59	44	124	116	74	72	71	48	75	70	108	88	67	74	59	89	61	51	72	70	40	36	64	67	55	73	42	45	51	138	113	65	100	62	68	111	83	67	40	64	58	54	87	72	60	32	47	59	67	58	70	64	72	48	55	64	47	70	69	48	48	53	55	32	35	43	32	70	34	58	64	28	56	56	19	53	46	32	55	37	53	35	31	13	35	55	89	53	37	53	45	82	47	39	48	100	33	37	52	39	124	57	54	66	34	85	72	37	76	33	59	46	32	42	31	70	35	52	69	53	99	39	39	29	52	50	40	54	64	31	46	40	35	66	38	38	58	24	57	53	59	55	31	20	57	33	83	48	18	45	40	56	54	46	58	54	39	70	52	44	21	32	37	22	40	34	41	44	21	36	40	33	30	21	71	77	29	71	42	26	23	31	33	48	39	29	37	18	46	49	54	34	41	56	45	42	33	41	37	46	38	30	48	35	36	26	45	28	43	33	40	46	45	24	46	34	34	76	40	41	35	27	20	65	21	28	76	29	39	35	32	29	24	19	51	16	27	65	29	10	68	44	31	42	34	28	51	15	43	23	19	38	32	21	15	39	54	44	70	41	22	22	4	38	27	51	17	23	30	30	27	22	27	38	62	42	24	22	30	55	50	14	39	58	43	50	51	23	62	30	54	40	28	27	32	35	34	25	17	19	26	24	45	21	23	26	31	24	23	32	52	19	35	25	29	27	29	23	20	24	46	56	32	31	31	24	8	22	32	17	31	36	25	29	34	9	40	21	20	14	20	13	21	18	29	32	30	40	43	11	53	27	19	23	27	26	21	28	21	23	23	18	29	36	20	12	29	29	32	17	30	33	36	25	47	23	15	12	36	27	32	31	17	18	19	15	19	23	12	23	32	21	3	16	65	21	17	36	13	12	16	29	11	17	28	7	27	30	4	51	15	30	26	26	32	16	19	18	21	24	13	21	3	28	34	13	21	17	40	9	17	23	18	21	2	9	14	17	20	21	12	23	24	19	13	16	18	9	23	8	24	22	16	27	56	11	25	7	22	14	6	15	19	30	14	32	40	37	42	26	10	27	23	16	29	7	6	4	19	23	7	7	5	20	23	21	11	29	24	17	27	10	26	28	24	20	4	14	20	8	7	30	18	7	30	12	29	18	17	14	5	32	29	13	13	19	15	39	51	10	51	25	10	10	17	6	26	19	25	8	13	17	24	19	30	9	21	11	10	27	11	18	29	31	8	61	15	21	27	17	22	6	11	21	18	21	17	11	19	15	17	21	6	17	21	17	40	16	7	5	26	13	17	7	28	49	12	27	17	17	19	23	16	32	9	26	45	24	25	27	16	6	16	15	24	13	37	3	9	14	5	11	12	11	6	14	11	20	23	5	1	18	26	4	7	18	14	21	44	9	6	24	14	33	18	12	24	24	6	6	7	23	3	4	12	19	23	20	8	17	7	11	12	18	16	3	7	22	4	19	37	12	21	14	11	8	35	50	2	13	34	8	17	10	7	16	26	32	18	6	26	5	26	15	6	9	9	3	7	21	11	2	26	10	10	19	8	15	5	11	12	13	16	11	28	10	19	15	18	8	18	17	8	11	5	4	19	19	15	41	8	8	8	7	23	14	4	5	9	22	8	9	3	17	22	10	2	12	9	14	5	15	18	5	5	15	6	17	36	31	9	10	3	33	21	19	14	9	16	6	40	3	20	8	17	11	5	12	11	2	11	13	11	7	4	3	28	20	3	2	12	5	18	16	11	5	3	13	10	9	11	4	7	17	18	2	5	9	9	7	7	8	6	5	28	9	9	4	13	8	9	6	18	48	16	5	20	15	18	6	3	22	6	6	16	4	6	10	53	11	3	17	14	25	4	5	10	11	10	4	18	14	25	38	17	2	11	3	14	16	8	16	19	19	19	10	8	31	8	1	8	7	9	3	12	9	17	2	21	8	16	11	11	13	19	24	12	13	7	2	12	8	3	6	5	5	7	12	14	2	2	16	6	10	12	9	19	6	8	8	3	8	11	8	6	9	8	3	12	16	9	4	21	5	4	6	9	9	15	25	4	10	9	12	4	52	7	12	8	3	4	13	2	11	22	20	18	7	14	10	7	19	10	6	12	7	0	7	17	7	12	7	28	13	7	9	5	7	17	14	12	6	2	11	9	5	1	11	16	9	4	7	8	2	4	10	14	17	6	6	5	14	7	12	5	39	9	5	16	13	8	7	1	7	10	11	3	1	10	9	1	23	9	7	3	3	12	6	5	8	9	4	11	1	3	10	1	1	8	12	8	6	3	8	9	11	1	20	10	3	11	0	5	6	3	6	10	15	19	6	10	11	5	1	6	10	8	4	5	1	11	3	8	7	6	3	37	10	15	6	19	3	3	10	1	9	5	3	0	5	4	4	5	23	2	12	7	0	12	10	14	13	15	14	7	8	13	6	14	4	9	7	1	12	1	15	9	1	9	3	11	8	4	10	4	3	4	12	6	6	3	14	6	6	5	3	2	1	2	5	5	11	5	10	10	5	9	6	2	2	4	10	5	4	19	12	8	8	2	6	0	0	5	8	12	22	9	3	4	5	15	6	1	5	10	7	5	5	8	9	3	18	5	2	3	3	6	10	22	12	5	2	2	1	1	4	11	1	4	2	2	5	0	1	2	8	11	9	6	0	9	12	6	6	13	15	1	4	2	2	9	16	4	4	5	3	7	20	6	11	3	3	4	11	3	4	10	8	7	12	1	8	0	9	0	1	4	1	3	4	1	7	6	1	3	4	4	27	9	3	3	10	4	5	5	4	1	14	0	2	0	8	5	5	7	4	8	1	2	9	9	9	8	1	15	4	2	6	6	3	5	1	6	3	1	18	5	2	5	1	1	5	8	2	6	9	7	10	18	6	5	7	9	24	11	15	12	3	8	14	8	1	7	8	1	6	4	1	6	10	9	15	2	5	13	0	8	6	9	3	6	5	6	5	0	2	2	0	3	1	4	2	5	3	4	4	8	2	7	9	5	5	1	0	10	1	6	14	3	6	7	3	10	4	4	2	5	5	5	2	3	10	2	3	5	10	8	1	4	12	2	2	6	6	0	4	18	0	11	8	1	6	1	2	0	1	11	3	8	2	3	9	2	7	10	6	7	0	9	3	3	1	0	4	4	7	4	1	4	11	3	3	2	8	1	1	7	13	5	13	5	0	3	6	3	2	3	2	2	0	12	8	7	3	4	8	0	14	4	1	4	12	3	3	2	0	0	7	0	3	3	9	5	1	5	0	5	4	2	4	8	0	7	3	10	7	3	5	4	6	8	6	0	2	2	7	1	0	0	5	7	3	2	2	5	2	5	8	3	0	0	1	1	2	2	8	4	0	11	5	2	4	1	0	1	2	0	4	0	3	5	4	2	7	0	2	3	8	1	3	4	2	0	0	1	3	4	2	3	0	4	0	0	4	0	1	0	1	2	2	3	14	5	3	1	1	0	9	8	7	0	4	7	0	0	1	4	10	3	3	4	0	4	0	1	3	3	2	3	3	0	2	1	0	1	4	1	2	0	1	1	0	0	3	2	4	2	0	0	0	3	3	5	1	6	2	5	0	3	0	0	4	1	2	3	0	4	2	3	1	1	2	1	1	1	8	2	1	0	0	6	0	1	3	3	3	1	0	1	2	3	0	1	1	6	0	1	1	0	0	0	1	2	0	0	0	0	3	1	4	0	0	3	1	0	1	3	1	0	2	2	2	3	7	2	2	1	5	0	5	1	0	0	0	0	1	2	1	0	0	0	0	1	9	0	0	1	1	0	1	0	1	1	8	0	0	0	3	0	3	3	0	0	2	1	0	1	3	4	0	4	0	0	1	2	0	0	1	1	0	0	1	0	3	2	0	0	1	4	0	2	0	2	1	0	0	0	0	0	0	3	0	0	0	2	0	0	0	0	0	0	0	0	0	0	1	0	2	0	1	7	1	0	2	0	0	0	0	1	0	0	1	2	0	0	0	0	0	2	1	2	0	0	1	0	0	0	4	2	0	0	0	1	0	0	0	0	0	1	3	0	0	0	0	0	0	0	0	0	0	0
ne0200	310	581	263	121	299	151	146	128	176	159	136	101	264	143	274	122	113	144	106	139	154	103	251	78	130	92	192	160	106	273	163	65	123	94	194	160	82	118	113	125	98	106	65	69	41	73	81	82	158	127	53	109	76	47	39	178	83	169	104	75	77	104	174	100	135	45	67	80	67	115	77	88	132	145	60	123	79	102	63	81	60	64	38	52	129	70	83	75	75	73	99	97	39	56	44	61	70	71	31	26	94	36	92	33	48	85	54	57	72	21	58	30	58	39	50	65	48	80	67	40	86	32	150	53	49	83	73	33	44	58	95	75	60	116	70	149	47	112	38	50	58	63	26	48	86	99	66	48	30	90	45	51	104	68	74	105	74	41	31	11	43	75	63	85	57	61	61	107	86	30	71	75	54	122	33	89	80	31	57	94	24	89	48	59	37	66	42	79	49	51	75	86	36	60	52	39	54	46	74	33	44	72	45	36	79	29	32	55	120	25	37	71	46	45	48	134	53	148	87	89	85	27	86	41	130	73	64	60	42	41	70	33	51	91	27	66	54	78	64	42	37	89	44	90	58	82	98	36	27	53	40	37	29	29	48	25	70	69	67	50	37	77	40	69	48	39	27	78	71	73	65	76	27	56	32	57	46	15	90	36	55	28	64	76	28	71	83	20	36	38	70	32	76	24	44	52	24	39	51	31	83	15	77	51	16	63	86	130	45	39	59	45	55	28	74	60	27	170	29	27	68	79	49	79	59	80	35	18	40	17	20	24	45	23	15	12	45	46	34	52	41	19	58	23	25	44	22	39	64	36	48	49	55	40	23	26	27	38	95	50	24	44	12	57	45	20	11	59	38	12	49	46	70	13	53	47	49	43	36	43	16	32	34	24	129	37	20	38	33	33	35	51	20	63	16	39	39	19	45	33	48	29	28	27	25	43	34	40	34	37	23	44	15	20	36	41	35	38	42	13	48	85	17	35	67	19	18	21	41	31	19	53	32	30	32	7	50	17	48	25	31	55	25	20	24	42	20	39	58	10	27	22	11	28	39	51	20	21	40	37	9	10	21	32	52	22	30	12	47	18	20	35	14	9	43	15	19	17	60	18	34	7	15	41	14	36	9	18	26	97	18	37	40	45	31	39	24	16	11	31	42	34	11	10	14	28	38	33	39	13	21	41	41	18	55	82	24	47	14	13	50	51	39	32	21	29	14	11	60	12	12	105	8	35	45	34	21	18	60	51	18	34	37	13	38	10	31	17	65	22	32	40	18	8	58	53	22	19	17	28	18	41	10	10	19	13	34	7	32	31	30	33	22	17	31	49	31	10	25	17	38	21	18	28	18	8	15	75	21	19	22	27	23	58	9	39	13	10	17	42	6	23	53	6	30	64	22	24	32	23	20	20	48	27	39	22	19	21	19	45	20	32	12	52	20	27	20	14	12	26	6	14	25	33	25	41	15	5	27	30	11	40	56	17	50	17	6	13	57	15	41	13	30	25	22	14	17	6	30	12	10	12	22	26	29	13	16	57	18	23	20	17	9	15	19	9	26	39	5	45	50	7	15	66	5	16	32	7	21	21	11	7	25	9	18	17	11	70	9	46	7	14	6	19	8	6	28	16	11	18	23	37	30	6	48	18	19	18	23	39	21	53	13	33	33	36	8	45	22	12	42	12	45	19	22	20	26	16	14	16	16	17	9	11	11	10	17	10	13	14	10	34	13	11	16	12	22	18	73	20	9	11	34	9	20	37	7	34	13	8	26	19	17	17	10	13	8	23	10	20	9	12	11	5	15	6	11	19	20	15	14	10	2	11	7	9	11	43	20	26	12	13	14	6	16	10	16	18	14	3	27	18	11	37	2	11	4	23	12	8	15	14	3	3	9	11	11	29	9	5	9	26	11	20	15	39	16	6	49	4	9	12	3	12	25	4	13	8	20	48	14	5	6	10	42	14	24	20	28	5	24	8	11	34	8	14	15	21	33	35	1	35	21	17	23	27	4	12	30	11	26	26	30	24	6	31	8	28	10	18	10	32	25	27	36	2	5	12	6	18	17	20	37	9	35	10	5	19	13	12	18	15	10	8	12	18	15	12	18	16	14	26	10	7	10	14	16	65	16	36	13	7	10	10	13	39	21	7	8	17	13	3	14	5	19	20	11	10	15	8	20	12	38	8	14	37	13	30	27	36	6	18	14	8	15	22	26	20	7	2	30	8	23	12	22	17	3	8	13	12	23	16	5	7	6	31	10	7	11	23	5	10	20	11	16	15	14	2	6	13	6	10	23	6	6	39	13	11	9	8	5	13	11	13	2	12	13	8	28	9	18	3	2	15	11	15	1	9	14	12	10	10	7	12	7	6	12	14	21	11	5	7	30	12	16	16	2	1	6	23	10	10	30	6	5	19	2	17	20	15	8	4	15	2	6	15	3	22	2	6	19	10	11	3	20	23	7	20	4	11	10	6	7	4	18	7	12	4	4	8	8	14	7	11	4	11	25	7	3	9	9	3	10	13	19	23	11	14	4	4	15	11	6	17	1	16	12	9	14	8	22	13	0	4	17	13	2	8	23	14	7	13	5	9	3	2	14	10	12	20	18	18	8	3	8	5	6	18	12	6	11	8	5	19	12	12	5	1	7	3	5	7	9	8	9	8	13	9	5	11	4	6	2	10	26	15	3	5	14	6	3	4	11	14	11	12	4	5	5	0	0	1	6	11	27	14	7	1	19	2	1	14	4	4	18	7	3	15	7	11	27	13	24	3	15	0	11	9	19	22	25	19	0	4	4	8	9	12	15	4	21	12	12	14	11	6	15	7	8	4	8	6	0	7	0	22	27	5	9	7	5	1	3	14	15	43	5	1	16	4	1	17	24	7	1	2	13	8	12	8	5	5	7	20	9	12	16	6	29	10	3	9	6	10	3	10	20	5	0	5	6	9	21	9	0	5	2	5	4	0	2	8	13	9	9	8	10	6	2	8	19	3	9	4	6	9	21	13	4	19	8	7	9	2	2	1	9	14	19	3	3	13	1	4	1	9	0	3	15	19	12	1	0	3	3	8	6	6	34	3	4	7	9	15	11	11	9	8	6	2	3	6	0	6	13	4	0	16	7	10	12	10	7	1	4	2	1	10	14	14	5	6	10	3	2	8	19	8	8	4	23	0	4	11	10	3	7	2	4	2	4	2	7	9	6	5	10	2	3	1	19	12	7	2	5	9	9	6	4	5	8	4	4	3	12	2	38	0	4	2	7	5	4	12	7	6	9	22	9	3	3	12	5	1	14	5	0	20	5	11	3	10	12	1	9	2	1	23	23	6	7	2	1	7	8	0	3	4	4	14	9	3	17	3	4	4	6	17	0	2	4	45	10	9	3	4	7	11	6	1	8	1	22	1	3	0	13	1	8	6	0	9	4	7	4	4	4	1	6	0	1	0	4	8	4	23	6	9	7	0	1	1	4	0	5	2	1	3	6	7	6	0	0	4	3	3	0	4	0	2	1	2	1	6	4	1	0	3	4	1	8	2	8	5	5	16	2	0	3	1	6	1	5	1	3	3	16	2	4	7	1	1	6	2	15	1	0	7	1	0	1	2	1	2	0	2	1	1	2	7	12	3	0	2	3	1	0	1	0	1	4	5	4	1	0	3	1	1	4	16	1	7	3	2	1	2	1	0	4	2	4	1	4	0	0	5	0	6	1	1	5	0	6	3	1	1	7	0	8	8	0	14	0	1	3	1	3	1	4	3	3	1	1	3	1	0	2	0	4	1	2	0	1	1	1	0	2	0	2	0	5	0	2	0	0	3	0	2	3	2	0	20	1	2	4	0	2	1	1	0	1	4	0	4	1	3	1	1	1	2	1	3	2	0	1	0	3	0	3	1	2	4	3	0	1	0	0	2	1	1	6	0	0	9	2	1	5	0	0	0	0	1	1	5	0	0	0	0	2	4	0	0	3	1	0	2	0	0	0	0	2	1	1	0	0	0	0	2	1	0	0	0	0	0	0	1	0	0	0	5	0	2	0	0	0	2	0	3	1	0	2	5	1	1	1	0	0	0	0	1	0	2	1	0	0	1	0	0	0	0	2	2	0	0	1	1	0	1	1	0	0	1	0	0	0	1	1	0	0	0	0	0	0	0	1	0	0	0
ne0201	1904	3255	1356	1701	1565	898	1153	755	1197	1361	1056	771	906	726	947	879	782	684	853	660	820	825	835	718	617	780	837	588	844	900	631	743	464	516	845	602	575	495	667	760	648	441	897	442	579	529	479	367	803	557	490	460	650	589	554	551	516	498	516	613	514	548	701	723	415	366	570	620	454	473	580	477	475	574	632	592	587	407	387	592	439	548	465	495	559	373	403	394	752	308	554	476	402	495	500	489	437	521	500	481	423	469	432	383	372	300	290	442	362	444	400	412	361	532	382	335	319	503	402	326	462	321	469	346	338	474	291	582	298	348	330	334	320	396	401	538	520	494	337	347	380	341	517	278	521	373	384	401	357	246	287	269	228	223	314	504	342	277	298	358	398	286	348	283	350	318	287	530	353	562	622	312	330	339	279	287	347	327	296	208	337	499	302	360	317	337	314	347	299	256	786	263	440	271	248	265	354	284	427	309	221	357	500	370	382	298	333	166	390	291	277	405	477	216	569	473	242	375	287	330	374	481	272	178	365	474	223	342	214	252	381	168	303	421	330	431	421	350	245	230	432	354	362	463	493	166	238	200	317	345	181	394	279	290	353	250	303	299	335	274	253	240	201	147	274	254	138	241	241	268	338	239	261	154	268	241	396	244	344	275	245	264	334	311	268	366	266	295	282	179	307	220	292	199	260	208	373	316	167	206	296	230	256	170	225	428	325	378	264	297	373	235	289	243	205	363	163	350	333	263	298	221	151	211	253	194	193	239	295	242	260	241	162	226	232	190	220	267	285	218	236	176	360	197	199	199	173	228	223	180	161	203	221	300	212	179	207	271	366	270	205	228	247	246	287	301	234	201	207	118	244	246	205	159	198	291	267	140	204	188	260	209	141	214	605	248	200	229	129	197	163	284	203	298	170	141	203	172	255	178	207	261	242	141	216	239	239	283	166	246	195	227	232	209	180	264	183	253	235	155	137	208	188	169	134	192	161	209	220	165	268	264	237	179	212	127	321	176	168	162	139	305	181	105	198	144	293	244	192	286	181	247	213	100	152	156	186	119	175	152	117	230	191	202	163	145	103	208	156	202	218	124	146	178	171	132	182	216	194	218	156	216	157	177	167	197	234	260	166	225	142	118	162	272	214	140	238	279	123	152	202	170	233	186	139	220	227	121	136	165	192	238	141	123	87	191	101	185	168	121	126	162	205	221	185	116	191	146	178	144	178	178	241	143	236	109	124	144	176	238	175	253	206	113	224	262	274	134	168	218	186	189	148	84	148	163	172	142	148	129	133	247	147	84	147	152	103	151	124	136	138	222	137	167	75	121	475	125	190	220	176	65	101	95	140	155	201	175	166	145	114	72	154	157	113	278	143	73	121	86	112	121	145	120	60	149	149	127	101	184	114	91	132	162	125	103	219	72	161	143	194	129	123	172	224	161	101	100	151	122	103	145	120	132	129	179	124	180	198	153	144	192	210	140	175	103	177	193	172	117	189	127	118	122	84	126	117	106	166	131	136	190	127	71	126	150	113	184	160	104	156	123	118	85	106	136	139	115	167	105	178	114	76	159	125	148	112	136	130	127	110	88	168	126	124	74	77	114	67	132	123	110	84	250	69	149	135	108	99	136	112	117	177	88	138	118	67	93	61	133	80	116	110	124	106	117	105	118	58	97	124	86	195	119	115	167	130	174	76	110	107	98	105	155	146	108	128	112	119	104	103	48	112	119	188	79	157	170	124	109	86	72	103	117	92	118	239	232	98	80	112	69	120	105	75	90	109	217	145	100	109	81	106	122	56	160	145	53	97	148	109	54	141	112	114	105	116	138	76	108	145	46	132	129	40	48	74	153	122	70	103	95	59	88	74	81	73	115	129	55	52	90	129	96	88	128	76	93	82	83	178	64	166	368	82	56	64	103	140	41	89	140	67	37	89	65	143	64	86	111	158	70	70	121	132	82	141	68	110	64	137	95	69	57	136	72	67	56	149	89	92	94	140	107	153	85	48	57	88	96	101	65	67	154	66	82	141	102	113	52	63	99	82	86	81	43	96	89	69	63	131	49	78	53	85	78	263	69	58	289	100	123	150	84	99	105	86	100	70	63	136	117	162	104	76	89	55	78	72	94	134	73	56	109	196	89	65	88	85	77	63	128	77	121	70	64	103	136	79	68	75	107	100	64	56	146	72	247	81	42	88	98	108	87	99	99	42	109	73	37	86	81	75	54	65	76	26	121	111	109	90	114	67	67	54	60	74	69	108	87	98	92	84	59	40	50	81	25	91	52	66	72	46	93	46	90	76	89	67	32	63	65	84	72	108	47	101	56	68	61	69	66	36	76	55	28	122	95	73	56	61	39	70	61	47	79	39	50	65	42	78	64	37	68	41	154	126	55	48	77	58	95	70	77	35	55	97	43	59	53	37	94	92	47	56	55	48	72	103	63	107	55	97	100	75	87	85	47	79	72	95	43	155	109	52	39	104	111	82	120	67	63	54	49	65	77	53	78	22	82	50	98	184	74	59	81	77	81	26	60	110	54	49	71	40	64	34	53	56	75	82	55	76	71	40	64	41	78	84	109	66	21	105	60	42	52	96	89	47	60	60	80	66	102	50	87	46	48	47	62	24	83	45	45	32	43	32	33	76	60	73	50	48	44	54	34	56	83	75	70	54	65	53	43	81	66	64	45	74	84	45	70	25	70	47	41	82	56	93	39	26	53	21	40	39	83	40	52	55	96	65	46	49	90	69	52	54	66	46	41	56	62	71	79	51	21	87	86	52	53	59	47	56	43	88	31	71	44	44	74	37	43	77	62	118	31	43	81	58	55	44	37	25	22	56	24	47	46	87	79	64	85	71	58	26	66	21	17	65	80	51	27	47	52	39	79	38	68	30	83	67	44	39	43	45	62	25	32	47	36	31	50	48	76	61	71	41	42	56	24	28	67	40	84	26	68	65	53	60	37	78	54	63	16	36	21	35	24	86	57	68	26	55	42	15	103	36	44	37	57	43	30	42	37	32	28	63	59	38	84	61	39	61	67	22	31	35	36	50	49	79	46	51	32	74	42	44	21	46	40	26	50	54	34	42	33	172	54	64	26	23	17	55	68	44	35	23	35	61	35	79	15	29	33	29	68	27	56	23	55	51	48	58	33	10	18	44	65	39	36	67	52	34	40	28	30	56	33	24	19	58	67	56	50	184	19	29	61	55	62	43	46	66	21	42	31	66	35	80	49	38	58	28	24	23	76	21	62	23	44	24	24	42	17	50	29	20	31	28	70	50	49	34	57	31	42	41	27	29	44	52	35	30	40	44	26	32	46	44	19	46	27	42	169	15	36	21	57	23	20	14	21	44	20	52	54	19	62	33	43	12	25	34	49	45	44	54	35	17	40	149	32	22	63	166	47	18	33	26	38	61	49	14	49	39	17	22	17	60	26	30	46	34	62	24	50	25	34	41	32	28	30	25	16	68	24	23	21	48	29	42	46	21	39	27	27	33	34	14	60	16	57	38	34	18	19	23	12	47	18	94	70	33	16	37	23	34	24	36	16	52	28	25	13	22	20	27	20	15	16	27	48	22	43	67	20	26	32	28	10	9	12	13	36	16	16	30	28	20	18	21	53	26	16	17	17	14	39	18	30	14	49	19	35	16	26	18	8	6	22	12	19	8	15	19	17	9	14	37	21	21	16	32	8	16	24	14	23	50	42	19	23	13	30	16	26	35	18	32	17	12	7	7	25	19	15	7	12	12	19	21	9	11	8	7	18	7	36	9	8	10	11	1	28	5	15	16	26	13	8	16	11	9	10	17	113	10	9	22	8	21	23	8	8	20	19	14	11	9	14	12	9	12	26	5	9	10	22	21	9	10	17	7	18	13	11	7	9	15	10	9	15	5	8	47	1	24	14	8	41	16	7	4	13	9	11	3	8	12	7	27	8	11	5	26	9	11	20	8	6	5	9	8	12	3	6	8	6	7	12	16	8	8	10	10	1	7	4	8	6	17	13	24	17	15	20	3	9	5	10	20	7	9	14	7	33	1	3	3	8	7	12	12	4	4	3	3	4	8	5	3	0	8	4	7	9	0	2	2	6	5	1	3	2	15	2	6	0	1	56	0	1	0	2	2	0	5	22	9	3	6	3	6	0	1	0	0	2
ne0202	2574	4477	2378	1835	2021	1559	1519	1037	1362	1150	1232	1272	1519	1276	1702	1243	1149	1100	1162	1215	1120	892	1422	864	992	1030	1385	967	845	1931	1009	672	765	813	1287	1066	1020	812	850	899	878	824	793	548	769	965	691	623	1141	905	686	723	941	892	414	1082	802	958	756	879	695	843	922	799	756	442	682	619	763	737	703	792	878	810	778	872	646	577	474	725	671	548	617	472	918	677	500	678	687	495	725	836	554	482	720	584	601	571	515	443	566	585	692	642	494	535	477	596	709	352	414	302	705	511	529	580	563	717	569	505	657	501	944	359	516	606	449	580	524	514	664	526	541	685	675	796	527	450	465	488	496	431	410	461	706	496	589	633	343	562	419	395	407	415	412	708	478	415	469	580	443	461	615	505	631	446	498	865	532	700	671	482	451	649	445	602	507	492	426	449	560	674	477	322	575	493	602	496	493	382	577	371	428	487	430	344	407	487	521	278	325	489	560	448	683	350	363	346	707	257	443	434	415	371	673	819	363	715	538	439	629	567	405	204	796	585	506	551	319	348	501	246	398	503	327	632	516	461	435	326	394	592	536	867	365	357	472	269	386	547	378	314	434	400	544	397	357	450	410	374	314	468	236	332	366	526	197	516	410	480	393	486	263	354	301	381	380	268	492	306	420	330	360	614	371	661	486	397	401	250	419	267	493	293	609	335	345	293	345	339	485	588	428	307	189	511	502	735	238	271	549	396	435	308	458	295	179	736	323	427	431	447	286	582	351	772	304	272	261	275	250	260	219	400	270	167	319	580	252	295	312	142	499	394	282	368	188	425	342	366	278	326	306	358	307	180	349	255	559	361	332	464	287	341	363	245	221	449	363	124	334	260	296	194	321	534	254	378	296	300	413	321	301	241	721	245	242	345	248	251	350	448	196	597	327	285	249	287	402	288	463	425	192	204	285	248	294	538	225	348	251	237	266	196	240	167	233	325	285	150	253	343	181	307	468	142	158	284	343	197	254	333	263	296	272	129	295	204	282	247	217	511	272	195	272	223	256	237	396	147	301	358	180	225	244	282	316	181	251	344	151	142	237	270	260	179	293	206	271	218	363	189	132	261	433	148	213	251	222	274	265	288	230	244	115	232	134	245	277	427	174	213	251	286	299	252	222	193	179	324	247	180	155	199	233	182	185	169	266	142	167	416	185	165	251	518	237	316	198	178	255	202	377	300	188	296	262	192	304	136	176	526	154	184	409	214	163	259	369	310	162	210	291	130	236	189	414	319	412	132	223	261	129	172	332	272	160	177	148	245	173	361	173	144	174	139	218	96	211	223	214	136	242	200	187	647	157	165	250	231	263	158	178	177	171	229	148	344	277	234	186	220	183	321	106	266	102	177	257	139	113	202	233	277	189	322	256	186	116	424	193	227	229	249	224	154	180	156	220	218	303	222	93	387	279	192	196	220	180	140	162	137	185	280	186	218	122	134	182	183	211	268	386	173	234	138	271	272	303	168	297	137	166	177	155	177	115	122	362	143	148	144	145	182	258	152	198	238	172	139	159	165	125	118	176	79	144	173	103	225	171	120	161	222	261	173	601	175	161	127	142	107	170	145	232	78	130	351	135	195	142	150	135	209	129	93	166	169	120	290	179	192	271	140	169	127	176	200	110	261	136	207	100	197	224	192	81	497	150	135	274	102	257	218	176	170	144	123	187	191	183	143	152	118	125	130	141	140	145	137	138	164	152	142	159	136	141	170	282	152	112	115	129	124	127	191	266	204	111	97	163	115	260	87	196	139	93	242	98	115	142	112	149	103	75	136	68	140	126	210	167	173	106	139	147	120	106	201	90	234	125	124	147	111	125	66	101	232	67	136	387	157	59	77	120	121	62	97	184	235	144	136	126	101	56	171	86	140	152	145	151	116	87	242	100	118	123	97	198	94	103	122	86	69	199	182	150	140	119	190	163	70	114	101	190	96	179	133	158	106	192	98	115	232	96	104	89	89	142	195	151	153	283	109	226	202	45	89	128	87	172	63	173	151	77	133	161	182	107	108	86	148	121	148	149	52	104	114	72	46	223	74	221	100	183	138	221	106	72	138	108	127	132	120	117	104	132	100	117	103	159	101	87	70	88	118	100	299	132	154	169	78	89	105	117	561	171	115	128	143	85	85	119	86	200	122	136	178	100	126	155	105	127	86	66	263	157	221	271	115	52	192	91	130	138	107	94	112	99	111	182	102	88	147	106	68	54	81	179	220	161	91	119	73	98	99	78	70	74	109	82	100	130	86	67	104	132	57	111	96	94	76	182	111	61	134	100	113	86	55	44	69	98	94	60	87	86	67	130	103	172	58	56	161	72	79	46	132	85	71	54	110	135	95	55	102	68	240	157	69	102	77	105	87	117	173	75	104	89	121	49	147	111	102	78	70	80	82	90	103	39	68	84	42	94	192	109	97	107	79	72	89	156	78	85	92	58	53	95	69	109	111	131	64	62	54	146	68	65	78	107	73	81	85	59	79	94	87	50	101	75	62	119	125	82	127	122	112	61	50	101	57	81	96	36	77	69	63	86	108	159	87	37	77	220	46	52	114	108	100	67	92	95	43	32	167	74	65	76	86	166	97	95	68	66	53	94	85	74	43	108	89	79	98	17	81	83	51	52	38	57	69	82	56	41	66	237	50	60	75	59	63	96	62	115	53	59	63	65	145	34	84	81	106	77	112	71	112	122	47	22	50	90	102	77	127	73	26	153	64	32	101	58	71	53	82	26	116	130	88	108	83	111	36	77	20	70	99	70	69	91	135	36	48	48	71	54	110	59	56	82	76	114	81	89	59	99	94	88	157	87	51	30	67	42	53	125	24	46	90	54	62	58	43	127	107	71	19	58	74	69	63	72	79	88	36	68	57	102	109	113	44	64	86	64	68	46	88	95	48	85	93	46	110	58	128	61	54	57	33	96	31	121	154	41	31	43	75	87	54	91	62	92	40	44	78	84	48	100	102	178	60	113	49	71	80	85	96	35	185	62	37	65	36	72	37	89	53	122	124	94	57	46	44	53	10	77	57	69	85	88	81	31	30	57	48	36	53	31	44	36	103	36	100	94	37	155	46	39	30	76	54	59	80	112	66	27	75	59	62	107	44	43	40	43	41	49	68	42	40	38	55	133	78	21	51	80	26	42	28	77	50	48	74	20	48	78	32	20	38	63	85	65	75	53	50	74	42	58	53	49	111	45	41	34	73	85	55	89	39	81	41	65	87	50	91	62	41	33	19	51	28	48	38	71	25	34	70	84	36	36	30	32	56	33	39	54	61	90	31	54	46	29	20	69	26	33	76	61	35	50	20	8	63	53	23	14	41	35	58	35	43	25	52	115	81	34	94	61	77	32	64	62	45	21	38	51	44	62	44	104	13	53	53	64	19	52	22	53	31	61	38	51	58	29	39	21	27	100	21	71	44	26	123	67	69	29	42	37	24	19	27	43	14	46	38	43	70	108	27	20	41	26	26	44	58	70	39	20	56	13	25	23	32	19	24	26	11	41	21	66	20	26	23	41	23	62	20	46	20	15	36	19	25	15	44	37	43	21	29	29	34	48	38	61	32	23	34	18	10	12	27	47	21	23	22	47	25	24	36	29	32	10	39	21	30	20	25	16	27	14	47	18	21	20	113	17	15	55	42	13	15	20	34	10	48	26	21	33	10	16	13	36	20	29	24	22	49	20	28	15	39	48	23	8	38	42	5	33	17	9	20	11	12	15	13	19	42	28	21	8	16	17	5	19	14	20	19	20	14	13	14	11	19	20	10	18	49	7	10	27	24	21	10	20	42	27	8	31	15	9	28	20	19	14	10	25	21	21	17	9	12	16	18	16	25	19	34	20	12	15	40	39	12	33	11	17	16	9	10	18	17	17	7	20	4	64	26	16	50	18	6	11	11	17	13	14	10	34	7	23	14	18	29	23	4	12	18	8	26	9	13	12	8	9	26	5	10	13	16	20	8	6	4	1	6	21	10	14	5	3	1	7	10	10	5	2	9	3	30	51	1	0	3	5	6	6	7	9	11	4	6	17	13	4	8	5	2	12	5	5	8	6	5	5	2	1	22	3	6	9	7	5	4	11	0	11	3	0	2	1	1	1	3	0	1	3	3	1	0	4	2	1	1	4	3	0	0
ne0205	2344	2910	1535	1357	1843	1337	1361	1144	1234	882	1292	1182	1172	1051	1001	1004	927	1078	912	946	954	934	912	727	856	802	909	830	730	1071	774	769	761	761	704	755	642	863	674	681	711	649	585	543	636	633	615	557	614	646	637	644	567	584	513	866	705	837	519	569	609	661	688	616	594	566	619	641	600	683	392	580	633	541	638	1003	577	581	493	525	476	561	727	496	812	565	504	512	364	433	473	468	674	417	478	438	532	404	459	360	499	457	510	505	410	504	439	491	487	382	424	425	493	498	484	317	519	499	499	481	433	450	639	405	420	557	487	383	469	466	626	433	460	455	517	600	411	395	423	368	365	432	316	407	403	495	479	450	376	407	334	378	522	352	433	537	433	454	430	404	405	457	366	461	372	461	378	480	494	345	422	487	348	487	422	324	502	410	438	398	477	368	422	332	365	425	410	353	333	401	323	410	298	356	364	332	325	414	400	374	312	403	286	293	433	382	322	324	450	364	384	527	406	353	324	418	323	561	410	398	541	246	505	307	417	459	381	306	370	408	385	296	383	375	362	278	532	412	395	320	521	392	264	383	387	347	428	279	393	324	307	276	255	401	318	345	283	376	301	356	269	331	222	284	242	252	248	382	303	337	317	311	276	263	332	274	288	302	310	292	392	245	317	405	284	412	371	259	385	256	373	260	431	253	297	297	342	292	336	253	487	259	351	264	234	269	319	443	214	382	542	223	343	282	298	286	313	342	229	265	334	292	260	417	272	269	280	298	256	362	293	303	261	185	249	222	367	367	247	272	237	261	253	348	260	283	249	314	208	281	244	289	325	192	206	296	249	310	305	225	309	275	178	302	247	280	205	309	252	213	280	272	254	183	275	358	238	245	213	241	252	284	266	217	317	248	273	274	185	241	318	294	219	206	195	218	264	241	233	228	221	285	204	200	246	310	265	228	261	283	255	206	187	229	185	186	193	323	225	181	236	335	222	226	267	193	169	238	238	203	213	272	240	251	237	176	278	207	242	209	228	202	201	214	192	209	264	178	238	126	189	184	149	178	255	189	169	209	200	219	165	137	217	259	244	167	228	217	256	210	247	203	215	78	195	223	169	192	234	211	254	163	173	241	162	284	160	158	233	276	153	188	265	330	276	225	243	165	180	244	206	217	151	162	174	194	188	174	170	139	192	210	172	168	172	267	154	233	192	196	186	255	266	140	194	158	215	169	240	127	151	244	287	186	203	166	168	188	232	184	152	235	231	201	319	168	182	193	252	184	168	161	142	151	206	184	127	184	196	159	188	200	140	193	221	158	210	127	189	169	121	135	234	179	160	193	154	140	208	119	231	136	150	182	162	146	178	216	166	192	183	167	198	213	117	130	131	173	146	139	120	178	206	170	160	223	175	206	208	205	225	122	224	168	185	232	166	139	171	195	182	220	149	237	134	179	170	108	211	118	161	134	180	124	173	185	111	139	153	164	147	121	184	113	218	149	122	109	181	137	169	178	155	158	136	128	125	123	172	102	102	117	175	210	150	96	182	140	151	116	93	181	130	159	138	108	133	194	108	163	191	127	181	196	150	164	179	150	143	132	132	125	130	154	180	167	95	137	180	222	134	147	156	125	121	101	122	165	126	186	143	189	149	132	177	163	112	136	88	83	125	207	108	171	178	127	113	122	124	125	186	167	101	120	122	161	201	112	121	179	130	116	142	110	117	86	102	120	152	119	199	120	107	94	291	101	141	92	111	154	81	133	114	65	167	198	69	164	221	86	168	145	110	113	94	104	91	96	72	108	169	108	112	116	134	145	75	98	109	139	265	110	96	130	140	100	124	101	89	153	144	137	200	160	88	102	107	144	104	50	158	169	96	51	118	60	79	105	115	123	55	82	150	137	102	99	74	126	123	57	116	135	138	155	125	109	92	105	129	102	96	93	116	91	104	109	66	120	120	182	112	82	108	119	156	107	99	102	136	87	150	99	58	129	94	146	110	88	156	143	98	176	99	108	95	130	60	94	92	81	63	98	100	101	82	139	155	189	91	120	103	119	117	109	123	107	92	100	112	75	158	112	96	102	85	113	127	136	102	112	105	110	113	87	111	51	95	88	107	115	76	107	69	91	91	137	90	196	97	143	88	91	60	38	102	90	104	69	122	124	96	80	93	72	79	105	64	91	134	93	107	119	154	102	75	126	83	135	66	179	107	62	91	113	91	105	92	80	97	108	92	88	75	98	127	79	60	106	97	71	81	89	76	72	105	110	88	117	95	74	61	90	57	98	113	69	48	89	137	95	91	87	124	60	80	116	117	87	83	70	69	125	80	90	66	109	152	102	160	93	79	70	55	153	83	94	75	102	63	81	110	70	91	83	93	68	71	91	55	75	117	74	127	68	104	138	114	67	99	78	47	67	97	70	73	153	22	118	81	84	68	90	97	55	64	53	66	99	61	87	57	103	83	85	117	67	85	86	60	90	167	67	99	57	138	66	198	33	62	72	81	64	79	84	55	84	93	132	62	54	90	70	81	56	94	84	77	95	41	63	100	65	107	108	52	87	72	65	91	61	118	80	56	64	92	84	60	46	79	71	39	84	66	61	54	67	60	70	85	83	121	50	63	95	77	77	62	78	95	89	43	67	93	80	73	71	32	72	50	52	90	64	113	176	56	79	86	34	82	43	74	74	63	49	78	64	62	72	102	52	55	46	43	65	58	78	81	57	74	82	44	32	48	78	72	81	43	33	79	65	50	42	183	111	102	69	54	157	80	74	62	94	93	28	65	28	40	74	70	57	53	67	48	39	68	91	55	64	90	66	41	75	72	93	58	62	44	39	76	55	77	51	70	68	49	63	37	53	60	69	53	74	61	37	77	73	53	66	60	43	59	53	78	24	69	77	75	51	51	41	76	64	42	72	49	46	58	53	135	48	54	73	58	63	66	91	42	65	35	54	79	21	77	55	85	25	38	38	179	65	44	57	92	60	76	73	41	68	26	67	107	64	71	86	61	48	99	43	61	62	49	40	70	87	76	67	67	49	62	41	87	47	39	63	45	59	97	61	47	56	39	22	39	45	42	46	62	30	34	77	41	39	53	60	34	55	54	36	52	78	58	43	51	60	68	54	34	30	51	62	76	56	108	33	41	52	41	38	34	46	23	51	59	60	17	25	63	44	67	40	73	56	36	51	26	70	60	33	41	31	44	24	42	76	19	55	52	37	39	51	44	74	24	38	37	52	26	36	36	33	26	40	54	50	45	28	38	48	27	42	43	33	47	18	77	40	54	43	36	43	43	38	44	48	42	59	31	26	65	73	34	68	22	24	41	50	25	22	51	32	36	49	21	37	29	54	24	27	45	40	44	21	31	31	57	25	34	18	26	49	41	41	41	41	47	47	71	27	27	36	41	30	50	18	24	26	37	21	38	46	26	72	17	32	71	18	29	36	37	36	40	36	57	19	29	61	39	21	38	23	36	23	33	29	27	23	48	27	47	38	30	31	25	21	39	23	63	38	24	41	19	44	27	14	190	32	30	30	14	23	38	48	18	31	45	21	37	37	68	26	23	33	24	15	44	16	30	26	33	37	18	21	21	19	69	14	21	39	9	11	14	24	51	31	27	32	34	27	19	21	35	26	19	30	22	17	27	32	21	24	47	17	26	20	22	10	21	10	21	31	26	28	10	23	12	56	32	33	14	23	29	16	18	20	8	27	16	26	16	16	24	17	33	22	19	13	22	13	16	10	18	21	17	26	17	17	27	39	16	20	32	18	25	23	16	11	22	27	26	24	23	33	5	23	33	23	16	20	19	22	29	19	63	18	10	6	7	15	31	9	21	11	18	28	15	33	3	22	37	15	4	12	11	35	18	27	16	11	12	10	10	12	13	8	12	8	13	18	9	11	6	13	15	7	8	7	9	37	16	3	18	20	20	15	22	12	14	13	14	11	16	12	10	12	21	27	15	15	9	10	4	14	4	4	15	18	37	10	9	19	2	8	3	12	7	6	4	7	18	5	4	16	4	24	7	7	19	5	18	7	5	6	4	5	6	8	11	5	1	8	5	17	3	16	3	10	5	6	15	7	10	3	7	81	6	4	0	1	3	14	5	0	47	3	7	6	4	9	1	1	2	3	1	0	8	10	1	1	4	0	6	2	7	0	2	0	0	0
ne0206	2269	1908	1178	1166	1102	1005	948	787	765	750	834	767	804	684	761	646	667	635	764	689	633	627	588	674	549	547	673	546	627	721	485	541	507	529	549	511	505	498	556	478	532	416	402	503	428	481	480	415	489	410	493	450	442	432	387	474	462	432	445	458	447	423	416	360	417	380	471	496	392	444	338	388	429	353	367	599	411	374	362	324	369	344	454	367	442	380	323	362	326	356	338	353	370	310	264	327	356	335	357	323	383	402	348	377	353	329	325	373	299	375	331	296	377	347	355	316	341	358	221	385	294	360	288	306	269	389	284	290	338	336	360	309	291	285	267	252	290	220	333	221	258	288	258	239	193	336	300	239	242	276	283	264	299	249	285	244	284	277	316	337	295	280	268	332	243	245	245	281	301	349	304	259	266	304	319	244	284	310	215	197	341	327	269	189	290	270	276	212	255	221	186	186	207	272	269	314	187	301	220	281	234	242	200	279	212	256	236	218	325	226	293	293	214	230	231	279	262	301	190	266	352	261	232	189	300	315	243	314	284	230	225	205	283	219	241	290	274	233	248	219	279	210	202	219	178	184	264	210	213	208	218	193	183	189	210	266	213	212	244	257	229	241	195	139	180	252	186	264	192	225	222	184	208	200	225	181	170	199	254	199	193	187	210	185	256	144	226	262	179	196	220	196	259	160	167	173	224	168	186	167	213	309	157	164	187	210	218	258	128	186	198	161	212	181	174	132	180	217	255	221	185	216	175	242	153	213	188	178	195	168	160	204	169	329	209	162	221	226	182	208	187	172	221	212	195	162	155	211	154	182	178	145	177	151	144	205	184	151	205	139	176	134	232	194	145	162	225	179	169	160	147	157	166	135	178	150	113	156	189	142	169	185	173	188	226	161	178	147	145	174	185	118	171	164	189	142	190	186	101	192	151	235	187	123	184	200	156	132	201	161	154	115	141	167	105	107	143	177	188	112	137	132	186	153	170	110	163	171	122	145	209	137	154	162	131	144	131	100	169	132	112	136	147	129	114	133	130	97	188	120	129	160	124	151	151	132	102	144	99	144	125	128	184	119	133	131	165	208	104	98	87	107	118	111	99	142	121	183	112	102	147	210	138	127	138	123	140	185	190	179	186	148	154	89	152	115	142	112	110	137	119	157	117	164	171	132	103	130	125	129	136	149	140	143	122	179	113	105	150	117	110	150	126	151	167	107	101	103	141	120	112	149	133	125	112	121	140	120	101	128	85	131	133	105	136	181	93	155	119	120	115	101	131	117	137	114	113	111	83	95	106	134	111	138	116	127	119	125	112	143	136	58	138	106	106	143	162	152	117	113	128	143	120	78	127	111	137	128	115	117	95	91	138	121	124	90	111	106	132	90	97	97	125	120	105	136	80	143	130	87	150	119	123	95	118	131	129	90	92	135	95	145	78	135	86	106	127	92	107	93	102	125	89	88	100	132	73	113	72	109	95	71	96	109	76	79	113	85	111	92	114	108	112	78	92	84	88	132	145	115	88	143	103	82	103	60	106	88	117	72	84	101	81	131	101	76	96	106	105	95	92	79	85	96	156	70	85	123	89	76	95	77	117	88	93	80	77	110	88	73	109	78	108	100	91	122	82	89	93	107	79	80	117	64	120	90	65	71	99	85	72	71	96	99	80	76	63	54	77	78	83	84	95	90	62	94	113	116	102	87	55	63	103	76	57	66	79	50	80	91	127	78	76	86	106	94	100	76	82	64	68	92	71	80	54	76	81	98	99	80	75	99	91	78	80	70	107	74	115	88	118	47	78	95	84	83	77	58	75	85	79	74	63	85	117	71	99	77	63	77	91	71	81	100	64	82	102	86	58	75	95	106	52	69	90	66	65	92	88	89	63	60	89	64	68	77	64	38	55	44	65	71	94	80	70	68	66	89	64	71	64	60	99	49	72	147	90	61	72	71	47	77	55	90	84	75	72	76	75	106	82	72	67	53	102	85	69	67	96	65	67	58	64	89	85	71	75	52	58	67	45	48	60	79	67	71	60	84	48	60	47	65	53	75	70	58	64	97	53	60	65	62	76	51	51	60	99	77	90	73	41	63	98	61	56	42	59	62	71	56	90	88	47	65	60	85	61	87	37	43	62	61	37	53	43	70	52	40	47	61	42	42	65	67	54	52	56	55	73	66	76	46	62	53	55	86	71	60	39	42	66	38	67	51	59	66	35	60	67	114	75	49	94	36	59	42	63	54	67	54	51	42	76	59	43	73	45	65	57	43	52	72	44	51	54	55	51	55	65	52	56	78	49	43	40	94	51	63	62	91	49	73	54	48	70	52	52	50	61	66	46	53	42	65	48	65	62	53	54	46	37	51	59	61	63	45	51	73	37	63	63	35	56	45	52	46	61	27	42	49	48	55	67	68	53	66	66	42	52	45	18	52	48	47	29	41	60	51	45	34	50	55	80	55	69	66	45	41	48	38	47	57	31	53	42	44	71	23	53	47	48	50	38	31	44	53	37	53	46	54	39	52	64	50	32	55	37	50	32	69	34	62	26	69	49	43	45	38	64	46	32	54	34	44	75	53	57	44	33	44	38	30	44	23	29	40	32	46	27	53	48	77	29	67	48	59	43	24	37	57	38	44	35	55	31	38	44	39	28	34	54	49	39	35	33	35	65	34	42	31	41	34	35	38	46	56	54	16	37	43	63	31	40	33	43	28	23	43	45	62	33	28	41	45	44	51	46	42	38	43	49	38	46	39	55	30	35	46	17	40	42	42	42	29	43	39	29	30	65	38	37	26	29	42	35	21	34	40	27	40	26	37	44	36	22	46	28	69	36	34	39	34	23	34	49	27	35	32	40	40	33	32	38	21	36	45	24	37	42	30	43	31	46	31	77	52	40	40	41	37	42	49	40	45	21	36	34	32	46	28	24	34	35	59	34	24	27	32	43	30	51	51	26	17	49	35	39	58	41	35	29	41	33	30	49	34	28	35	29	34	44	83	33	41	23	28	53	15	27	22	23	35	31	45	35	36	33	20	33	28	17	33	41	18	23	37	57	42	29	36	24	42	24	14	45	33	37	34	21	38	29	31	26	40	29	29	40	20	18	28	24	43	21	25	51	46	26	35	34	49	43	27	24	14	33	35	34	20	19	27	15	21	25	18	24	26	35	39	33	22	41	21	22	29	28	144	25	23	19	25	29	33	19	30	22	31	36	29	36	36	30	35	29	28	26	24	19	36	24	23	21	24	27	9	27	19	20	51	11	46	29	28	31	17	36	21	41	19	25	13	29	42	13	25	23	24	29	26	11	51	48	17	13	26	23	23	30	31	35	26	22	18	22	30	19	24	28	19	21	28	30	14	19	28	25	22	11	38	10	15	17	32	24	22	16	18	12	32	17	17	11	16	19	19	23	20	15	24	20	34	17	14	16	17	19	22	3	30	24	23	17	25	15	13	25	13	15	24	18	16	20	27	19	33	17	15	23	22	21	19	7	17	16	16	10	15	16	38	23	19	16	14	29	21	14	11	13	11	19	15	20	14	15	14	9	16	10	19	18	16	17	23	10	12	16	15	27	21	19	14	18	12	14	23	14	10	17	17	9	24	16	11	29	20	22	14	9	20	12	18	21	7	12	13	13	18	27	12	19	12	19	17	13	11	4	10	11	12	9	21	17	13	10	17	8	5	24	11	11	8	9	25	13	8	9	12	2	11	14	4	14	9	4	6	19	8	14	9	15	21	10	7	11	15	16	11	8	9	16	20	17	9	6	6	7	11	18	29	9	8	7	12	7	8	16	5	4	5	4	12	8	4	16	9	12	8	11	6	7	5	12	11	12	12	6	13	15	14	27	12	8	7	12	7	9	13	7	12	4	7	3	7	10	7	1	3	8	7	4	5	9	4	10	10	14	7	5	21	3	7	4	6	4	11	5	13	4	3	3	7	3	6	9	4	3	2	15	5	4	6	7	0	2	5	6	9	1	2	3	4	4	1	12	5	7	4	2	3	25	5	5	10	11	7	10	1	11	6	11	2	3	0	5	6	7	11	1	1	2	8	1	5	7	1	5	0	1	2	2	5	2	1	7	2	4	4	2	1	3	3	0	1	1	2	3	7	1	3	0	14	1	0	1	0	0	0	1	0	0	1	1	0	1	2	0	0	0	0
ne0207	4535	2785	1916	1909	1460	2046	1614	1726	1307	1185	1140	1431	1485	1317	1195	1157	1315	1116	1348	1123	950	2048	1060	1162	1091	891	888	779	1311	998	689	1038	1022	1028	875	766	889	808	862	682	920	791	744	988	914	797	912	889	805	706	839	680	721	623	904	794	565	673	705	692	853	647	443	650	636	818	872	830	660	606	559	661	725	568	530	451	711	685	782	603	690	614	729	741	485	668	663	493	447	718	548	483	712	441	560	451	726	464	789	747	625	491	518	695	660	516	533	654	527	698	598	595	632	694	606	584	651	508	448	770	469	676	518	624	498	531	481	633	608	597	388	507	467	423	424	332	631	369	599	573	443	620	689	503	364	522	481	737	612	521	486	418	589	509	527	434	585	329	596	401	552	403	401	436	509	325	380	448	332	476	570	470	390	388	544	416	452	531	384	386	391	328	449	552	444	316	403	443	404	459	445	461	511	352	408	467	456	543	463	490	457	400	437	514	568	493	356	383	421	472	519	528	519	392	293	446	444	283	376	361	287	410	381	416	454	430	429	361	395	409	397	420	561	385	577	244	231	325	327	389	562	417	290	333	309	341	437	296	436	318	362	532	406	317	265	466	441	443	414	500	340	228	423	346	269	320	448	402	311	334	394	309	526	372	422	292	351	404	373	309	253	262	330	378	256	172	272	349	221	387	299	404	224	326	312	248	489	297	349	342	297	286	291	291	372	264	373	281	320	295	219	257	215	368	274	268	343	276	448	279	286	271	383	260	469	352	383	278	362	238	468	404	388	333	416	313	341	219	236	277	292	336	199	270	344	257	266	292	234	257	360	374	280	230	277	382	292	294	269	234	264	162	261	261	231	263	326	215	278	333	251	236	215	313	317	280	341	275	256	324	224	207	307	355	346	248	328	214	296	290	271	258	334	286	217	232	319	299	198	244	328	184	371	304	381	259	227	337	336	265	197	213	228	371	249	346	370	241	331	382	238	174	306	185	289	202	316	257	187	316	264	232	186	291	210	312	161	309	167	270	280	193	187	213	151	195	175	248	205	339	217	248	222	239	217	228	258	221	182	190	263	212	175	232	279	238	229	171	218	205	232	211	270	244	219	222	279	153	186	305	248	282	161	247	234	263	296	326	192	280	229	224	140	158	173	181	244	193	213	207	162	226	266	312	171	262	183	191	222	311	225	192	259	225	197	168	203	297	225	272	208	211	150	183	244	172	185	155	209	228	120	262	271	186	122	157	244	191	227	266	174	132	128	159	125	319	133	198	223	228	153	305	276	242	210	216	239	108	239	193	258	144	207	171	236	270	198	188	192	200	196	194	182	156	206	164	361	202	193	246	189	206	163	161	241	168	157	222	181	219	115	143	167	110	179	159	305	120	215	167	220	189	162	141	150	169	141	119	129	155	187	143	117	122	197	173	172	191	125	149	142	110	178	170	282	228	122	153	220	206	262	100	153	150	152	142	168	187	137	193	127	92	164	171	109	178	116	157	124	118	127	148	150	189	165	155	237	241	145	167	184	178	144	179	136	159	169	110	174	180	88	128	183	184	248	200	153	174	309	118	108	208	210	166	143	473	205	77	97	112	113	81	172	172	142	204	109	126	149	78	170	161	137	160	190	205	152	103	158	110	109	235	129	108	149	189	146	114	142	127	158	118	225	77	203	102	127	96	143	155	159	99	72	83	189	105	112	210	136	84	169	135	130	122	142	100	154	153	143	113	117	123	115	152	133	112	224	106	181	135	186	190	160	135	115	95	121	175	106	118	86	121	155	144	92	128	222	145	195	112	139	113	116	147	156	116	190	133	127	157	133	153	194	84	90	173	234	129	160	92	180	154	94	108	116	125	122	124	119	119	70	108	131	106	80	60	85	129	147	134	78	124	97	93	170	87	81	63	85	88	114	75	220	100	84	162	128	113	74	91	130	99	175	121	100	116	131	80	135	74	84	109	277	126	115	93	158	92	109	101	129	116	121	112	186	60	140	129	73	77	122	104	96	138	100	60	180	112	101	183	95	162	107	113	246	89	110	69	117	85	124	98	127	73	182	108	158	59	86	116	86	140	132	109	123	72	177	175	71	142	58	152	132	120	91	126	105	88	81	109	73	124	138	127	124	69	132	105	90	58	68	153	99	81	128	79	96	60	122	138	60	82	134	140	55	105	112	61	73	112	107	82	75	135	96	97	78	67	112	60	253	51	93	120	110	156	115	176	116	95	112	100	159	112	102	67	116	94	129	96	88	102	81	130	122	93	115	62	83	61	99	108	46	46	97	73	33	137	93	101	73	107	31	112	70	118	92	86	72	108	128	106	97	58	84	113	65	89	108	100	77	107	71	91	110	133	209	88	87	67	68	61	160	109	84	76	92	47	78	76	75	67	133	77	56	44	98	66	89	105	114	46	76	98	109	36	107	50	63	72	101	81	83	91	154	45	53	104	66	92	76	94	126	108	71	99	126	74	83	118	100	59	39	67	61	135	113	82	92	59	49	91	81	61	111	64	70	77	88	33	75	90	119	35	47	83	45	52	87	99	55	121	115	66	101	72	99	80	52	80	52	61	79	84	61	96	103	58	76	49	98	66	68	149	80	80	62	53	78	91	82	62	56	134	67	93	60	43	62	95	55	54	72	55	60	115	111	123	87	134	55	31	108	51	149	108	49	82	51	62	73	71	81	52	49	61	43	124	29	71	161	79	28	79	54	38	91	80	51	85	106	77	43	56	77	93	44	97	44	95	115	64	111	54	50	52	108	54	66	47	43	77	48	141	39	92	35	87	35	64	44	33	81	52	77	47	37	48	37	84	41	45	33	65	63	32	55	66	54	68	37	62	139	55	60	59	32	65	41	80	86	48	98	54	19	51	50	53	40	169	84	21	49	52	56	74	102	80	47	39	60	66	60	46	48	54	51	53	61	45	41	43	63	46	74	51	40	52	46	44	73	85	80	55	81	47	84	40	55	60	41	37	56	66	45	11	57	50	63	56	56	40	102	46	42	30	77	70	77	37	51	64	55	56	39	69	28	26	34	26	60	23	54	47	29	72	33	24	43	39	33	53	41	52	33	39	49	32	32	27	20	29	37	32	48	95	155	29	39	96	43	18	56	71	28	48	62	24	24	89	101	103	67	56	61	54	80	38	44	49	37	14	28	32	37	33	43	57	45	96	31	82	44	50	41	47	81	39	36	48	28	33	35	32	112	25	22	32	49	70	56	13	36	31	40	35	40	37	48	96	37	32	24	55	56	29	61	163	30	37	19	47	32	45	26	24	42	11	30	89	47	55	54	31	38	24	20	30	39	27	94	37	34	45	32	45	38	107	15	48	23	36	77	28	27	96	65	49	32	37	36	35	40	37	47	16	29	27	44	29	71	16	22	17	38	28	39	39	15	64	23	37	58	29	19	56	36	31	32	18	25	69	9	23	20	53	32	70	16	48	37	40	72	21	29	23	26	44	37	21	16	34	37	41	119	33	14	35	15	35	35	32	23	36	23	31	30	13	32	32	55	51	26	20	56	19	37	36	20	50	20	22	37	27	22	32	38	69	15	44	48	56	52	31	42	20	16	12	23	17	13	36	12	13	20	18	37	29	56	25	36	29	41	11	38	30	14	17	11	29	30	44	32	26	19	16	40	25	22	36	85	19	53	45	54	9	26	8	6	22	25	29	12	9	24	9	9	32	15	14	28	14	31	10	28	16	21	54	15	18	24	27	30	24	17	21	17	16	21	27	20	13	1	15	10	9	11	9	5	20	9	30	21	7	31	28	16	19	10	11	28	9	15	12	21	13	4	7	52	7	12	42	21	19	18	5	11	4	12	10	42	18	30	21	7	18	16	18	16	9	19	5	10	9	13	4	7	9	13	58	11	21	11	15	9	14	11	17	4	6	18	7	12	14	39	6	19	13	15	16	6	7	17	22	4	16	8	27	22	3	36	19	4	11	41	14	20	7	12	5	8	4	6	10	6	7	15	3	5	24	4	7	4	6	9	6	6	7	5	10	4	40	5	7	1	44	14	10	5	5	7	2	2	6	1	1	4	3	5	4	2	8	3	9	3	0	7	9	6	2	2	8	63	4	5	3	0	3	3	4	3	1	33	4	5	3	1	3	0	0	3	0	2	0	2	2	6	0	0	0	3	0	1	0	2	0	1	63
ne0208	3365	3241	2437	2388	1857	2094	1781	1606	1738	1941	1680	1630	1279	1168	1210	1055	994	1757	956	1308	1461	1095	1249	1418	1222	1295	1289	1054	1141	1074	996	941	887	1028	908	1011	867	1211	1204	814	1014	809	1210	981	742	745	774	738	717	800	842	864	829	777	831	862	1215	1195	864	945	782	781	764	922	707	874	821	828	837	1040	883	678	841	790	851	1042	999	888	667	819	774	701	581	765	838	690	661	789	533	654	554	613	653	639	760	641	521	629	610	607	666	576	669	499	749	562	492	583	535	485	677	556	494	586	577	579	526	614	879	536	584	538	747	542	633	693	645	773	494	540	643	405	780	572	713	1143	686	608	491	579	523	464	596	570	463	513	605	1004	482	488	509	599	505	487	623	604	487	671	456	703	616	602	550	607	638	568	528	453	578	539	394	598	446	579	504	525	530	446	817	625	801	742	606	557	552	727	492	412	552	487	529	394	414	444	550	415	484	377	485	507	409	532	587	597	732	552	606	382	278	433	417	523	655	334	285	429	619	461	324	624	579	521	372	378	448	420	515	638	458	530	446	410	357	541	488	448	435	556	532	527	455	510	380	357	489	368	364	447	582	374	461	555	577	680	399	348	324	451	449	332	387	482	480	334	501	290	270	612	518	407	450	391	507	477	568	380	399	389	506	427	451	449	424	655	505	624	333	390	331	305	442	446	499	423	288	538	413	385	390	421	410	550	363	302	359	391	427	340	309	477	425	402	479	418	356	354	356	260	382	443	415	313	372	441	398	260	357	442	294	502	390	342	287	371	330	271	337	395	351	325	390	293	435	401	293	385	266	298	504	399	365	392	372	247	385	454	491	412	374	521	280	302	238	358	258	382	496	368	264	262	405	426	297	347	430	301	353	305	351	356	281	255	357	309	437	335	396	378	274	464	424	336	296	304	361	327	296	466	474	402	339	319	278	272	285	310	336	296	347	333	370	435	312	277	351	279	270	277	318	255	264	352	313	295	337	277	243	331	473	307	234	251	261	225	298	298	269	287	222	265	234	401	226	349	237	297	298	277	205	214	285	290	241	335	324	328	376	290	307	124	227	367	291	172	265	277	213	257	241	232	246	238	240	308	247	271	189	251	303	350	339	448	174	470	270	285	265	241	223	259	297	296	262	282	322	247	282	250	241	183	317	255	351	156	188	254	364	267	210	201	244	243	363	221	227	267	236	288	253	198	262	231	330	117	208	199	248	239	268	282	247	164	214	291	180	244	206	220	354	319	215	201	216	300	249	404	191	501	298	279	251	296	226	222	243	276	248	257	167	222	286	266	212	213	286	223	254	222	236	341	255	198	387	310	235	196	191	268	266	239	245	187	237	266	210	238	210	160	173	212	200	159	188	251	279	240	142	308	101	159	143	351	225	199	222	183	227	154	234	153	244	380	228	311	189	205	172	209	239	203	161	276	180	166	181	218	197	136	167	278	255	225	241	144	260	225	212	145	189	424	170	118	180	207	230	379	324	99	267	250	172	279	161	158	238	144	185	144	233	167	207	214	237	221	177	143	207	162	173	175	299	147	181	151	157	155	325	234	179	122	235	201	266	182	174	109	183	292	128	252	208	161	117	157	211	206	127	160	98	129	179	226	191	122	172	170	121	141	182	173	173	206	183	102	179	252	142	169	178	104	157	179	185	199	359	240	145	196	170	334	126	146	134	192	254	198	149	215	205	150	205	226	160	117	188	177	205	196	147	194	264	174	230	134	275	226	183	101	157	316	174	333	143	185	237	148	285	80	141	273	120	166	120	214	142	177	252	319	202	197	152	157	179	143	233	172	81	124	212	182	200	156	281	213	161	93	147	154	195	112	119	224	190	125	139	132	191	126	144	145	120	184	138	100	125	154	183	163	104	144	159	140	191	164	109	165	147	50	180	160	296	196	135	174	128	130	138	118	106	120	164	144	119	134	172	283	317	204	190	124	187	178	94	133	161	165	171	203	140	187	137	134	82	151	153	144	226	131	127	104	189	125	95	80	305	128	117	144	166	155	152	90	106	182	147	134	178	167	143	93	112	166	250	146	119	147	119	109	127	134	138	86	136	119	153	153	124	143	105	149	97	139	97	122	91	116	134	130	120	180	122	90	76	119	126	181	139	71	149	104	85	123	131	164	154	119	104	78	125	112	216	89	238	121	94	111	142	89	154	122	163	130	96	122	146	182	163	88	184	104	84	138	144	142	169	127	119	161	166	142	189	95	183	99	123	178	79	84	125	83	82	103	146	106	226	98	88	138	124	78	114	83	147	99	133	114	129	88	150	129	118	85	113	114	135	189	123	135	141	98	120	117	127	118	73	154	113	131	96	55	97	145	85	160	209	94	83	99	40	91	155	94	65	120	45	149	91	83	93	81	119	80	105	43	105	167	57	170	113	91	309	54	85	95	74	210	138	97	114	145	69	123	133	81	176	69	57	120	117	88	105	134	73	244	69	163	96	120	82	93	114	52	113	104	97	68	97	95	66	59	139	83	139	100	89	133	72	132	81	78	85	85	88	78	140	173	43	77	124	57	88	75	134	56	63	77	62	95	93	124	58	79	66	65	71	68	158	65	69	87	77	123	121	90	175	65	193	113	84	88	55	74	114	48	122	64	64	148	128	80	58	136	115	80	82	67	93	107	109	66	92	84	118	138	77	126	61	65	56	52	105	111	140	50	64	52	96	74	84	89	56	92	80	81	76	73	144	48	39	96	74	61	104	78	69	75	98	73	76	83	162	79	64	81	76	80	78	89	147	44	82	66	101	27	80	64	71	101	119	50	61	71	64	99	44	122	97	54	78	63	83	57	50	53	81	69	77	63	66	52	115	76	47	99	50	87	61	92	174	80	70	82	77	45	67	33	98	72	72	32	60	75	80	66	98	91	46	73	94	64	66	65	45	91	45	48	78	81	79	77	98	79	68	56	83	87	55	81	45	59	110	22	101	84	69	35	59	127	108	94	63	42	70	72	71	52	43	89	46	83	68	96	113	58	80	91	111	95	65	70	61	45	33	77	49	92	60	34	26	116	93	24	38	40	189	78	52	70	62	50	61	66	70	62	75	67	51	52	29	41	71	70	86	38	70	41	100	50	27	43	15	85	53	118	87	78	50	39	51	79	73	38	64	78	37	67	68	45	49	30	50	29	43	54	73	33	65	36	60	55	37	75	69	68	34	53	70	54	14	39	26	45	80	68	28	36	38	23	79	32	82	97	66	75	50	69	28	58	70	21	34	131	69	81	57	104	42	36	38	42	84	21	52	32	46	59	44	52	18	91	46	40	54	47	21	67	26	83	73	47	258	65	24	23	32	75	42	34	31	26	76	39	23	25	64	51	48	60	24	38	46	37	36	47	38	15	46	33	87	60	45	13	42	15	64	48	54	41	47	46	52	70	59	30	70	59	44	60	26	32	47	51	13	34	50	31	31	33	80	39	25	25	55	38	39	31	42	43	46	29	39	41	24	43	27	19	41	32	30	22	29	25	40	53	126	27	84	30	82	60	34	52	23	30	39	50	53	37	18	35	104	44	36	52	65	14	25	23	25	55	41	42	17	27	46	27	38	28	40	23	28	30	37	47	21	21	45	32	35	22	27	57	19	14	36	25	20	16	30	19	29	43	51	35	15	14	27	17	14	50	34	28	73	22	32	16	15	49	48	26	40	26	10	29	41	35	26	60	16	40	33	52	22	19	57	26	11	25	73	30	6	82	57	27	16	27	18	35	10	9	23	19	33	11	23	25	28	45	27	10	24	17	18	17	38	53	23	13	12	15	29	19	28	25	18	17	25	5	32	13	30	15	18	39	13	15	5	14	9	26	42	0	23	14	17	14	28	21	12	27	15	7	23	18	11	38	38	10	8	12	45	3	10	46	20	10	3	4	17	16	10	18	3	26	18	25	42	9	17	32	8	5	12	12	15	11	3	21	7	20	20	6	16	20	21	16	16	24	10	27	8	16	11	3	9	5	35	12	9	38	19	16	12	12	5	8	4	2	7	8	8	4	6	20	3	56	32	5	2	0	7	6	1	15	5	4	8	1	10	2	10	9	8	9	19	5	3	8	1	6	2	0	4	8	3	12	4	0	1	1	3	2	40	4	13	0	4	0	1	0	1	1	1	2	2	4	3	3	1	7	1	0	0	0	1	0	0	0
ne0209	3538	4012	2421	2118	2202	1916	1600	1422	1481	1950	1513	1508	1478	1308	1628	1222	1024	1353	1197	1311	1351	1293	1459	1287	1249	967	1375	1108	1153	1682	1140	965	855	994	1125	1239	824	1124	1097	850	912	905	943	964	812	791	774	692	1021	888	768	872	943	937	963	901	798	1052	949	929	852	965	856	862	766	843	768	744	772	871	780	689	828	690	778	1117	705	864	812	783	658	815	656	742	829	686	678	783	667	785	815	712	628	636	646	704	583	540	563	628	652	674	798	550	792	516	649	604	533	720	575	620	606	535	611	615	495	590	759	544	609	543	842	621	733	587	513	572	475	568	594	557	618	686	778	506	565	495	525	594	517	458	478	599	612	595	527	479	546	685	523	573	517	493	631	514	514	589	508	744	581	633	576	592	733	497	556	553	591	659	560	556	472	721	460	631	558	488	493	483	435	648	562	438	551	747	575	540	511	585	499	371	451	433	498	576	432	460	473	476	458	486	508	598	487	416	443	379	442	440	442	536	438	377	381	647	494	629	379	597	703	401	533	419	595	480	507	658	437	469	526	456	453	474	481	560	537	499	538	489	431	547	414	649	422	368	449	483	423	435	402	452	566	479	365	375	355	440	539	429	449	476	410	337	460	340	313	405	561	436	372	371	449	450	379	344	400	369	506	448	451	449	373	409	415	491	511	331	394	354	428	350	506	371	625	446	422	391	356	391	466	558	335	415	388	381	419	525	235	375	482	374	466	318	448	321	399	410	341	573	376	574	426	352	406	557	426	412	370	316	330	344	422	414	319	351	420	367	332	423	316	330	566	361	255	412	365	390	249	340	376	455	442	383	314	332	298	386	377	346	261	410	432	346	321	272	378	410	396	330	362	243	366	308	328	344	295	325	275	363	484	299	296	280	445	367	326	308	308	328	324	564	446	276	328	270	338	324	341	357	473	552	250	298	345	272	287	309	352	377	332	345	318	260	337	172	264	345	285	300	319	319	305	431	322	208	333	333	245	244	340	270	199	332	303	278	293	242	291	259	198	389	262	265	312	293	244	172	321	206	262	232	228	290	309	268	421	351	281	244	297	261	335	228	254	254	209	207	251	246	307	211	258	300	494	308	290	234	223	220	299	369	177	318	226	310	218	260	391	296	212	311	312	299	296	242	237	270	262	254	240	275	252	242	315	231	249	261	196	258	194	295	272	183	265	295	214	232	253	269	211	254	383	218	256	237	331	281	360	229	277	252	220	204	306	223	191	301	358	297	242	227	272	293	253	215	250	498	369	260	231	278	236	198	332	345	274	197	168	200	229	352	272	189	258	256	253	264	221	218	255	114	201	222	241	300	135	230	250	282	288	226	266	219	309	121	225	255	285	246	188	158	195	276	188	250	184	223	217	266	211	280	241	253	240	217	223	254	254	337	206	254	273	225	240	163	236	195	197	255	248	283	199	247	325	209	269	238	172	190	218	240	218	160	215	268	137	162	186	252	196	132	221	241	244	184	221	166	248	143	206	252	150	168	166	202	212	238	234	143	205	191	230	181	263	177	227	198	137	222	144	140	219	212	229	119	206	240	129	176	219	155	237	204	124	111	322	177	122	133	141	249	156	191	233	218	152	231	142	270	149	190	138	292	183	204	185	242	148	221	226	190	239	122	223	187	132	144	212	117	221	263	158	226	265	199	144	275	181	200	209	189	202	155	130	300	159	180	167	193	213	189	125	127	192	144	166	147	165	157	164	182	191	126	214	166	184	202	159	178	156	223	165	188	182	184	143	177	134	286	146	160	141	201	157	184	177	93	132	158	184	156	183	164	203	149	122	118	226	134	179	208	118	194	162	111	215	170	162	215	113	194	119	137	104	155	145	147	135	155	125	156	114	116	144	182	121	115	172	112	146	80	149	123	156	138	110	134	173	169	74	197	96	244	151	175	165	156	143	149	134	133	173	121	186	195	81	162	155	224	126	168	117	100	138	155	134	168	183	145	169	73	138	182	187	151	138	168	151	186	98	188	221	115	189	186	135	158	97	164	197	117	120	194	116	149	136	179	129	118	138	134	148	140	129	126	162	135	113	123	246	171	199	111	173	191	179	126	102	132	77	138	111	105	104	123	130	112	127	145	163	100	111	115	142	125	126	152	147	157	145	129	129	168	162	207	107	104	83	149	174	45	76	118	139	136	129	120	119	132	171	158	138	107	127	177	69	222	212	103	140	131	96	133	105	161	133	93	135	140	115	114	168	111	102	172	104	117	150	202	127	111	262	108	108	105	106	104	67	84	94	71	106	127	134	100	123	103	81	164	128	88	170	71	141	140	98	100	120	92	128	107	104	105	70	150	86	129	92	71	149	105	94	110	120	149	54	112	97	112	94	104	118	123	72	100	115	73	101	93	138	97	107	79	118	95	101	67	94	127	126	98	161	89	109	69	136	66	77	139	73	62	81	101	78	85	79	82	86	93	94	141	84	60	108	120	94	101	71	92	114	45	77	81	69	91	86	82	117	77	120	92	127	118	63	107	124	57	98	68	101	86	133	135	103	106	88	101	74	136	85	70	57	60	90	87	92	98	70	99	143	78	97	104	61	94	92	95	70	138	95	119	112	114	87	94	114	61	71	103	90	90	92	50	117	83	78	72	118	82	96	66	88	88	102	108	74	92	74	64	70	112	81	71	50	89	37	110	76	82	71	115	87	81	91	90	82	77	46	79	56	69	100	82	90	121	82	88	58	41	70	116	118	58	81	82	91	100	111	103	58	96	48	106	83	57	95	52	73	94	79	52	91	83	107	50	87	75	117	86	100	96	74	68	47	106	55	89	107	63	77	49	122	68	82	89	60	48	71	100	93	77	60	128	64	110	58	91	53	95	80	67	54	55	133	57	90	68	86	84	90	96	105	62	67	63	77	63	64	83	50	42	47	116	81	68	87	98	73	110	78	82	77	50	77	68	47	82	74	86	116	40	82	106	65	39	45	73	143	61	61	48	68	86	73	102	46	78	71	95	88	92	43	33	79	75	106	86	47	123	58	37	55	83	59	83	58	39	37	56	55	56	56	62	77	92	58	47	78	55	109	45	43	66	107	64	56	55	34	44	42	113	91	83	58	62	82	39	63	45	43	45	27	65	141	57	74	72	86	79	62	47	43	54	39	39	49	73	61	29	46	63	77	44	68	39	72	36	53	48	47	32	40	54	36	39	57	53	41	52	36	46	44	75	70	49	65	50	73	62	41	83	23	63	52	42	37	93	50	57	48	55	31	56	74	51	60	53	38	25	68	62	45	42	40	47	46	66	44	35	37	28	72	30	31	35	18	31	71	47	18	42	56	25	44	51	34	34	49	35	45	61	30	58	75	27	53	29	45	28	41	33	40	61	60	72	36	63	32	26	62	39	33	52	46	42	48	32	33	33	87	53	56	42	38	47	56	23	45	45	31	32	42	39	29	49	30	61	64	39	67	50	34	38	22	62	48	52	63	37	44	21	30	48	45	22	29	52	59	13	55	56	67	40	21	27	24	18	37	17	35	39	31	37	47	29	36	27	25	16	14	18	24	28	30	35	24	33	29	28	12	44	36	27	34	26	30	32	17	49	29	46	36	25	270	13	31	22	18	37	20	39	47	28	19	30	23	58	21	35	38	61	18	17	29	43	24	19	34	30	19	28	17	29	15	31	21	26	17	42	28	10	27	29	31	29	22	49	29	10	25	21	29	22	30	32	24	20	17	22	11	6	7	22	15	46	34	25	18	6	42	29	19	16	8	14	14	17	63	20	16	14	23	24	24	25	17	12	28	9	17	13	10	35	46	12	28	6	16	26	21	31	15	13	7	26	17	10	6	16	11	14	37	46	12	7	21	8	15	18	21	19	11	16	15	35	10	29	13	19	2	11	6	13	19	19	8	10	6	16	16	9	10	12	7	14	8	18	30	11	20	13	11	3	8	25	9	3	12	16	15	15	12	26	17	12	11	13	22	13	10	5	8	6	13	9	8	6	24	11	21	7	15	10	6	9	4	7	11	12	7	8	4	4	5	0	25	5	2	17	2	7	6	3	7	7	1	7	4	5	9	9	0	7	8	4	7	5	4	4	6	18	3	5	3	5	6	2	1	1	8	7	0	1	6	3	0	1	2	0	1	2	4	1	0	4	1	0	1	0	3	2	0	0	1	0	0	0
ne0210	1844	1571	1331	1034	783	1045	747	813	823	972	639	834	674	672	540	587	618	807	552	654	740	671	656	597	615	595	566	538	540	568	520	489	545	532	397	480	443	544	592	306	529	430	360	489	461	418	468	358	328	431	468	436	351	626	348	438	425	470	353	433	463	444	337	318	336	458	427	468	417	479	504	319	369	246	329	424	341	476	414	403	392	307	412	335	333	376	372	402	274	338	305	308	354	281	348	275	327	249	319	419	328	291	286	308	344	344	248	351	235	239	342	256	318	356	348	333	326	245	749	402	261	327	322	286	291	361	326	439	289	332	305	272	419	345	333	194	301	271	329	284	230	237	212	279	179	273	250	302	257	247	298	270	270	290	242	226	260	251	311	245	322	280	315	279	329	267	253	211	570	314	290	308	267	210	318	274	266	301	274	289	309	203	331	260	270	612	247	213	312	263	190	243	202	232	317	224	219	258	223	279	228	209	274	301	289	229	282	167	162	230	290	291	261	230	112	280	300	212	163	334	252	238	230	206	269	313	244	216	263	258	208	193	229	308	249	142	167	251	217	251	228	228	214	153	155	197	196	267	267	185	216	202	245	249	145	239	149	169	258	237	196	209	291	234	223	180	145	265	303	160	234	180	226	206	249	176	153	231	247	247	172	222	231	232	225	332	155	198	107	189	223	196	208	221	120	248	227	118	174	230	197	228	156	214	146	161	198	245	98	375	179	221	195	260	175	84	148	115	263	217	183	186	243	193	173	170	186	209	205	132	152	175	164	230	213	129	218	174	143	220	169	131	153	152	152	189	139	200	142	148	192	182	196	156	174	157	192	174	180	176	134	174	156	136	160	103	204	165	123	133	167	112	164	156	193	237	165	164	168	165	240	125	165	151	143	193	234	145	132	186	221	106	168	130	194	142	175	179	264	209	191	174	181	173	153	131	158	85	152	173	184	192	166	146	143	130	131	116	184	128	110	190	223	140	110	196	175	195	86	160	116	133	91	172	151	167	142	113	112	142	119	118	96	162	116	138	108	101	104	109	129	173	100	135	146	165	182	175	152	88	177	101	169	110	124	140	124	99	160	80	86	125	143	174	83	112	89	109	193	106	184	107	105	191	149	125	137	135	147	118	188	174	170	119	102	109	164	144	158	83	124	135	139	86	93	185	148	119	102	171	118	104	167	108	127	157	140	103	120	160	150	87	148	116	109	108	149	111	115	106	111	104	142	136	100	102	110	142	141	180	152	90	105	160	114	123	88	131	132	146	80	121	123	132	122	150	136	105	56	87	149	108	92	106	124	137	149	154	133	150	165	63	84	136	143	103	133	178	116	124	143	108	114	96	137	85	89	89	136	100	94	58	116	136	110	99	101	132	85	64	81	142	86	91	109	81	73	66	104	83	198	154	111	153	89	104	102	105	94	104	83	96	111	83	84	90	101	64	116	171	108	115	129	50	99	118	102	66	107	126	88	32	140	100	102	124	85	56	102	108	86	107	83	95	91	119	89	89	123	135	121	106	117	104	87	94	119	73	91	94	58	64	97	94	118	117	125	138	103	94	114	107	123	64	170	82	109	156	79	70	101	89	69	76	119	123	78	81	52	45	89	95	103	101	88	89	69	51	67	93	75	151	83	60	84	149	48	78	126	31	83	117	104	158	139	89	81	117	85	125	66	74	37	70	88	36	51	90	104	43	99	106	79	49	116	88	72	82	71	80	101	78	90	67	88	112	80	78	68	157	88	122	93	72	119	102	56	49	70	146	47	69	85	113	54	68	57	45	66	85	72	48	72	52	116	85	31	44	106	87	128	85	88	58	129	59	81	93	117	82	87	116	50	132	64	85	109	110	67	59	91	97	55	64	41	42	73	95	107	88	74	56	107	90	67	47	51	50	89	92	33	94	50	58	52	68	80	69	67	61	79	83	78	69	65	63	53	83	86	36	83	82	74	59	39	87	68	85	85	133	56	66	45	60	67	35	57	108	38	57	69	72	62	58	79	64	64	91	67	97	85	76	63	82	93	51	69	66	81	46	65	68	96	52	89	87	57	21	62	90	69	56	68	83	79	58	99	51	21	50	40	75	48	55	53	50	56	61	58	93	33	75	60	65	61	60	77	34	72	42	51	75	59	49	72	59	77	45	38	91	246	61	39	68	37	64	48	48	53	46	59	66	41	74	89	83	147	33	91	29	57	33	65	77	28	55	82	51	33	116	52	44	91	51	46	82	60	64	50	26	44	46	74	60	104	51	60	51	61	24	35	53	34	61	69	53	30	44	44	48	58	76	94	50	98	64	88	55	92	36	62	59	53	32	37	99	32	72	68	53	35	58	49	74	58	70	71	75	40	52	53	41	30	57	32	52	61	68	41	51	65	76	73	23	63	30	46	49	56	52	67	10	38	38	64	37	55	27	37	58	39	54	55	55	71	25	33	40	53	52	46	84	53	28	14	48	52	70	40	49	37	26	44	55	42	26	72	50	33	18	39	34	77	59	48	68	57	34	60	92	51	46	31	47	62	48	23	31	42	54	36	49	27	26	40	48	47	82	30	44	26	35	35	30	52	58	72	50	35	23	44	70	51	57	61	15	74	52	52	34	22	27	137	31	75	92	30	43	64	24	44	51	43	37	52	51	34	59	36	47	40	30	26	33	35	44	46	69	39	25	42	44	23	51	41	21	40	39	14	50	49	55	55	35	32	80	41	40	17	24	56	33	45	34	45	37	35	53	25	45	38	41	27	40	24	20	27	20	26	33	15	59	53	29	50	27	18	35	26	29	36	61	30	39	51	63	26	64	43	37	36	23	21	41	38	29	64	32	23	26	38	36	30	53	37	72	20	39	40	38	33	49	30	32	72	24	49	59	23	21	20	22	28	15	102	19	31	46	32	26	30	30	27	38	38	41	54	30	24	29	31	30	32	19	36	28	40	30	13	32	52	17	21	28	39	14	22	33	47	60	27	21	36	40	42	79	33	42	17	60	23	90	45	25	34	17	45	63	20	17	64	26	41	34	9	44	22	15	17	34	26	41	25	22	20	60	37	20	143	27	19	16	33	34	19	24	20	15	16	21	31	16	38	14	27	159	12	32	23	26	11	40	21	40	44	37	43	46	22	24	39	49	56	32	18	24	41	19	28	11	13	14	49	5	33	15	26	13	27	17	10	26	33	18	9	29	34	15	16	15	22	46	32	29	17	29	21	18	42	21	51	37	21	39	28	14	17	29	25	16	40	34	24	22	20	8	21	49	15	71	22	21	27	14	15	28	23	17	4	22	13	30	29	13	7	20	13	24	19	11	12	25	22	12	29	12	26	11	8	33	32	32	4	8	19	23	16	8	15	8	21	12	23	14	35	7	51	8	26	146	28	10	17	16	25	20	12	20	13	16	9	40	32	2	5	22	18	14	10	7	17	19	9	7	13	20	16	25	10	25	3	17	26	8	19	31	35	22	40	16	18	19	26	31	20	5	19	28	34	7	12	4	18	28	12	10	17	12	27	19	23	15	6	12	44	11	20	17	9	14	20	8	16	19	24	15	9	25	4	11	19	11	15	13	9	11	9	20	10	7	8	14	27	14	9	5	28	6	14	15	9	13	17	1	15	7	3	6	10	29	13	17	25	20	29	10	10	8	9	16	12	7	36	9	16	2	2	15	7	9	15	8	16	13	31	16	12	22	34	12	20	1	15	7	11	20	16	14	5	8	3	3	3	17	3	11	8	13	10	4	24	15	13	16	11	9	3	15	5	5	3	9	17	18	9	26	4	6	5	7	11	3	5	20	9	10	7	2	12	6	41	12	1	14	2	1	15	2	6	26	0	1	5	4	13	9	6	6	1	19	10	2	13	2	11	5	48	5	1	21	1	6	3	14	5	5	3	5	1	5	2	6	2	10	1	11	1	3	16	6	12	4	5	5	1	11	9	4	8	17	2	4	24	15	4	3	6	14	3	10	4	1	6	2	12	1	9	2	9	7	0	8	11	1	5	1	2	1	0	6	6	4	1	2	0	1	10	2	1	1	3	18	1	1	3	1	4	8	0	3	2	7	1	1	7	1	2	5	1	5	3	2	3	1	0	1	2	0	0	2	2	0	20	0	1	0	1	4	0	0	1	0	0	0	0	8	0	0	1	1	0	0	0	0	0	0	0	0
ne0211	3029	2416	1907	2000	1331	1591	1553	1444	1157	1542	1120	1267	1016	944	999	888	858	1214	748	927	951	897	807	1017	836	842	792	765	651	848	681	849	708	835	527	758	689	882	839	513	779	698	662	850	564	635	684	591	467	585	759	693	629	687	666	587	724	823	694	714	615	551	463	555	576	641	655	656	613	675	763	450	576	670	486	617	863	636	663	476	577	504	497	560	551	568	476	499	361	586	389	362	601	384	436	479	464	566	593	576	575	325	495	455	548	492	520	472	356	491	491	521	456	614	497	438	465	388	460	545	387	468	445	440	512	631	372	641	450	520	490	307	454	502	498	555	342	376	425	456	359	387	450	423	243	430	399	615	404	424	390	509	375	427	397	327	348	436	435	673	490	371	396	504	427	362	329	362	327	421	304	410	329	430	440	379	487	412	534	419	869	496	431	412	394	368	393	320	396	382	311	281	230	335	447	391	293	362	303	414	314	290	469	459	473	380	433	344	171	347	390	324	250	316	274	361	463	230	278	455	351	460	247	361	323	371	342	406	330	429	266	356	234	300	405	300	331	337	384	379	309	313	284	281	314	355	320	314	382	241	280	311	344	505	258	342	205	362	284	228	244	410	408	252	358	269	222	357	368	254	395	250	437	316	372	197	242	317	235	265	254	239	277	405	327	275	238	278	137	218	320	265	264	310	211	402	394	299	310	326	242	361	239	311	294	232	285	276	170	265	254	377	258	318	203	241	313	175	404	369	304	262	291	246	273	176	264	291	206	423	198	278	293	378	338	264	250	284	320	307	221	275	296	355	253	227	256	258	295	253	295	233	294	204	232	303	503	179	164	291	211	211	198	247	205	193	322	239	238	264	257	266	257	311	282	237	280	237	205	204	304	235	203	211	220	335	316	203	206	305	338	317	269	179	300	217	163	339	242	365	218	213	210	194	218	204	248	207	270	217	216	304	212	224	192	215	213	179	273	224	180	212	195	221	146	157	217	236	206	163	226	227	172	153	240	190	177	142	126	201	182	244	136	277	185	180	280	138	160	183	276	243	167	193	207	183	235	208	186	104	239	127	169	158	229	213	197	197	133	127	330	146	193	273	165	204	158	166	179	230	244	330	157	288	226	124	243	251	154	96	178	251	154	127	185	193	216	173	218	133	185	237	188	110	162	180	172	158	129	200	165	159	226	112	163	135	149	124	217	167	174	185	200	108	196	148	185	171	174	196	180	100	148	253	141	208	125	153	178	183	130	99	144	244	104	106	106	280	193	231	154	199	170	187	178	184	200	120	75	133	181	201	150	208	235	145	179	172	158	215	243	99	213	190	182	118	191	242	158	227	174	139	160	164	170	218	154	111	123	179	153	112	207	162	267	152	154	238	108	151	154	199	132	155	149	112	111	160	171	123	151	254	153	133	153	136	117	153	125	166	108	187	119	62	152	184	110	122	129	181	188	215	149	133	156	170	186	121	112	192	116	64	179	132	168	254	164	98	148	114	188	108	126	166	195	137	146	154	153	122	146	148	146	170	134	125	135	107	181	116	257	82	113	95	175	143	210	188	161	97	173	126	232	113	169	75	179	140	66	130	84	154	105	83	115	120	95	140	71	60	171	171	153	134	135	164	93	118	161	105	124	116	83	112	137	161	90	127	106	70	116	103	148	152	190	141	94	163	107	180	71	86	74	150	119	130	79	118	165	65	105	85	111	73	130	86	91	126	79	120	196	101	156	77	115	169	118	88	104	127	90	233	119	118	163	96	137	51	84	148	73	91	87	155	115	123	151	189	113	116	120	115	152	129	181	103	55	86	163	127	87	87	124	188	111	78	82	81	125	80	100	173	99	97	90	82	143	144	131	93	93	184	131	90	123	91	118	119	153	112	69	105	175	124	85	116	126	35	118	137	222	145	92	116	124	73	108	82	63	102	106	79	68	110	115	183	385	151	123	50	142	104	98	93	124	93	79	138	111	113	125	133	101	96	81	125	94	113	98	54	114	94	62	68	175	83	87	133	89	115	113	98	66	140	103	57	71	157	78	92	81	96	187	124	87	104	104	92	80	84	94	52	143	125	76	90	79	96	124	103	36	103	80	94	49	83	56	76	73	129	96	74	70	74	77	77	89	44	119	59	48	92	93	129	100	59	85	70	45	62	93	50	126	113	100	54	79	81	68	107	97	87	50	114	110	97	87	36	120	117	79	76	92	78	91	73	75	82	113	109	83	47	87	60	66	118	79	60	94	66	55	56	72	64	96	62	59	79	90	58	82	74	96	69	76	81	86	73	78	88	114	54	78	69	94	103	70	61	74	95	65	54	61	91	97	93	68	104	48	66	76	88	79	98	83	87	116	134	49	69	50	53	44	106	34	72	64	79	63	61	86	56	57	30	43	82	56	113	39	53	96	68	72	69	70	105	84	61	122	104	52	76	110	86	144	38	39	86	62	67	84	84	74	133	83	95	46	90	29	41	59	42	51	76	60	49	32	70	57	33	85	60	121	82	77	115	52	95	77	56	58	73	61	57	108	77	51	50	69	77	58	43	67	30	57	47	54	57	100	75	29	66	45	49	63	52	90	69	85	83	75	81	75	55	118	38	130	32	56	69	32	34	69	60	92	78	51	68	95	41	44	35	49	56	95	70	55	66	23	71	77	43	51	57	44	80	54	76	34	31	53	72	78	56	42	44	73	63	45	61	77	59	71	33	87	57	90	69	168	43	65	46	85	26	46	38	82	58	38	46	106	65	71	75	42	74	57	43	69	40	41	69	46	36	88	29	29	64	98	46	39	104	37	109	32	102	65	54	70	63	49	30	20	32	57	59	54	43	38	36	62	34	29	41	45	51	54	65	47	39	49	59	58	26	46	26	58	60	55	33	35	41	46	69	70	41	37	65	68	57	46	36	34	58	45	37	59	51	31	60	56	25	39	33	13	76	21	60	34	45	54	25	32	56	30	37	49	66	64	70	48	21	38	33	34	39	21	60	45	55	18	63	33	68	55	41	53	67	34	53	39	23	28	49	15	38	21	20	18	57	34	43	34	33	152	52	50	29	27	30	35	33	32	39	41	37	49	39	32	27	57	47	81	32	55	10	43	36	22	26	6	94	22	35	52	46	54	36	27	59	25	35	20	47	24	49	47	31	33	24	46	23	38	16	38	16	41	25	37	17	11	20	34	47	63	49	30	31	20	29	9	39	26	28	31	41	15	31	39	20	32	86	47	36	17	53	24	40	41	32	29	47	38	58	39	28	22	19	32	44	73	22	25	27	22	47	17	40	19	26	46	28	31	27	7	29	29	30	117	21	328	24	32	18	18	46	27	14	21	18	26	27	11	17	40	16	39	31	31	28	32	30	18	31	21	20	30	13	40	33	17	32	26	16	58	35	15	29	33	23	27	48	22	10	28	11	26	75	6	8	35	26	10	26	11	30	28	18	37	36	22	17	49	17	12	16	26	25	17	24	34	20	25	38	15	14	37	19	22	15	21	32	16	32	116	37	24	10	51	13	37	25	33	14	13	24	20	38	11	10	40	10	23	10	25	8	10	11	13	63	21	15	16	20	40	42	17	17	30	19	10	21	13	16	18	10	38	11	10	20	24	30	19	12	13	22	20	11	15	22	17	16	32	7	25	14	13	16	5	45	28	14	34	7	14	13	31	27	36	11	26	21	6	70	21	26	69	25	11	30	27	37	19	18	27	19	8	22	10	6	10	19	10	17	9	17	12	42	14	3	12	13	35	13	28	16	14	25	17	14	7	14	11	15	10	31	8	10	14	9	9	5	8	13	22	16	15	3	7	1	16	3	10	26	4	5	4	14	60	22	33	5	20	16	5	3	32	6	7	17	12	6	7	6	15	9	9	7	13	3	18	6	2	31	7	6	2	4	8	41	6	9	4	11	9	3	43	8	18	16	2	9	9	1	5	9	7	6	3	3	6	3	8	18	3	16	8	12	11	4	9	7	6	17	12	5	3	3	6	9	4	1	2	9	2	19	7	1	9	8	8	8	8	2	2	34	46	5	5	1	11	1	5	1	7	1	1	1	3	3	4	5	2	0	5	3	1	4	2	3	2	0	1	1	2	2	2	2	0	5	3	6	0	3	0	1	2	0	0	0	0	0	0	3	0	0	4	1	2	0	2	0	2	0	0	0	0	0
ne0212	4447	4224	2416	2147	1417	2185	2158	1646	1629	1669	1321	1577	1621	1354	1673	1136	1571	1121	1271	1446	1711	1239	1145	1017	1064	973	1136	1492	1355	1602	846	1194	895	997	1256	1219	987	971	1105	1482	1025	928	857	985	1003	956	757	937	1526	835	764	827	779	822	938	1096	739	854	1073	826	791	770	609	1029	690	981	823	762	841	780	855	625	1032	1161	608	726	999	755	847	750	780	908	540	766	671	623	619	671	588	871	953	780	624	1025	598	642	519	695	718	670	609	646	682	588	682	466	658	584	693	749	915	650	554	590	533	808	503	821	536	570	942	559	587	845	669	669	645	405	476	547	422	658	508	596	775	559	518	438	495	507	715	827	549	561	462	633	525	539	689	772	525	464	627	625	655	485	650	521	528	578	494	559	469	598	784	426	554	934	420	472	702	463	458	729	468	676	459	445	445	471	424	673	427	732	390	582	429	699	451	513	736	430	515	342	381	455	489	456	810	480	520	381	442	479	461	493	541	449	860	549	424	656	522	488	609	665	415	487	444	409	473	398	451	522	625	524	426	586	482	405	398	532	366	446	659	656	337	347	477	409	658	325	406	868	616	383	504	393	423	501	321	391	470	395	418	353	313	473	449	354	457	379	423	375	407	559	432	412	439	636	429	583	423	393	467	354	387	460	577	381	452	344	342	443	373	605	506	387	313	558	317	407	354	478	699	469	392	617	505	380	373	364	350	347	500	270	353	449	616	336	295	336	298	269	440	534	486	374	409	558	344	518	336	337	390	572	483	334	394	248	390	420	372	363	323	442	318	489	370	273	404	464	443	471	387	455	451	330	232	316	321	310	350	398	323	431	314	361	312	311	246	593	282	279	301	361	358	454	457	438	409	256	309	249	289	402	696	292	300	319	316	279	307	283	512	362	303	303	301	307	389	474	338	472	234	271	362	290	495	268	360	336	301	286	556	282	272	254	324	317	225	379	305	308	312	544	263	359	351	433	335	250	393	468	549	310	363	309	272	308	246	277	248	273	182	373	298	290	391	230	210	286	277	342	399	231	205	495	443	276	284	198	180	280	270	239	381	326	261	392	297	307	231	235	251	242	236	238	205	279	322	223	197	268	512	264	377	116	240	312	256	175	207	298	303	363	274	321	231	367	204	279	234	225	220	221	271	257	206	247	173	235	332	205	216	253	214	304	278	303	204	371	317	200	245	238	203	236	233	171	216	174	263	319	219	220	226	398	293	274	352	363	226	226	257	228	199	270	206	301	246	194	194	246	157	209	234	215	273	300	297	313	241	171	212	243	339	154	291	195	266	279	313	171	206	251	222	244	175	218	158	455	166	173	197	170	240	201	270	187	224	302	187	173	350	215	224	295	261	266	200	230	240	202	202	288	243	211	251	238	335	257	231	212	187	264	205	164	170	241	158	279	200	209	176	117	169	185	202	200	370	176	173	264	305	254	194	240	151	239	167	189	178	284	145	252	128	235	167	239	223	297	179	230	185	161	214	346	213	127	165	183	161	133	184	168	196	141	221	146	331	194	162	141	203	213	218	314	205	269	149	158	245	123	187	177	221	163	238	185	139	176	296	118	149	194	310	166	229	144	144	290	213	169	196	154	221	175	146	129	153	240	137	193	211	222	224	180	169	256	175	172	181	122	136	183	162	148	224	244	193	183	196	142	209	179	155	182	158	202	356	162	284	182	161	105	101	184	136	155	207	158	167	201	239	155	124	143	138	171	120	145	173	215	143	183	238	176	154	171	183	301	153	145	120	97	101	263	110	247	92	221	152	224	106	156	229	93	180	147	145	154	169	129	212	158	140	139	152	143	218	212	227	151	165	190	213	212	171	206	112	143	117	139	113	174	186	154	147	188	96	123	171	88	95	162	138	169	149	120	182	150	99	103	170	148	138	136	107	144	77	152	141	296	108	138	151	142	113	99	167	138	108	96	178	100	131	176	135	144	132	222	151	141	91	141	174	145	119	108	141	136	139	143	239	78	133	149	92	157	118	135	211	183	128	144	130	114	120	235	233	135	156	309	128	115	108	133	141	60	137	122	130	145	133	123	238	125	118	140	189	152	147	150	107	136	180	174	109	156	106	92	129	147	93	123	70	119	120	152	154	110	89	132	136	84	114	258	150	97	105	153	144	141	143	216	76	132	86	120	122	95	74	105	154	99	95	111	115	154	110	108	66	118	105	144	86	189	150	128	145	121	136	156	79	146	135	103	71	93	137	146	106	107	125	128	82	86	121	272	211	82	125	84	115	122	71	71	139	87	136	105	83	80	86	107	118	104	57	132	116	154	67	112	125	135	73	125	82	108	152	153	63	94	78	150	65	81	85	76	168	128	110	98	139	145	140	122	137	112	88	81	157	143	90	112	90	63	96	85	156	56	104	165	78	78	118	120	139	101	158	187	144	99	50	103	99	71	82	101	99	100	51	76	98	86	102	57	99	60	104	74	146	65	60	149	94	71	86	112	75	88	82	74	57	97	78	69	91	72	118	132	87	85	111	100	50	67	53	86	73	68	94	110	66	106	201	104	88	80	62	95	63	90	110	73	76	55	41	136	81	87	94	93	70	137	109	107	95	94	74	84	96	94	80	97	153	51	97	93	66	68	43	96	81	85	87	92	96	92	100	60	79	75	68	101	100	113	101	114	65	57	63	68	73	78	72	62	68	96	59	55	83	56	93	59	68	64	52	72	69	90	81	251	94	54	76	62	98	67	88	121	72	61	77	48	105	93	83	90	117	85	79	68	74	53	109	63	79	146	58	61	61	67	66	102	54	95	59	90	86	51	74	90	54	58	49	81	58	66	47	56	69	48	68	69	77	59	103	65	99	54	74	74	51	98	62	89	83	100	107	60	73	66	54	82	70	65	52	91	62	77	96	88	59	75	101	63	45	60	68	54	67	65	54	84	59	64	54	58	58	58	58	60	45	49	62	75	50	71	124	68	71	62	42	53	54	82	70	56	92	55	29	86	49	42	45	62	66	59	105	74	62	51	52	47	60	39	100	90	41	64	59	108	51	83	36	36	45	56	41	36	50	50	41	67	42	42	60	31	143	128	70	44	73	48	54	48	45	64	48	61	134	93	69	29	58	61	29	52	68	48	51	76	57	65	58	72	51	46	120	38	66	32	37	44	43	94	63	48	92	35	47	43	81	43	73	29	62	75	98	98	47	94	23	36	56	56	58	60	63	50	55	38	51	46	60	30	77	109	56	59	53	63	72	55	80	47	52	59	44	86	46	57	56	70	32	89	43	35	43	45	32	51	39	33	28	30	102	65	40	38	56	35	41	38	37	42	31	35	29	48	28	68	11	37	52	43	65	51	45	36	80	44	60	47	75	39	21	36	46	43	49	24	46	38	33	76	34	22	56	48	28	26	25	21	16	30	19	69	59	29	47	61	45	56	35	29	28	20	52	24	45	40	31	47	27	44	57	48	40	41	44	43	26	30	48	44	45	39	19	30	32	41	47	46	33	38	32	23	24	54	31	24	21	29	20	44	62	37	44	49	21	21	41	25	26	13	204	28	18	42	19	42	31	48	39	56	34	27	22	72	30	45	15	21	35	28	35	33	14	100	18	16	35	28	27	16	48	23	59	44	14	13	27	18	18	27	31	23	25	31	12	34	19	20	26	27	37	39	12	19	36	51	21	42	48	24	20	11	28	43	19	17	12	27	33	63	36	21	21	11	22	21	18	29	27	31	32	16	17	30	26	23	36	38	32	13	25	8	32	19	18	10	25	22	22	14	32	34	27	11	19	7	16	17	11	11	35	10	21	26	26	17	28	5	14	8	29	15	9	22	21	27	14	13	10	13	23	17	17	24	36	20	24	25	13	22	9	28	9	18	9	17	13	54	10	81	12	12	19	3	23	10	9	7	11	20	7	11	14	8	48	15	19	7	13	13	17	30	6	7	6	4	9	11	7	11	7	19	6	10	10	30	6	15	26	13	5	14	7	6	26	5	6	7	11	8	18	5	12	6	21	6	14	13	9	6	2	6	3	8	2	3	8	10	21	6	3	38	3	10	2	3	1	4	6	4	15	3	4	43	8	14	6	5	5	4	0	7	10	2	2	6	4	3	6	0	2	7	1	3	0	7	3	3	2	3	1	0	0	0	3	1	2	7	0	2	1	4	2	0	19	2	2	0	0	0
ne0213	4925	4120	2901	2038	3120	1936	1597	1638	1576	1965	1698	1766	1714	1524	1009	1513	1472	1810	1077	1340	958	1459	1183	970	1532	1321	1300	1223	1606	1097	1283	1508	1160	1009	1098	933	917	979	1356	652	1286	945	2520	996	1217	978	1075	889	927	1023	1047	831	840	991	1332	779	888	855	1094	970	907	826	804	843	834	977	1026	713	990	1001	930	967	980	598	862	756	655	814	1046	1250	749	925	638	1094	596	851	1229	769	796	808	549	695	730	762	1020	787	742	521	855	655	589	592	487	779	574	784	771	804	727	846	827	861	659	743	685	676	749	578	699	797	592	743	684	911	800	502	825	988	709	715	589	672	623	681	854	523	2079	828	708	715	648	480	830	599	569	408	542	841	776	687	674	838	479	711	572	1162	605	886	626	313	622	621	559	424	576	556	623	408	655	466	635	641	591	370	580	614	434	640	511	675	363	390	653	459	717	475	649	498	746	580	545	486	1156	507	661	344	646	574	488	406	442	1000	846	622	658	415	848	408	507	767	585	567	1305	542	407	387	794	423	471	515	338	621	440	583	389	328	505	439	874	671	520	608	613	503	540	373	260	512	399	547	321	394	614	404	412	503	292	595	830	525	379	384	473	525	280	518	363	412	635	593	453	426	702	456	429	367	456	322	502	590	372	479	448	352	376	434	487	560	604	619	589	559	755	597	293	413	428	398	413	522	343	572	371	791	336	686	218	336	400	457	333	378	406	413	492	372	602	251	355	544	393	420	360	330	543	414	498	540	349	339	331	394	521	281	318	165	402	508	477	388	676	341	411	267	371	489	443	262	255	372	440	461	203	223	279	516	491	369	424	491	313	482	296	383	481	312	693	726	424	470	251	306	166	319	371	310	393	250	356	458	403	354	232	385	451	396	299	358	425	329	300	234	353	351	521	257	317	321	318	502	297	172	280	429	457	323	517	488	377	358	378	134	312	348	402	471	443	401	237	332	430	352	418	250	788	291	293	341	264	362	272	394	230	192	237	200	483	308	311	440	107	322	461	269	214	438	372	476	442	330	280	303	642	516	410	287	237	321	345	249	278	251	356	296	307	290	233	334	339	357	381	702	245	296	376	290	316	228	317	455	311	208	323	284	206	333	314	214	186	439	209	192	170	460	313	480	318	197	100	331	296	448	324	304	231	333	337	358	283	172	452	238	320	166	90	322	454	435	213	273	329	232	341	451	277	199	298	337	300	209	281	280	164	217	299	269	398	362	200	266	328	248	279	321	159	183	530	234	235	286	505	325	245	274	308	678	189	223	206	227	223	315	212	337	185	210	374	342	463	234	224	118	415	175	315	347	252	265	300	437	321	251	291	311	347	96	242	269	154	225	174	173	189	285	232	125	272	183	201	223	477	206	160	141	164	159	225	407	168	239	255	210	141	215	200	235	233	130	205	165	129	179	171	213	225	165	184	265	193	133	323	168	241	146	168	198	241	230	201	412	381	306	336	177	303	189	206	273	849	429	209	367	180	185	279	173	132	203	127	302	199	257	245	288	194	309	219	113	223	197	232	134	274	198	146	232	196	173	206	264	97	215	264	50	142	205	371	162	205	132	210	342	163	206	136	146	229	133	129	180	243	261	135	318	262	198	203	142	199	148	248	224	237	187	259	94	158	158	189	139	184	183	232	119	136	241	167	194	131	175	240	267	193	120	130	179	200	146	187	179	181	163	146	102	226	205	176	133	182	650	145	460	156	184	211	227	227	146	192	213	79	176	233	319	162	200	245	134	245	152	400	168	121	100	152	159	480	158	371	163	126	155	90	164	212	173	157	123	109	199	82	91	112	142	208	121	433	156	187	149	152	150	415	194	121	215	239	156	178	274	151	152	243	159	139	241	170	116	151	262	172	79	120	110	66	123	252	174	75	146	208	117	118	189	204	64	101	127	142	127	189	167	186	82	128	150	154	225	197	241	203	290	27	196	73	135	125	125	143	90	197	324	153	79	171	233	157	113	113	133	114	104	119	121	185	96	153	269	119	301	149	95	68	90	56	133	123	250	171	211	106	152	171	82	169	64	76	91	297	182	118	242	121	125	184	157	139	161	194	171	137	134	120	179	99	158	128	114	424	96	172	156	73	89	208	98	125	106	142	123	47	101	113	173	103	79	149	83	158	106	92	196	142	66	106	75	123	212	154	178	60	168	120	108	75	124	108	105	107	83	111	91	96	112	246	109	75	133	122	74	108	88	136	93	129	87	115	173	107	81	188	138	66	84	99	160	92	198	146	145	141	51	101	148	115	47	151	121	151	76	114	70	214	62	139	122	40	74	86	62	209	144	108	67	122	193	76	131	97	149	169	112	126	105	77	72	150	153	93	144	107	128	95	84	118	84	113	52	105	91	131	145	111	46	183	118	128	116	63	136	48	128	103	79	116	77	131	80	81	96	141	83	42	121	92	86	149	51	65	111	99	254	59	89	93	64	94	110	106	110	67	85	100	61	82	153	60	81	91	242	161	45	568	78	104	128	140	129	130	84	70	113	132	125	75	73	190	131	86	54	87	69	61	61	85	165	72	83	93	74	139	83	95	68	106	125	91	87	58	92	88	109	139	144	120	87	112	127	98	63	99	77	62	100	91	85	86	88	129	97	167	128	29	48	60	197	177	190	160	68	75	60	101	177	65	64	112	104	337	43	64	72	123	91	213	92	101	57	175	100	78	78	114	123	63	69	73	62	92	119	58	75	50	137	50	115	63	87	57	97	100	78	48	86	72	51	51	119	90	73	66	96	60	31	36	52	108	85	141	106	151	77	132	116	95	78	53	176	11	75	54	61	93	55	92	84	42	38	112	103	73	85	75	42	108	86	66	65	95	47	114	118	101	65	176	71	114	102	365	178	125	100	59	60	57	117	83	95	49	44	61	45	83	66	35	84	106	108	74	54	38	59	39	50	39	66	96	63	91	43	67	134	66	99	54	145	73	65	80	78	77	31	46	39	79	92	76	87	40	66	46	81	55	45	63	52	55	45	73	86	21	36	80	197	60	52	33	121	73	38	90	50	58	77	241	46	56	93	42	35	81	82	28	47	71	53	34	204	83	19	63	65	87	37	97	58	36	109	67	78	105	30	23	54	87	35	195	49	84	61	142	67	66	96	33	83	66	50	47	38	32	105	35	63	83	62	53	64	69	107	61	36	37	96	62	41	86	51	67	60	59	320	57	32	39	37	89	67	56	79	64	70	44	130	70	21	58	48	30	92	61	57	24	58	57	58	23	38	45	57	52	38	73	68	77	56	52	22	24	178	31	51	34	66	135	71	27	28	30	69	88	52	50	47	32	32	28	46	89	21	8	45	56	42	53	118	31	90	35	79	37	69	115	43	41	60	45	32	59	25	56	90	28	51	15	31	41	13	32	58	34	47	27	24	29	118	113	42	44	54	52	43	45	94	18	52	45	28	37	22	18	31	49	26	57	72	33	67	11	46	24	53	20	28	71	39	82	28	62	35	29	15	49	41	28	36	17	65	11	104	59	24	55	41	40	27	34	72	66	272	63	31	78	33	21	149	66	37	86	58	16	10	55	66	33	22	28	26	26	35	8	16	38	56	31	34	53	52	24	40	43	52	13	9	16	85	22	114	33	13	34	51	76	22	41	14	42	23	100	20	47	34	6	18	39	15	14	16	41	22	24	52	33	36	37	35	6	21	39	25	31	30	17	22	43	28	34	21	11	35	22	14	16	27	15	81	53	28	145	43	24	14	64	31	25	39	22	11	35	17	17	14	14	30	11	7	90	24	6	29	13	12	8	16	30	11	50	11	8	11	17	60	57	63	19	26	18	54	22	17	40	34	29	14	40	26	11	27	23	7	8	56	12	17	11	11	87	16	104	9	30	4	6	8	16	3	14	9	37	8	12	8	25	11	5	17	22	71	19	8	10	16	43	12	4	16	3	3	14	13	3	9	2	15	14	7	12	15	33	25	16	4	5	3	15	13	7	15	5	17	9	19	5	4	9	7	10	13	2	18	25	21	3	5	3	21	0	2	4	1	11	11	4	5	1	3	2	15	11	10	1	5	1	14	6	4	11	21	9	7	29	3	4	2	3	12	12	1	8	2	24	17	4	0	26	0	0	0	19	2	0	2	1	2	1	3	6	6	1	0	0	0	5	4	0	2	0	0	0	2	25	0	0	1	0	0	1	0
ne0215	470	552	266	345	245	249	239	207	192	128	149	175	169	170	210	168	141	157	169	159	191	124	168	109	90	130	123	166	117	179	134	81	79	129	146	140	79	89	105	188	105	99	103	68	102	140	107	67	117	61	115	101	136	104	80	120	106	134	80	142	106	139	190	143	99	88	98	104	88	78	80	73	76	101	100	113	98	81	63	110	63	87	100	92	128	90	66	51	81	58	113	85	105	96	82	86	89	104	49	42	58	86	73	83	59	57	55	87	90	77	56	45	91	74	99	63	85	75	84	81	127	88	139	40	54	73	52	71	83	78	58	57	70	75	96	101	51	54	82	60	77	60	78	56	72	49	48	54	60	57	60	55	65	43	69	66	57	59	83	61	59	41	46	62	83	54	36	95	73	69	71	54	37	83	73	77	42	65	51	45	55	98	73	84	58	73	78	50	52	59	135	30	61	37	41	62	76	72	77	28	43	66	55	48	56	53	74	46	74	39	69	40	65	40	73	84	49	62	42	52	83	62	63	29	70	34	66	73	61	56	65	32	59	42	40	96	66	35	49	43	32	89	58	127	85	36	36	51	61	56	46	54	56	45	45	62	54	55	70	44	42	48	52	29	79	41	33	40	45	49	31	31	42	37	50	58	50	44	54	37	64	47	27	59	53	86	69	46	34	28	42	66	47	39	88	79	45	76	40	32	54	63	45	33	27	41	32	47	64	42	66	53	46	33	37	76	22	62	32	78	34	51	33	54	29	69	31	39	36	37	38	40	26	51	32	28	27	69	66	35	29	18	85	55	43	46	24	45	44	41	30	58	52	41	32	30	39	52	96	14	27	61	55	34	66	44	33	47	76	20	46	67	38	24	23	43	63	56	33	43	32	34	36	25	61	36	37	33	19	21	51	90	50	37	40	21	48	48	42	30	38	46	33	17	29	39	40	100	34	32	23	36	29	33	46	67	26	35	29	15	30	55	21	39	24	13	29	19	49	33	44	37	27	23	25	21	40	32	65	18	32	64	36	41	32	31	48	57	24	30	18	42	25	16	36	41	43	17	46	27	35	18	37	41	33	37	28	17	27	24	42	17	29	34	107	19	27	29	51	39	16	31	20	25	29	34	21	36	41	46	19	30	57	34	30	27	21	39	21	33	11	36	17	49	49	27	39	27	27	14	19	33	24	21	23	23	21	23	27	17	22	22	28	53	33	23	31	28	27	39	32	23	13	19	45	24	18	40	49	20	27	91	21	30	87	17	43	45	31	27	41	40	38	23	22	25	12	14	17	29	13	40	14	23	14	36	33	15	15	21	28	53	28	19	22	27	72	20	12	12	18	22	18	19	16	25	27	33	24	28	38	31	16	41	29	73	8	34	13	28	10	34	43	22	18	21	31	22	29	26	25	21	20	37	12	21	17	14	19	25	29	33	9	46	30	21	23	16	15	22	24	28	23	27	13	32	10	15	36	17	25	35	17	14	39	19	31	20	29	8	23	30	23	14	33	23	32	19	24	22	29	34	21	23	25	17	19	25	19	23	55	56	22	17	12	11	16	21	26	19	30	18	22	21	20	9	48	21	15	39	11	29	30	12	36	16	28	18	12	30	16	16	14	27	7	24	13	22	28	34	18	11	22	12	27	15	28	17	31	27	37	33	11	22	37	24	14	15	12	11	46	14	51	18	11	35	19	22	10	26	29	29	8	9	9	12	17	10	15	16	20	17	21	15	13	14	15	24	33	14	22	8	15	17	9	39	18	16	14	28	28	12	13	24	10	10	23	25	15	16	13	18	19	14	21	12	4	22	18	14	21	28	11	13	17	7	15	15	14	27	3	27	15	15	17	26	10	11	19	6	31	12	25	17	11	28	7	7	12	16	44	13	10	6	8	26	21	20	15	20	26	30	10	84	10	10	14	13	16	14	9	17	11	7	26	10	20	18	11	42	30	20	22	12	19	14	26	19	13	8	19	13	14	13	15	21	14	16	22	29	1	14	34	9	21	18	13	17	14	15	21	11	22	30	11	16	7	12	19	24	10	15	34	9	5	9	14	16	7	4	26	10	17	8	12	15	15	21	10	26	18	3	10	8	10	21	14	7	15	29	32	6	17	16	20	25	7	18	7	26	24	7	6	21	29	31	12	13	5	8	14	11	17	11	3	10	25	5	19	13	17	12	13	6	11	29	14	29	11	18	4	14	12	19	6	24	6	10	17	10	14	12	10	9	14	20	7	4	16	33	11	14	23	21	17	22	8	10	18	16	19	5	20	17	13	9	26	11	10	15	8	4	25	9	3	12	2	15	16	4	19	7	6	13	4	5	21	4	11	5	14	12	9	28	17	12	5	12	5	13	20	12	10	11	6	17	7	20	19	10	29	6	6	10	19	39	10	10	7	5	11	10	20	16	7	16	4	5	11	7	10	6	6	6	12	16	5	6	18	12	14	12	8	20	15	13	7	24	15	12	10	7	8	10	15	16	67	10	5	27	9	10	6	14	4	18	14	13	9	12	6	16	11	7	17	10	12	14	5	5	16	6	25	6	7	11	10	3	24	15	15	7	13	6	16	7	6	8	10	17	1	7	8	10	1	7	7	9	5	4	16	19	9	14	12	6	8	5	28	8	8	15	14	8	9	2	1	5	8	6	13	5	7	2	8	4	11	3	16	18	20	13	6	4	20	16	9	7	23	27	4	7	6	15	6	12	10	11	32	8	2	11	10	11	14	9	4	2	8	13	6	5	8	16	9	20	3	21	18	12	13	6	34	3	8	0	7	8	16	9	6	10	8	11	2	8	7	9	3	3	13	5	11	3	1	6	0	12	14	9	17	13	7	7	2	4	9	7	3	5	5	5	4	5	14	13	6	4	8	8	4	13	11	13	3	10	6	7	8	15	12	7	3	16	7	9	12	11	10	4	8	8	6	14	8	13	3	15	4	7	11	2	12	8	7	7	1	2	9	17	7	8	5	3	4	15	1	8	11	4	21	6	10	15	6	8	10	6	1	9	5	6	4	4	7	3	5	8	8	14	6	5	6	4	2	9	5	5	4	16	16	3	5	7	3	10	9	10	17	4	13	5	14	14	8	14	9	8	5	2	4	7	8	8	7	4	3	4	4	4	4	5	1	2	3	15	2	4	5	7	16	5	5	8	9	7	12	2	10	1	22	4	3	8	4	4	5	4	4	2	5	5	3	12	7	6	6	5	6	5	3	8	0	7	3	5	8	4	7	2	5	10	10	11	1	20	8	13	5	5	7	4	8	4	10	5	7	9	30	5	5	0	11	11	3	6	5	16	1	4	0	5	4	2	7	6	2	9	18	7	8	2	5	16	6	2	7	1	3	4	3	5	1	2	7	6	3	14	16	4	3	2	12	5	2	4	7	9	2	1	11	0	8	12	14	5	8	8	5	4	5	5	11	10	6	5	3	5	8	3	9	0	4	6	1	2	5	2	5	5	7	0	1	3	5	1	4	4	5	7	0	8	3	3	5	1	2	1	8	0	2	1	1	1	9	9	17	2	7	3	6	10	0	2	2	3	5	5	6	3	1	6	2	3	6	3	13	1	15	4	2	2	3	0	1	3	2	4	1	2	16	2	2	4	2	2	5	0	8	2	5	4	5	5	6	2	1	6	1	5	4	13	13	1	1	0	1	3	5	5	2	1	6	1	3	8	3	1	0	2	1	0	1	1	5	5	9	1	4	2	5	5	2	2	10	3	1	3	0	2	5	2	1	3	2	4	2	4	3	3	9	2	2	1	1	1	4	4	0	0	0	1	5	1	2	1	1	0	0	9	0	2	2	15	0	8	1	1	4	2	2	1	0	2	0	2	2	1	1	4	0	4	1	2	2	12	0	9	6	2	2	0	4	5	0	0	0	1	1	6	1	3	0	1	2	5	2	0	0	3	3	2	2	0	0	1	1	1	1	4	3	4	1	2	5	0	2	2	0	5	0	2	0	0	1	5	2	1	2	1	13	0	1	1	1	3	4	0	3	4	3	0	4	1	9	0	3	2	0	4	0	0	0	1	1	13	0	1	0	0	1	0	1	3	0	0	0	4	3	0	0	0	2	0	0	2	0	0	0	3	3	0	0	0	0	0	1	0	0	0	0	0	0	1	0	0	0	0	3	2	0	0	0	0	0	0	0	0
ne0216	566	733	367	329	305	226	241	170	175	158	170	143	178	150	214	159	206	130	221	143	140	156	200	121	143	149	190	165	180	205	131	138	123	106	161	132	143	105	104	182	164	137	102	78	113	129	122	103	236	108	76	98	141	140	75	148	71	91	106	126	78	156	143	101	93	65	84	94	117	75	136	114	120	110	90	97	83	82	74	127	86	101	58	94	119	77	69	67	97	112	140	94	60	79	104	115	57	95	73	69	79	100	101	90	99	64	130	62	140	54	86	54	67	55	60	115	54	100	88	45	77	67	96	90	67	78	103	84	49	51	66	69	98	105	92	135	56	87	52	80	53	94	72	68	94	81	81	76	51	91	79	84	60	76	76	49	91	73	44	60	65	58	69	61	112	45	91	70	91	57	138	73	67	107	35	112	45	40	40	71	65	107	64	40	92	71	97	105	36	45	74	43	69	57	43	46	82	46	70	41	51	73	102	72	92	57	65	61	108	43	36	56	59	43	112	90	38	57	105	44	47	78	95	42	109	55	41	78	71	53	61	59	59	74	56	111	66	42	48	69	71	75	64	136	24	47	49	70	67	82	60	36	56	45	69	32	89	88	63	53	52	53	42	43	97	72	50	43	37	70	67	80	58	59	31	69	48	74	80	36	68	51	32	88	45	128	78	73	68	51	31	61	41	44	124	61	48	34	61	71	51	72	42	53	38	48	29	86	33	36	36	55	28	40	71	32	33	57	40	54	52	89	44	52	29	71	65	40	56	34	32	53	56	43	30	28	59	62	53	31	53	29	76	63	38	73	36	39	34	49	60	55	37	55	53	38	63	45	87	45	35	69	51	33	66	53	35	55	65	31	50	35	36	28	45	64	28	34	41	46	54	41	50	44	66	50	24	37	45	27	42	92	36	66	53	51	53	45	79	25	59	56	39	30	46	27	26	64	23	37	12	46	43	39	54	24	17	47	35	26	42	47	45	60	51	36	36	36	62	24	33	33	40	35	29	50	43	43	64	44	19	50	47	36	53	45	35	16	70	22	45	43	46	44	25	29	50	24	43	71	47	25	46	63	32	19	30	29	27	43	46	19	28	55	93	35	46	16	36	49	24	77	29	28	22	50	43	41	41	56	18	30	41	30	21	41	20	51	19	41	22	45	28	26	36	26	30	24	40	37	21	51	25	29	43	34	43	17	38	26	44	19	25	82	49	50	27	41	50	41	37	57	26	16	59	21	20	39	31	27	38	49	15	28	46	24	60	32	48	36	58	17	30	24	49	39	34	14	36	41	16	46	32	29	17	27	47	22	30	13	24	16	43	16	37	21	40	9	28	17	17	37	35	17	23	29	37	30	26	19	30	45	26	26	27	47	28	26	28	41	37	29	34	36	36	28	33	26	15	80	14	14	21	25	38	15	31	40	25	23	35	18	20	32	33	38	43	37	25	15	27	22	20	45	20	15	17	36	33	9	36	70	36	28	31	16	30	25	28	18	30	24	25	23	43	21	15	25	42	18	47	30	13	24	22	29	17	29	31	33	60	15	14	19	15	23	11	23	22	46	15	20	25	23	29	13	28	24	23	22	13	25	32	12	46	8	30	41	20	20	19	26	19	49	11	20	35	39	23	25	19	20	28	13	22	9	22	24	25	40	21	29	17	14	16	14	21	25	34	12	49	13	36	34	15	17	18	23	21	20	20	17	18	28	22	19	19	15	21	22	9	34	17	26	16	19	37	24	31	12	24	12	28	28	9	24	17	31	20	28	34	20	23	13	22	11	19	22	19	14	20	21	19	10	8	8	13	18	12	19	21	23	14	5	15	18	12	32	9	33	16	16	17	20	17	34	10	20	13	23	27	11	19	24	11	41	12	24	14	22	43	16	3	18	14	31	17	16	15	35	18	13	15	37	14	13	17	22	22	29	10	16	12	10	23	12	32	26	16	25	14	26	17	16	30	9	22	13	10	9	20	9	12	21	20	8	23	8	18	25	12	24	33	18	22	21	18	15	15	14	37	16	25	23	9	22	19	15	32	13	25	12	15	12	16	15	25	21	17	14	17	20	28	5	17	13	18	24	19	21	21	4	9	13	21	11	10	14	16	15	32	8	20	11	14	8	9	42	7	19	18	9	16	11	16	25	10	24	12	16	24	17	14	20	29	15	26	23	9	9	16	16	13	5	6	29	18	37	17	10	17	20	14	29	9	17	10	6	15	15	13	24	10	13	8	8	17	13	8	37	36	14	21	13	8	21	6	18	20	37	23	19	13	12	9	11	15	12	12	11	21	9	22	13	10	9	2	20	27	16	21	13	2	23	7	5	10	12	7	10	14	7	15	17	12	6	14	9	18	9	20	14	21	11	20	8	8	16	15	9	20	8	12	29	9	26	23	17	13	20	7	9	28	14	17	6	8	7	9	7	12	8	5	11	8	29	18	9	24	8	12	5	13	10	5	15	12	8	20	16	12	22	9	15	11	19	39	11	6	16	22	11	4	5	7	6	11	9	15	24	13	16	20	14	8	11	8	13	6	8	17	12	14	22	15	16	9	5	11	11	17	13	10	7	18	17	6	13	20	18	4	9	14	9	6	17	13	17	9	17	18	12	6	13	5	16	9	12	8	7	17	4	17	9	2	8	13	9	10	7	13	10	16	7	9	8	26	10	6	23	7	5	8	6	17	11	4	7	11	10	6	8	5	39	10	11	18	13	17	12	5	19	6	8	16	5	14	8	13	6	8	8	9	11	10	7	6	7	30	17	14	3	13	5	2	6	13	15	7	14	15	9	13	10	13	4	7	15	15	11	8	13	10	7	9	4	9	10	17	31	15	8	7	6	4	14	7	11	6	15	13	1	4	11	13	12	7	6	10	11	6	5	7	10	6	11	12	10	10	6	10	7	10	9	18	14	3	12	4	10	9	9	26	24	7	16	8	5	6	2	8	9	10	20	8	10	7	5	7	9	5	8	5	3	9	5	4	4	10	3	13	8	21	10	6	7	11	8	7	6	11	3	9	9	13	5	5	10	19	9	6	6	9	4	4	1	3	8	10	7	23	25	10	5	6	3	10	13	10	4	6	13	5	20	10	23	10	8	5	6	7	9	5	16	5	9	2	6	1	1	9	6	4	2	4	8	5	9	11	10	22	9	10	11	8	4	11	3	2	3	18	9	3	8	2	4	16	7	2	3	8	1	6	7	6	3	15	3	6	9	5	8	2	6	6	8	7	8	4	0	9	11	8	10	7	24	13	17	10	5	3	6	2	5	9	7	10	2	22	4	0	2	6	3	8	10	11	4	6	6	7	4	20	7	3	8	12	3	14	2	23	2	7	9	8	1	3	2	2	3	4	5	5	9	7	11	5	18	6	5	1	7	9	10	4	3	3	12	0	5	7	1	6	19	8	5	4	5	5	5	3	5	17	3	5	11	6	1	7	4	11	3	3	4	3	6	2	10	7	8	1	7	8	3	2	7	2	6	5	1	3	6	8	3	5	4	8	8	4	9	3	2	1	3	11	5	8	2	10	8	6	0	2	3	9	5	8	5	0	2	1	11	1	8	1	2	4	2	5	3	2	7	0	2	14	2	6	3	1	4	1	5	5	1	2	3	1	1	2	0	1	2	5	1	4	2	1	4	0	6	2	8	10	3	3	15	2	0	6	3	2	0	12	1	3	4	1	1	5	2	2	2	3	1	6	1	6	9	4	1	4	6	6	0	2	3	7	1	1	1	2	9	2	0	1	2	1	3	3	5	5	1	1	0	0	2	3	2	0	2	0	0	3	1	2	0	1	6	1	5	0	1	3	9	8	4	1	3	1	2	2	1	1	3	2	0	2	6	10	9	1	8	1	0	0	3	2	2	4	0	0	5	5	4	2	1	2	4	2	1	2	1	2	3	1	0	0	4	4	0	17	3	1	0	0	2	7	0	2	1	2	3	5	2	2	2	0	1	2	1	5	0	0	0	2	3	2	0	1	0	1	11	3	1	1	1	2	0	5	5	4	1	0	1	10	0	0	3	2	3	0	0	1	1	3	2	1	0	0	0	0	1	0	2	1	0	1	2	2	1	2	0	3	2	0	2	0	0	0	0	0	1	0	1	0	2	0	1	1	0	1	0	0	0	1	0	0	0	1	0	0	0	1	1	2	0	0	0
ne0217	573	717	213	193	137	282	223	203	113	185	82	211	221	250	210	237	308	62	292	206	124	152	170	64	80	57	76	284	160	173	57	199	135	133	152	116	79	48	86	197	112	111	63	54	87	118	113	142	346	133	96	74	31	67	82	153	26	43	145	26	131	97	73	68	61	135	146	76	102	95	69	98	145	129	24	25	70	83	107	82	74	107	89	92	41	97	79	57	65	111	90	163	100	113	60	90	80	21	82	36	63	123	35	100	65	88	44	99	67	78	137	100	137	116	90	93	82	102	36	90	74	90	35	164	123	30	90	11	82	99	29	185	17	66	89	69	37	40	81	30	75	137	61	27	92	99	52	39	81	126	55	31	150	104	77	36	199	100	93	57	22	82	48	33	184	24	103	121	39	37	68	17	114	55	70	70	23	99	25	35	14	123	46	77	19	23	50	145	48	40	77	77	35	42	22	22	29	117	83	41	80	21	20	44	12	31	54	55	166	72	71	11	63	100	227	40	27	41	139	20	13	14	48	114	57	25	30	44	66	45	43	66	28	54	54	23	84	21	22	21	33	66	38	38	39	86	36	29	28	185	8	27	108	16	45	70	51	82	64	28	41	23	58	79	44	124	77	16	37	31	47	30	42	14	27	21	30	55	64	27	14	33	14	11	18	45	98	55	74	168	14	30	20	86	42	34	41	50	111	31	19	41	32	42	73	31	15	40	57	15	19	31	31	20	79	48	60	25	16	19	37	72	20	8	23	49	61	58	49	1	34	66	95	14	28	67	32	51	27	11	101	62	41	149	46	83	121	50	0	19	22	15	24	43	38	37	25	67	29	24	19	54	49	14	74	12	35	24	20	66	15	14	68	22	7	45	57	79	17	11	16	35	20	28	38	31	18	62	25	7	15	23	38	33	6	23	51	28	42	16	32	46	33	17	70	42	20	250	12	33	17	18	59	25	25	56	26	31	29	23	45	14	63	24	118	19	43	42	15	29	42	21	9	14	14	58	9	34	61	11	22	13	35	35	111	25	15	55	57	14	8	5	13	12	14	20	72	50	21	148	46	26	30	45	38	53	17	8	22	21	13	13	44	36	24	41	55	9	12	30	19	22	38	2	33	68	31	21	18	58	1	46	22	9	12	7	34	63	18	43	17	15	28	3	19	4	5	74	37	43	21	19	24	12	14	15	7	10	17	2	15	12	20	156	27	12	17	87	26	17	81	24	44	13	30	16	14	63	10	34	34	15	14	33	16	20	80	19	47	71	19	27	14	7	25	26	64	19	25	6	13	31	36	17	10	18	14	19	6	7	0	42	11	12	15	16	16	9	2	22	16	26	14	13	16	10	29	27	32	41	26	18	6	17	5	20	19	21	49	30	55	18	25	30	6	14	12	1	5	30	5	21	41	16	13	6	16	11	9	12	42	8	19	39	28	22	32	26	5	36	31	6	10	16	8	14	5	87	18	5	51	84	4	12	13	12	18	54	24	7	21	12	18	6	4	45	20	14	3	2	73	12	4	18	9	40	21	24	4	30	5	3	19	16	6	20	4	18	14	20	3	13	23	14	16	5	11	11	16	3	11	60	12	24	5	2	35	26	33	6	4	44	17	10	16	25	1	25	27	46	33	7	7	17	11	7	23	6	12	18	6	14	18	14	2	8	20	15	8	16	62	14	33	9	5	7	8	8	7	11	19	25	11	60	44	16	19	1	75	3	5	6	6	21	4	7	8	46	2	8	10	14	10	26	0	4	11	53	28	28	4	32	9	10	8	14	32	30	27	6	9	18	24	8	4	11	19	20	7	8	23	21	19	1	15	39	43	13	16	41	4	3	6	31	7	40	5	21	28	39	4	9	18	1	1	7	9	37	5	6	12	16	3	32	13	18	12	35	30	26	2	1	3	14	12	13	14	36	4	5	11	25	1	5	8	4	4	25	1	5	6	66	15	4	4	6	26	11	11	1	1	15	20	14	17	3	6	19	3	27	8	3	21	13	33	11	17	14	5	25	45	58	11	3	20	10	8	8	14	1	4	11	0	4	2	6	22	19	11	14	21	30	13	4	11	3	9	34	19	6	21	11	7	13	13	37	6	12	18	4	10	17	31	30	12	0	10	16	4	4	5	21	10	3	8	9	3	30	9	6	0	30	11	5	7	12	24	26	2	18	14	6	6	4	15	10	6	24	6	6	11	7	4	22	4	10	8	4	5	0	5	22	4	2	3	0	7	9	4	13	10	20	24	5	8	8	3	1	9	10	11	6	0	3	2	22	3	11	5	14	3	6	1	3	15	5	6	23	6	3	14	17	0	3	27	10	1	7	5	7	28	4	14	3	3	10	13	6	6	11	22	12	21	15	42	7	10	1	16	1	9	9	1	20	2	6	37	1	44	6	2	22	12	10	2	1	4	8	0	5	18	12	7	14	6	9	30	0	21	5	29	3	10	4	2	8	5	0	15	10	7	8	4	4	3	9	9	4	1	13	33	33	5	7	25	0	2	10	1	24	14	14	39	8	0	1	36	9	2	6	9	15	1	6	11	5	4	4	3	7	29	0	19	4	3	13	7	9	4	13	25	6	8	10	10	8	4	6	9	16	6	3	10	2	5	28	3	24	0	3	22	3	4	8	8	5	3	35	15	35	2	2	5	2	5	5	2	1	10	9	6	7	14	5	4	1	4	2	6	69	4	0	17	46	10	1	0	5	3	9	20	11	5	3	6	3	6	11	12	25	16	6	3	5	4	2	13	1	1	34	3	14	1	9	3	11	4	2	0	18	7	4	2	7	29	9	0	25	3	5	0	10	36	1	9	6	2	0	10	5	3	2	16	6	3	9	0	10	0	11	11	1	1	15	0	3	5	5	2	1	2	4	12	3	0	5	15	15	0	18	11	3	0	1	28	15	0	5	2	1	3	1	9	4	5	4	9	2	14	3	18	11	10	18	3	10	4	1	0	14	5	12	3	17	5	0	22	3	12	1	28	2	1	1	2	3	7	1	3	3	3	22	7	16	0	7	1	5	11	1	1	4	13	29	3	0	7	1	1	0	8	26	13	1	1	3	2	0	5	4	1	0	2	6	6	1	0	3	1	3	7	1	2	1	4	3	4	5	1	1	4	0	8	4	3	1	5	6	2	3	4	1	1	4	13	8	9	0	1	5	7	18	5	5	3	3	0	7	9	14	8	9	2	0	4	2	14	2	30	4	1	1	5	4	15	3	5	2	2	14	7	19	2	2	1	13	0	6	4	9	2	1	7	4	1	3	2	2	18	1	0	0	6	1	30	4	4	7	3	4	0	2	0	29	2	0	7	4	11	1	1	3	2	16	1	2	12	3	2	3	0	7	10	2	4	1	0	49	1	4	1	5	5	1	1	0	5	4	0	1	6	3	2	1	4	11	4	0	0	0	1	1	3	2	0	11	5	22	3	12	3	2	0	7	3	0	0	8	2	4	3	10	5	1	0	7	1	3	0	2	0	5	3	2	0	1	0	8	1	0	8	14	0	1	5	1	2	1	53	9	0	0	1	0	0	16	0	0	1	11	0	5	1	5	4	2	1	7	1	1	6	8	5	2	11	5	0	7	5	4	1	5	1	0	8	1	0	15	0	2	0	2	4	0	0	0	1	0	10	6	0	0	14	1	9	6	0	2	0	2	3	9	9	0	0	2	1	8	0	0	0	0	1	1	0	0	1	1	0	0	4	0	0	1	4	7	1	0	2	2	1	2	0	0	2	1	2	2	0	12	3	1	0	0	0	7	18	8	0	1	0	8	0	2	1	0	1	7	0	0	0	0	1	0	0	0	4	0	0	0	4	0	4	1	2	0	1	0	4	5	3	3	0	3	0	0	0	1	2	0	0	3	3	0	0	4	3	1	2	0	1	4	23	0	1	0	0	0	1	0	0	0	1	0	0	0	0	4	0	0	0	0	0	0	0	0	8	2	0	0	0	0	1	0	0	2	10	0	0	1	0	0	2	0	1	0	2	0	0	3	13	0	0	1	0	0	3	0	1	1	0	1	0	0	0	2	0	0	0	4	1	0	0	0	0	0	2	3	0	0	2	0	0	0	1	0	0	0	0	0	0	1	11	0	0	1	0	0	0	0	4	0	0	0	1	0	0	0	0	0	0	0	0	0	0	0	0	0
ne0218	1655	2033	1052	1343	701	913	1037	765	599	615	406	571	489	433	515	749	690	465	779	479	444	560	586	493	395	406	356	333	473	448	306	424	308	463	298	356	411	277	379	423	502	422	525	339	435	427	444	348	409	274	354	307	250	488	556	328	239	340	291	303	286	351	283	335	218	277	284	281	363	186	416	457	327	286	268	158	274	291	250	278	304	231	310	444	204	301	316	180	279	250	394	317	336	242	276	405	263	339	342	365	190	310	292	399	298	161	313	209	403	381	204	246	250	232	267	402	238	258	250	217	256	321	226	245	229	234	244	288	237	215	138	224	225	223	141	190	230	213	246	211	201	250	433	209	193	163	164	173	153	173	207	205	155	224	226	176	167	176	204	222	166	176	195	141	340	168	180	207	208	267	263	234	161	253	175	251	138	193	180	165	258	256	204	212	223	170	256	198	141	150	337	111	280	133	166	280	350	183	169	122	177	150	370	222	179	195	244	170	186	137	177	97	164	188	530	135	225	91	206	152	110	227	208	112	164	139	142	214	228	191	172	160	133	196	152	249	114	103	137	158	88	186	196	211	173	98	105	162	189	238	147	139	250	170	205	164	273	180	230	124	130	143	131	94	170	169	182	131	76	135	149	180	165	157	114	164	185	197	180	127	155	201	109	132	142	152	134	154	101	148	73	224	82	107	146	207	158	145	164	178	110	224	82	151	129	119	104	133	140	109	134	256	80	160	104	149	94	135	190	142	93	149	124	106	81	159	186	139	117	87	167	130	154	180	108	111	94	148	177	96	153	89	208	253	117	186	90	117	93	121	200	148	157	224	138	97	160	155	136	98	84	152	180	85	138	155	95	145	144	119	96	83	89	128	116	112	129	133	93	158	265	86	141	133	120	113	72	120	115	58	136	157	157	154	132	172	93	150	116	135	79	133	187	91	113	85	95	398	74	55	54	78	142	100	183	142	81	70	63	205	148	120	104	124	105	118	122	70	142	70	124	55	111	101	55	152	75	114	125	109	98	84	117	180	101	121	86	106	118	194	78	137	282	103	58	89	151	84	133	102	134	218	70	155	88	141	111	73	53	136	96	62	98	185	191	85	100	66	76	196	89	109	44	56	132	82	104	98	118	92	74	83	77	56	68	99	77	106	100	101	67	59	66	158	119	37	71	81	129	100	78	93	66	78	92	86	105	71	72	75	96	48	94	244	83	104	106	83	77	185	58	101	51	65	71	40	102	110	56	58	92	80	59	101	72	110	99	99	66	70	163	56	111	104	64	68	90	41	116	125	41	95	86	77	60	72	90	77	104	54	112	88	68	46	97	74	121	108	54	52	60	109	75	86	80	72	80	45	75	81	55	99	50	53	83	135	84	119	92	56	89	48	53	101	91	50	48	40	61	76	64	69	38	52	75	39	80	116	153	64	58	34	69	55	72	90	68	132	42	52	66	88	45	107	30	46	58	108	137	33	131	205	53	91	60	66	87	51	54	42	48	57	48	89	98	47	77	87	62	119	83	57	44	60	69	105	60	102	68	59	117	66	58	66	58	81	29	55	76	89	50	61	81	91	84	54	43	61	50	40	43	58	45	27	71	31	74	59	65	22	50	57	69	98	25	101	54	57	114	60	54	41	60	24	39	16	128	40	109	124	59	53	59	35	38	40	53	38	77	35	66	35	120	69	48	38	34	65	58	48	41	67	61	50	60	34	61	52	53	51	50	85	32	65	31	53	29	59	72	27	103	35	43	103	26	25	105	48	50	62	72	45	65	48	88	41	69	65	53	53	45	101	96	73	34	48	126	98	30	50	47	66	25	29	56	44	66	72	66	60	35	69	39	48	82	66	44	44	99	71	40	50	103	74	37	126	54	31	57	32	153	28	45	33	66	59	97	41	48	94	45	39	31	85	38	48	22	38	62	48	28	37	53	47	45	51	85	90	20	58	39	60	71	28	72	48	53	30	43	34	55	26	27	55	43	25	37	38	51	31	21	45	112	27	74	35	60	30	43	41	81	38	49	52	46	21	29	30	75	38	57	17	30	29	29	25	57	44	35	51	67	38	35	26	27	37	55	60	34	73	35	53	17	20	50	80	14	25	21	26	68	13	106	95	52	25	10	40	21	28	38	32	54	98	48	35	25	49	40	22	41	50	50	36	55	30	58	55	13	26	28	40	32	41	25	32	32	40	24	53	22	41	19	68	32	33	18	22	27	42	25	41	29	51	34	27	50	29	32	33	41	47	78	76	20	42	32	29	37	69	135	15	27	40	20	27	42	55	19	36	29	15	47	32	15	15	36	16	25	46	36	25	24	73	37	16	25	9	26	22	32	29	45	40	17	24	71	29	37	47	33	20	39	28	32	18	12	21	61	17	33	26	31	90	25	42	52	42	39	42	69	13	29	27	45	25	60	45	26	19	32	30	30	40	34	64	26	29	57	32	34	10	20	31	22	17	18	28	42	36	21	38	33	28	23	48	43	61	12	35	21	24	37	26	25	23	15	18	36	40	41	45	33	35	19	8	19	27	21	56	25	30	47	39	34	61	24	20	18	36	20	22	98	18	29	21	16	48	23	76	24	38	26	30	24	67	24	7	9	27	30	51	21	18	19	64	28	22	24	13	41	21	15	23	39	29	25	54	30	21	13	23	23	18	40	20	38	64	21	35	34	32	24	8	25	15	13	18	24	99	24	20	12	40	17	36	14	51	72	30	40	42	20	13	22	16	41	57	11	31	29	26	16	48	33	42	32	20	24	43	17	22	21	97	20	43	15	60	44	28	21	39	57	37	23	17	14	12	6	21	9	36	7	28	11	13	19	58	29	27	21	36	22	12	23	19	16	25	30	39	22	12	6	41	20	33	40	17	17	15	14	36	19	28	29	26	26	29	18	50	17	23	6	13	26	23	23	9	13	13	37	13	21	28	17	32	11	16	35	8	31	28	23	22	21	133	26	21	10	31	18	14	13	8	33	17	18	11	63	8	26	27	24	26	34	26	19	12	8	23	20	19	23	27	21	13	8	21	16	28	28	8	17	10	18	16	23	20	15	16	39	42	14	17	27	15	15	13	17	19	14	31	36	28	16	6	36	17	10	14	15	19	14	32	11	9	17	11	12	7	19	11	10	4	6	8	7	16	11	16	37	19	16	22	26	14	14	15	9	5	31	16	19	9	38	20	30	13	13	21	24	4	3	12	31	12	8	16	3	19	9	17	17	32	7	19	8	20	7	12	10	18	16	12	8	62	23	18	21	29	4	14	9	15	15	15	19	22	77	8	5	10	30	7	10	10	5	12	13	23	39	14	12	10	2	20	2	17	15	6	15	7	66	26	16	12	23	14	5	2	12	7	17	20	16	11	13	14	15	10	6	6	26	17	7	6	3	10	10	9	21	6	9	24	25	11	10	14	7	6	12	9	29	12	27	24	15	21	15	34	8	23	5	19	9	10	11	10	26	17	6	8	4	7	5	23	5	11	14	9	9	10	5	5	13	21	21	12	8	12	28	5	6	8	32	8	12	8	14	29	8	12	10	3	4	9	10	2	13	10	10	27	4	7	4	1	5	5	13	7	16	6	11	9	12	6	8	7	2	14	9	7	3	3	5	6	3	5	8	0	8	6	5	4	8	5	19	8	11	16	6	4	16	7	10	41	17	12	6	8	8	13	26	9	2	6	8	6	11	8	2	4	4	2	5	3	10	11	12	2	10	21	4	1	26	5	10	5	5	7	4	7	3	5	3	4	3	4	10	6	3	3	4	3	6	4	5	2	4	7	1	4	3	2	4	2	4	40	0	12	6	11	4	12	4	15	12	5	9	7	5	5	4	8	8	4	3	5	9	3	7	2	5	2	3	4	6	9	5	18	6	1	5	1	3	8	2	2	2	1	2	5	1	2	8	3	10	4	5	3	1	2	1	3	2	8	6	5	7	1	3	12	12	2	4	2	7	2	6	2	8	1	4	9	5	11	3	2	12	1	8	4	3	1	1	0	1	1	0	7	5	5	7	0	4	5	3	5	10	3	1	0	3	1	6	0	1	0	3	1	23	3	3	5	0	1	4	7	0	1	1	4	2	17	2	0	0	0	1	0	5	1	1	5	0	9	1	0	4	0	0	1	2	1	0	0	0	1	0	0	0	1	0	0	0	0	0	0
ne0221	2950	2133	1627	1821	1600	1778	1417	1277	1282	1269	1211	1386	1259	1064	827	1235	1074	1161	776	1182	1074	971	803	873	830	1003	996	835	783	713	907	619	831	1020	710	595	811	808	857	545	762	883	499	590	602	802	889	516	461	736	840	788	668	796	606	666	715	678	543	764	1007	577	510	621	760	558	856	507	666	679	528	703	591	522	714	1000	496	831	505	655	644	534	913	586	903	761	468	784	511	484	441	446	756	469	556	599	768	527	443	435	460	423	400	671	394	594	344	727	394	448	432	503	726	704	696	417	660	575	422	770	481	698	440	397	493	465	451	697	678	701	665	412	599	443	485	594	381	422	698	476	495	358	376	457	357	375	427	560	332	286	618	369	325	303	461	561	346	536	616	439	464	462	451	298	400	433	305	249	355	487	356	397	479	291	614	355	540	634	430	381	653	365	493	374	460	432	428	326	471	377	373	249	473	480	443	285	289	589	284	355	369	352	412	438	390	294	389	322	369	297	585	365	274	325	209	290	549	482	300	449	707	443	528	261	257	230	404	277	359	336	499	274	408	256	326	395	425	532	557	326	258	329	256	401	599	325	295	356	348	297	450	337	368	378	268	550	253	337	344	374	309	298	315	165	382	280	260	419	362	307	268	301	371	339	221	260	477	319	210	404	269	282	421	333	458	462	202	173	250	246	408	216	561	435	349	293	355	220	308	256	438	232	332	240	231	367	400	217	209	378	488	379	582	321	256	416	217	363	338	308	171	151	223	345	276	278	206	368	341	296	252	258	222	311	224	201	260	342	198	266	312	211	235	253	248	204	211	208	351	244	232	291	356	214	223	242	172	275	256	335	248	312	230	337	233	156	297	244	261	212	289	265	226	244	281	293	332	199	183	208	434	217	202	206	210	273	236	323	142	296	344	357	355	272	381	203	257	253	328	337	253	309	205	219	216	200	335	205	212	343	269	249	198	171	181	250	242	173	132	208	135	214	250	167	199	212	156	174	347	235	200	227	224	171	333	247	201	180	131	177	212	318	213	232	315	149	230	174	207	243	152	337	210	188	312	280	194	153	134	199	247	147	240	191	210	201	154	211	186	238	345	157	265	242	204	260	256	207	182	230	240	140	146	288	254	200	145	146	155	161	317	182	178	152	326	180	153	179	218	213	271	169	170	183	180	143	342	225	152	185	129	191	176	182	150	146	150	177	189	202	193	235	266	131	242	135	217	252	135	170	254	134	137	137	247	192	180	226	185	122	184	143	285	252	148	182	170	154	128	211	141	172	156	167	90	87	197	193	109	142	156	222	192	209	216	195	183	208	140	184	257	150	165	178	146	173	116	231	116	134	252	179	211	150	133	271	129	173	87	124	199	130	71	272	120	203	117	159	161	140	104	202	100	200	118	167	209	136	150	272	209	165	254	151	123	219	136	156	132	235	267	358	191	92	149	167	221	117	82	163	163	147	202	150	211	270	140	111	111	198	100	63	123	191	227	147	137	160	269	154	121	217	158	144	120	112	144	165	109	125	118	128	230	202	92	114	120	100	88	132	158	119	121	146	155	101	182	127	125	124	181	88	204	136	191	125	157	196	86	115	138	188	81	102	126	99	158	74	98	205	104	165	111	105	108	102	75	111	106	104	113	98	104	92	169	112	103	120	106	124	107	119	106	227	193	229	102	100	98	170	121	156	130	229	156	209	124	124	100	97	149	118	166	96	113	94	116	122	157	130	163	91	195	88	144	97	137	137	146	101	95	161	99	123	200	188	87	100	109	146	208	100	116	85	138	141	79	107	90	130	88	74	96	82	91	146	79	98	170	81	190	120	89	217	195	82	131	70	80	105	116	158	121	107	103	163	74	72	81	101	63	155	51	52	180	61	184	143	67	78	41	78	140	109	66	85	71	41	144	106	114	136	66	203	77	122	146	69	71	159	156	62	124	108	76	124	117	86	100	69	212	116	128	48	73	117	62	117	189	215	139	75	50	72	101	108	109	110	114	140	79	58	117	55	84	79	75	98	176	94	80	63	118	80	158	182	127	205	125	95	94	142	110	117	102	108	100	75	85	103	82	49	116	111	108	152	89	71	76	62	171	123	59	70	133	102	128	91	88	100	66	66	136	92	130	111	78	80	89	62	118	72	63	92	96	138	48	79	88	66	48	77	87	72	61	71	83	60	201	40	88	146	112	66	109	103	99	126	81	61	67	91	140	85	107	64	42	102	116	200	99	49	41	66	66	154	108	106	76	77	63	76	37	91	75	55	87	132	78	75	69	97	171	144	102	122	64	64	202	35	77	57	81	66	75	118	105	106	84	59	94	37	141	96	60	59	95	110	95	71	57	82	62	89	69	78	41	62	52	69	70	81	56	47	64	96	57	29	49	87	81	41	27	63	96	120	71	89	68	60	59	158	52	76	108	140	120	50	60	107	37	53	91	79	140	29	42	83	49	59	40	70	36	85	98	127	48	87	117	38	80	44	88	78	105	38	82	56	54	50	75	53	85	109	48	57	121	96	108	48	68	66	61	61	109	106	119	64	70	25	91	94	50	52	76	64	76	68	78	74	42	52	44	49	28	49	54	46	57	70	66	69	67	76	51	87	89	120	57	55	38	60	33	27	72	35	46	70	67	61	45	116	63	92	42	29	71	86	31	85	53	61	90	99	56	66	19	82	68	54	58	96	74	60	42	70	56	42	110	98	60	40	80	82	49	61	93	81	152	58	72	65	40	155	57	36	49	79	65	93	38	49	53	65	42	63	38	103	53	55	69	69	52	21	45	50	36	73	87	44	55	85	55	54	43	111	82	34	65	37	37	54	40	66	96	89	57	54	66	96	65	56	38	55	37	39	84	59	81	74	47	69	66	47	53	88	27	60	79	43	48	35	79	43	135	73	66	58	65	53	30	53	52	61	69	71	57	30	75	56	44	39	80	26	44	124	50	80	29	53	49	32	27	89	43	18	26	54	94	46	28	48	52	31	50	48	43	75	47	65	28	119	58	34	55	55	65	59	15	37	199	45	50	25	46	23	38	48	31	47	69	26	58	51	49	40	21	45	38	46	66	25	85	25	41	48	37	22	7	35	62	40	14	27	28	39	154	31	42	44	19	25	42	67	67	51	56	32	60	60	32	20	14	43	73	42	40	18	39	37	14	33	36	27	58	37	24	39	34	15	40	17	36	25	37	31	61	29	18	21	53	31	31	36	25	31	21	21	28	18	71	52	18	44	40	50	18	29	35	16	23	30	35	28	30	40	35	60	13	11	52	32	40	30	23	55	41	26	26	62	34	34	52	22	27	32	33	54	116	26	84	35	27	20	39	33	37	35	18	38	47	43	14	42	29	26	18	16	40	28	33	28	16	22	27	39	27	12	34	87	22	12	16	30	107	33	51	20	43	11	60	50	18	14	90	11	20	29	43	37	23	42	17	32	37	15	14	41	57	30	39	19	39	8	15	30	21	30	19	30	43	20	16	14	47	5	46	44	29	17	31	16	22	33	14	20	40	23	20	21	51	56	10	26	86	26	22	33	7	40	52	8	27	16	20	22	21	28	45	35	18	16	20	7	46	20	16	19	19	10	21	20	18	25	51	23	17	14	6	18	18	29	34	13	23	13	13	5	12	8	42	15	65	17	12	22	20	25	20	22	48	12	18	21	15	17	8	21	42	12	22	10	8	7	12	32	38	10	26	33	18	8	34	17	24	32	9	14	22	27	28	22	20	23	10	13	21	24	17	13	14	13	39	22	9	8	21	34	5	9	5	29	29	12	8	20	12	30	20	13	20	4	19	23	11	15	6	2	3	21	52	16	16	152	7	18	6	18	26	10	33	15	10	5	8	4	9	4	6	16	14	10	21	12	11	21	40	9	7	4	11	13	3	47	19	8	31	9	6	16	6	16	11	12	9	0	5	26	11	7	15	8	9	7	9	8	11	15	2	7	28	10	5	15	29	1	24	17	7	11	6	9	5	1	2	3	4	3	8	7	20	9	3	15	7	3	3	3	3	7	11	13	6	24	2	6	14	4	0	0	5	5	4	5	2	2	1	4	2	3	4	5	0	6	5	1	3	4	14	1	2	2	9	5	5	9	5	0	1	0	3	0	6	3	4	1	1	9	5	0	0	1	1	0	1	2	8	11	2	0	5	0	1	0	0	4	0	0
ne0223	4042	4576	2137	1987	2363	1586	1639	1344	1572	1829	1521	1232	1297	1152	1601	1201	1069	1084	1443	901	1091	1161	1146	930	1034	1079	1004	922	1212	1244	1041	999	877	863	1206	930	879	844	909	1178	973	824	746	776	665	762	711	961	1141	837	633	628	718	687	768	843	793	623	911	697	648	738	1121	1001	684	863	678	695	769	701	863	815	836	782	908	755	739	686	784	745	660	761	512	671	750	480	662	562	792	765	759	578	498	674	512	695	460	595	617	553	650	699	520	541	648	530	662	574	499	631	628	713	434	471	461	563	360	570	611	447	593	415	577	622	606	566	636	430	383	423	560	488	456	501	569	809	512	486	403	501	488	529	502	493	613	663	608	440	527	657	474	514	572	496	577	610	553	521	367	558	473	521	501	703	542	436	496	623	459	425	679	493	509	734	322	421	396	356	426	360	389	630	432	438	500	525	496	548	498	459	465	546	430	419	412	419	556	329	560	491	467	350	430	509	404	481	547	421	508	562	305	545	460	405	567	520	441	482	543	360	495	348	454	518	554	405	303	534	490	435	497	512	430	395	460	531	661	376	292	406	442	453	514	393	381	370	450	376	460	396	356	425	438	360	383	271	389	438	483	455	336	377	290	446	447	438	474	416	379	356	306	344	352	329	339	348	289	349	414	324	375	334	318	302	439	465	525	301	385	456	315	469	323	355	363	365	286	366	318	377	474	442	398	363	463	484	368	440	410	287	346	371	324	338	365	304	426	382	261	425	404	421	288	394	321	348	352	365	387	293	275	430	374	259	290	424	394	475	441	303	351	409	566	330	343	360	472	430	307	280	276	305	258	381	321	401	241	378	414	255	303	419	320	451	407	315	348	408	343	388	304	396	354	279	305	342	282	356	313	243	233	407	306	267	348	308	276	325	293	280	234	317	268	304	238	248	278	277	283	245	260	452	255	316	287	346	305	398	344	260	268	224	285	310	247	267	315	386	332	285	280	369	344	370	364	386	282	335	352	275	274	268	362	325	276	282	231	299	383	263	191	413	289	273	285	281	315	252	301	250	251	211	281	239	219	241	284	261	226	308	254	232	203	274	226	213	203	291	298	257	168	279	279	210	248	208	301	344	329	219	219	274	282	216	244	241	213	278	253	265	211	255	282	230	241	211	186	279	205	212	210	245	268	189	237	212	195	262	243	364	197	251	233	212	242	289	216	240	186	213	213	342	204	332	255	227	248	257	274	263	264	288	235	241	293	177	244	264	182	184	211	371	192	186	367	111	297	285	233	238	243	216	298	210	281	258	246	183	189	176	217	309	249	214	197	254	197	242	316	217	128	194	228	178	169	202	182	183	229	232	189	217	202	168	249	143	264	190	343	203	196	155	211	165	201	164	207	209	167	161	215	187	192	228	170	218	204	239	206	200	154	255	155	161	209	176	166	170	153	153	209	168	210	263	221	186	206	217	179	147	150	198	173	188	187	171	156	154	165	189	152	314	137	272	148	140	207	218	143	160	230	248	170	227	143	161	153	100	187	147	246	182	102	135	214	278	185	202	165	127	225	299	165	121	162	185	159	172	159	252	201	171	176	136	157	144	187	111	230	223	158	175	163	148	183	127	181	210	153	228	146	184	170	194	165	167	123	234	128	284	226	189	177	182	236	162	98	178	135	156	147	164	185	150	110	118	158	178	152	158	159	173	255	129	119	255	162	159	194	169	138	170	174	174	189	126	99	143	196	169	149	154	155	164	135	174	164	213	174	124	123	169	135	153	100	210	130	153	209	145	227	161	110	116	165	92	189	191	138	181	187	164	146	204	167	185	151	72	121	120	143	125	162	139	131	202	145	146	132	169	130	105	174	141	63	153	149	138	122	184	101	113	104	181	143	159	119	116	123	114	167	136	106	170	111	154	134	178	165	183	105	124	126	257	143	149	90	138	141	113	118	142	72	151	104	120	92	145	100	212	124	102	117	142	100	111	141	104	88	106	226	136	134	114	117	192	119	98	236	129	140	114	137	167	188	139	123	85	112	128	145	116	161	154	96	160	116	94	142	91	127	146	143	126	124	127	134	194	171	161	163	189	86	123	149	137	140	108	203	102	126	101	111	157	111	130	128	154	132	89	244	138	89	107	121	128	108	184	102	143	169	94	106	83	74	62	146	136	115	111	147	174	151	112	108	118	140	134	121	133	102	90	128	66	83	118	96	135	70	159	101	110	85	114	86	109	103	113	136	68	121	140	94	87	110	92	108	91	117	96	109	67	223	95	76	121	100	114	87	123	131	130	88	78	144	78	170	114	81	88	125	98	101	131	138	140	108	90	125	89	112	144	80	101	116	73	138	101	90	117	158	72	87	99	67	87	56	72	132	54	165	79	51	126	123	116	91	91	113	107	84	103	116	89	110	175	150	112	116	106	63	116	133	118	103	147	107	118	57	79	67	110	66	101	62	90	142	73	79	58	92	104	84	123	145	91	73	110	61	81	85	174	80	88	125	90	106	147	99	141	113	121	81	92	103	65	98	99	71	83	94	85	116	153	68	98	126	103	57	103	65	80	139	110	81	131	64	121	99	86	129	72	100	91	72	91	73	80	86	130	71	73	78	92	76	74	89	65	66	86	64	152	116	59	110	57	88	76	63	116	69	52	104	82	87	108	70	74	114	55	85	79	62	86	83	87	67	116	103	80	109	86	95	81	112	86	102	67	120	85	68	79	100	105	92	71	83	73	97	83	80	55	62	80	112	99	107	105	64	84	93	73	83	103	99	136	99	110	57	107	82	43	125	58	57	90	99	76	131	100	99	69	119	39	77	51	99	72	78	82	87	69	97	48	41	52	75	72	89	59	85	61	109	73	97	94	69	73	53	90	62	63	53	127	88	97	65	62	107	61	87	107	78	85	48	85	72	90	57	68	72	50	76	57	61	90	45	64	69	89	58	75	85	67	72	85	102	74	77	50	68	59	68	76	70	75	63	69	53	46	62	82	55	55	66	92	79	44	57	66	151	53	41	96	53	56	119	53	71	96	81	71	33	80	49	63	82	46	76	54	56	55	69	80	69	41	59	93	65	84	42	43	51	59	48	52	85	36	76	70	64	94	111	72	61	48	49	33	54	86	95	48	71	51	85	72	33	71	72	37	41	48	62	41	56	61	85	36	59	71	81	112	47	83	33	53	47	59	62	52	68	45	39	46	104	73	25	53	71	54	55	47	64	36	42	24	68	46	68	64	31	64	77	29	51	48	33	59	41	42	53	34	48	33	22	31	49	23	71	41	50	77	39	22	43	77	36	52	61	41	47	61	34	44	64	63	67	45	20	76	48	61	32	67	38	43	71	49	71	38	43	36	57	60	45	42	50	32	28	41	35	50	79	63	30	52	37	77	47	42	40	48	53	101	29	35	51	41	41	46	72	33	49	23	71	47	42	18	16	45	31	68	51	94	42	52	36	28	67	46	34	78	15	39	55	55	38	42	56	32	33	55	26	35	25	67	31	29	26	67	41	45	57	54	65	27	44	59	35	26	42	64	46	46	38	33	23	29	31	26	58	42	40	41	53	50	22	37	37	24	14	30	29	58	28	23	19	41	34	14	34	22	49	34	16	35	26	34	35	15	35	32	30	42	26	49	44	55	29	24	41	18	32	25	40	25	44	20	66	48	32	25	35	27	33	31	38	24	30	31	30	29	24	26	24	44	22	37	17	29	16	30	24	22	29	23	39	26	17	28	18	16	20	16	11	26	49	15	13	22	27	19	16	30	33	27	24	20	18	28	19	14	16	26	18	13	30	25	42	33	33	26	29	35	16	18	31	15	10	38	18	10	15	27	25	18	22	21	30	12	22	12	19	14	20	26	7	14	25	19	19	17	15	11	15	36	7	11	43	15	9	23	18	10	12	11	18	26	21	14	5	20	30	19	18	14	13	11	24	5	23	7	15	19	14	10	25	11	5	21	8	16	9	15	8	18	18	19	8	15	12	12	17	14	8	9	6	14	7	15	16	13	14	13	10	7	5	4	17	8	25	7	27	13	9	10	5	9	5	6	2	8	6	16	9	12	3	6	1	15	2	5	3	6	10	9	9	4	7	7	18	5	21	5	5	11	8	3	3	5	7	1	1	6	6	8	5	1	2	5	0	5	6	3	2	3	1	2	5	3	4	6	0	9	2	0	1	0
ne0226	2492	2990	1671	1650	1505	1136	1217	791	937	1054	980	837	1043	792	1455	729	826	823	829	727	964	749	888	558	659	855	857	975	1146	1464	649	754	659	636	1290	769	715	641	724	953	616	668	537	469	580	575	397	772	892	528	389	614	545	760	558	758	555	455	678	471	440	494	523	528	516	716	397	581	538	521	613	558	685	657	554	525	491	442	613	525	555	620	252	549	488	298	551	541	536	583	578	514	276	487	322	462	320	583	458	439	534	441	439	294	432	427	407	361	451	445	490	469	247	292	288	472	251	586	566	236	395	302	340	505	452	509	372	183	231	250	411	406	468	631	439	466	457	352	236	415	398	493	296	371	414	462	399	499	458	589	446	268	385	317	300	497	396	276	218	347	299	508	332	394	294	346	358	669	563	272	535	331	350	560	198	498	430	189	301	275	450	462	256	288	315	545	288	407	376	325	280	340	421	343	411	354	263	173	380	313	307	332	305	328	314	375	356	458	483	470	179	403	395	293	321	578	258	533	376	390	419	262	367	413	657	483	304	406	334	283	332	370	372	398	354	559	283	375	288	227	545	233	376	466	320	418	369	319	318	287	175	284	256	360	330	136	281	334	405	369	235	371	311	350	291	287	260	428	366	390	210	309	230	252	336	198	229	242	354	271	260	394	190	281	315	444	439	195	256	310	357	304	280	328	432	257	190	305	299	248	323	266	247	249	379	277	341	513	254	269	320	324	257	234	353	238	342	415	177	324	246	354	254	429	302	319	209	263	290	252	193	308	222	239	290	329	358	438	317	246	214	337	393	233	338	267	329	366	209	197	183	205	279	236	273	221	185	270	262	243	202	358	164	309	299	257	272	402	299	306	204	223	308	192	164	318	262	329	302	160	314	217	151	257	384	275	164	250	228	217	260	295	235	219	151	179	267	217	318	170	276	453	307	261	268	138	250	173	194	264	242	223	194	260	215	185	163	210	240	165	236	528	234	266	303	229	243	243	218	195	146	242	201	199	117	193	190	256	242	173	158	275	156	197	309	171	208	200	345	182	232	155	148	196	198	189	157	257	209	196	170	122	198	122	150	147	163	172	219	171	192	214	155	165	351	200	247	120	175	191	169	127	158	207	172	194	180	217	152	325	250	219	188	192	212	148	157	229	120	142	109	172	191	142	198	171	153	129	312	169	103	137	151	109	143	302	142	263	166	157	136	208	191	240	191	113	148	284	193	175	212	426	185	197	312	247	133	133	130	232	130	174	195	144	397	187	167	189	210	177	162	203	131	107	207	210	206	167	131	138	252	168	165	147	126	149	132	217	172	177	91	118	135	205	142	136	186	85	149	138	191	143	133	124	202	116	132	262	215	155	149	116	163	195	134	228	167	128	113	119	146	157	113	213	113	283	166	167	149	186	185	202	163	207	172	115	153	78	115	180	232	159	138	260	206	150	218	171	156	176	116	194	158	283	173	188	131	137	137	151	153	189	207	151	129	143	202	147	176	186	120	167	163	183	99	169	131	91	140	182	126	108	112	65	153	105	105	138	179	129	144	105	171	59	130	144	130	128	156	146	101	106	158	88	128	239	206	203	153	117	163	181	155	151	144	112	156	177	102	133	155	106	130	164	116	126	98	125	84	228	115	218	142	87	127	151	79	139	166	215	132	123	122	163	76	113	114	163	85	133	181	90	219	103	116	102	116	79	156	97	99	115	98	122	135	164	167	123	119	103	93	67	103	187	84	134	159	164	127	123	97	131	183	119	53	117	85	193	124	131	130	121	157	159	84	174	84	89	98	94	77	109	216	116	125	155	76	78	94	108	115	101	88	137	192	166	120	75	124	163	61	68	146	112	85	132	111	135	67	125	93	82	82	106	89	71	97	109	153	77	102	204	86	79	88	182	69	88	69	70	95	121	146	163	93	110	82	107	106	91	167	135	34	113	155	173	50	91	108	155	105	101	92	116	53	119	99	103	130	143	127	144	125	100	101	99	99	123	105	139	96	128	179	95	147	86	100	113	102	95	118	104	79	161	82	135	73	130	109	75	113	328	132	124	131	85	84	98	85	110	88	131	117	66	117	123	167	96	116	92	128	60	157	123	55	74	80	146	105	92	188	101	107	87	126	98	109	231	95	75	75	108	122	125	99	238	102	131	84	103	109	96	64	84	74	87	110	71	100	63	56	60	77	62	108	97	107	210	99	87	73	83	80	78	92	78	121	61	53	121	52	95	99	65	110	94	47	54	127	146	59	87	49	134	103	122	57	71	80	82	65	111	93	75	90	77	128	61	43	57	102	99	332	126	106	65	42	82	98	106	95	72	55	84	78	138	53	63	48	104	138	50	101	105	52	95	92	123	61	68	70	79	73	75	48	101	97	36	58	91	126	64	157	36	78	82	81	72	60	87	32	116	120	94	39	84	77	118	54	97	55	69	36	64	45	87	80	41	60	35	82	84	144	61	56	54	87	98	63	97	42	82	75	50	48	44	65	61	89	113	104	114	71	71	73	72	67	62	46	64	90	49	256	85	51	65	137	50	78	59	39	125	62	100	36	99	61	56	47	90	56	63	57	98	23	80	85	71	66	92	52	72	44	60	58	74	86	38	82	57	78	106	36	110	91	62	54	62	74	68	84	33	26	52	65	83	78	65	49	65	33	36	73	43	39	70	39	72	48	66	75	47	96	68	86	48	63	41	99	54	60	84	71	109	60	60	23	58	104	52	47	84	106	71	105	186	97	40	38	56	60	81	52	46	60	39	41	49	93	33	48	15	65	74	50	50	48	94	130	103	75	50	42	50	58	21	50	80	67	58	49	89	78	28	60	51	39	84	38	62	64	96	49	68	50	76	42	39	56	71	78	37	20	46	49	43	57	38	52	70	26	49	59	48	126	25	72	75	59	36	94	75	66	41	45	111	56	47	31	56	44	35	52	23	64	94	69	66	69	64	29	42	82	26	54	52	62	59	24	35	75	49	23	69	56	45	54	52	30	55	130	100	65	61	34	55	56	43	78	54	53	39	29	35	40	56	51	26	57	27	55	52	71	42	34	49	38	53	87	79	58	58	41	21	51	30	38	36	47	33	18	60	70	47	76	35	40	50	59	34	59	40	33	55	67	91	23	42	47	31	114	48	34	15	59	18	40	43	23	35	50	21	47	39	27	22	47	33	37	41	43	44	50	93	32	21	52	47	25	38	27	55	48	28	57	28	64	16	64	72	35	37	40	30	36	28	53	29	56	29	73	29	10	41	50	57	28	58	53	36	38	26	14	26	25	39	40	62	62	28	21	35	41	41	34	27	34	26	33	37	14	46	27	33	16	20	36	45	34	36	42	28	34	79	28	22	28	20	25	63	66	36	45	51	67	34	42	81	24	25	69	44	21	22	13	18	19	16	24	49	51	12	39	15	35	27	18	39	25	19	42	35	26	58	40	44	18	26	31	49	33	45	98	44	40	56	40	83	48	34	13	39	39	42	39	13	10	20	43	19	40	57	13	9	34	20	37	15	25	27	8	21	21	62	20	17	20	40	22	21	32	18	17	34	11	33	26	20	38	22	47	20	19	25	10	22	26	37	26	20	21	29	32	30	124	26	13	19	35	23	20	16	27	19	32	12	11	34	14	39	15	25	29	27	15	8	28	23	24	32	7	13	12	25	19	26	45	25	21	16	15	15	17	22	14	7	24	49	41	26	20	21	19	11	16	21	14	47	8	18	12	12	28	17	9	15	30	9	39	10	12	21	6	9	16	21	13	4	24	16	17	6	4	9	14	10	13	8	10	27	21	8	16	4	6	4	8	17	23	5	15	22	18	18	21	23	18	14	24	17	10	26	5	7	12	14	9	7	35	23	10	6	2	14	5	18	17	11	12	19	7	37	10	10	4	11	5	9	9	18	13	4	6	18	12	8	21	15	10	14	6	5	8	5	7	9	13	10	11	9	6	16	4	17	6	5	6	23	6	11	6	2	20	4	7	7	4	22	3	1	21	9	8	6	1	4	2	10	0	2	8	8	11	7	7	12	12	21	5	20	6	5	8	3	5	11	2	13	8	14	3	15	2	14	1	0	6	0	7	2	2	5	8	3	3	4	1	3	5	3	1	9	0	8	0	2	0	2	26	1	0	1	0	0	1	0	0	2	0	0	1	2	0	0	0	0	0	0
ne0227	2937	4082	2144	2554	1855	1520	1896	1102	1379	1618	1384	1164	1134	1017	1239	961	1155	1069	1152	832	1178	1182	991	1107	899	1111	1354	1164	1309	1281	828	1080	1005	750	1172	932	934	749	893	893	882	891	614	675	979	664	612	867	921	751	677	867	736	814	842	747	734	658	796	701	607	669	655	690	713	803	583	788	685	679	821	685	686	755	712	629	756	598	818	561	768	690	534	721	615	433	722	720	581	703	787	488	436	624	592	483	446	589	746	664	659	744	731	393	579	643	1198	462	475	720	556	614	415	457	390	671	377	626	578	381	575	426	598	633	488	658	636	567	370	374	631	583	512	543	570	530	483	505	349	415	575	615	457	443	471	513	496	611	559	607	601	426	370	501	401	442	560	378	352	649	531	481	549	468	384	457	502	554	417	553	694	482	518	518	283	528	624	315	399	398	615	539	403	344	341	504	406	466	437	399	404	428	487	563	481	603	374	288	446	362	348	389	408	473	468	510	450	508	411	525	287	539	471	472	369	649	379	425	367	482	424	364	447	427	541	610	377	488	390	464	359	454	368	435	400	490	340	439	311	342	510	321	356	490	354	464	420	417	438	306	328	355	315	454	390	230	398	397	494	345	434	474	397	345	394	321	388	371	447	359	407	327	373	320	440	260	304	444	296	296	286	458	330	335	379	284	371	345	310	449	474	415	320	365	448	306	475	377	337	306	316	447	277	318	451	319	385	509	302	334	354	439	311	414	338	315	382	339	345	403	361	382	340	360	337	369	304	353	433	360	364	382	350	296	411	403	427	366	380	452	370	383	470	333	427	257	367	345	306	259	261	301	317	304	389	339	411	297	324	303	293	263	325	321	325	310	362	405	388	355	225	324	376	331	236	269	299	304	365	254	318	225	203	336	362	359	221	270	274	246	351	318	293	218	280	217	290	318	205	254	362	396	356	298	316	230	337	181	268	319	294	242	286	295	312	224	185	285	325	281	276	240	313	336	231	419	379	253	239	280	371	308	251	259	201	255	258	286	290	227	242	337	196	281	300	194	294	219	293	274	239	278	220	246	225	245	231	227	193	217	308	248	205	220	208	229	196	247	260	213	261	297	212	230	304	195	249	238	212	210	244	274	184	180	245	144	303	272	345	216	221	273	167	213	235	230	245	274	184	217	186	303	332	293	340	257	232	174	284	304	223	249	235	178	221	257	205	238	248	205	187	194	219	253	238	166	249	232	246	204	240	264	248	240	215	327	185	170	194	224	144	235	214	214	200	327	141	286	187	308	230	237	193	183	227	197	311	233	210	172	205	266	185	189	178	223	178	293	169	166	168	148	207	274	201	270	281	180	207	237	266	170	184	168	256	173	241	269	177	247	172	130	236	186	216	188	246	201	170	157	258	176	159	311	151	201	173	195	175	169	227	234	172	156	210	204	165	147	180	218	133	180	141	174	254	266	173	248	166	194	239	216	173	240	194	183	172	190	133	145	245	154	231	172	171	169	193	133	161	234	183	195	264	189	147	166	160	236	147	121	225	200	151	154	235	160	128	199	196	162	172	142	142	224	173	198	127	147	164	132	133	143	213	173	191	180	239	152	249	137	203	211	175	170	129	128	169	167	119	162	153	153	155	141	198	157	284	260	167	162	152	220	187	116	125	168	126	162	205	139	220	167	153	172	110	133	112	207	111	146	116	120	179	215	180	199	191	156	171	87	101	117	173	126	162	236	135	153	139	135	161	109	124	160	131	167	137	209	138	116	158	189	156	165	81	198	88	197	139	152	156	130	187	135	140	136	109	165	140	177	162	130	226	138	174	162	141	117	107	132	124	105	145	189	135	151	208	132	144	112	129	81	146	196	113	158	140	151	121	205	131	139	119	106	180	145	125	210	164	102	187	289	143	122	122	129	107	85	86	134	142	115	161	170	115	110	98	117	150	149	169	124	186	164	158	221	144	166	127	129	151	85	118	141	130	164	142	168	120	124	175	236	127	132	154	132	103	170	94	98	126	168	154	150	173	129	161	184	104	88	148	115	88	203	119	173	136	104	111	120	86	103	133	122	149	133	141	172	100	164	123	140	141	94	110	112	166	125	128	127	110	133	160	153	89	143	112	166	137	71	161	205	164	143	119	130	116	99	141	89	85	101	129	137	83	127	108	146	118	110	63	148	125	135	137	105	129	104	116	114	87	81	90	51	152	122	125	135	96	113	111	113	106	111	82	108	107	68	77	179	63	123	109	71	134	99	96	86	155	150	70	105	136	91	91	138	124	77	89	80	142	113	78	98	89	109	121	100	82	109	112	149	104	167	89	100	94	89	106	99	137	123	101	132	109	95	73	72	113	118	97	88	133	118	57	111	114	135	107	70	91	92	98	108	43	110	95	76	89	132	81	156	143	170	75	68	133	102	89	118	73	80	99	111	83	112	117	151	88	69	69	82	95	109	53	86	82	94	110	70	133	108	106	93	66	62	89	105	58	73	95	96	62	104	47	80	79	80	104	101	69	123	123	71	69	87	47	90	73	87	93	131	137	127	52	66	102	68	88	102	65	115	67	100	66	70	62	97	112	84	53	97	90	119	65	78	73	71	77	111	111	65	57	94	70	111	117	61	91	105	92	97	74	107	96	86	68	71	64	98	71	57	49	39	57	77	70	74	103	86	97	49	104	73	56	84	52	99	55	80	56	60	75	113	67	40	75	52	62	54	70	84	87	48	70	69	58	65	88	114	99	70	87	118	122	135	127	111	41	69	97	110	108	83	72	46	53	67	91	31	74	77	89	95	68	112	36	57	107	85	102	71	65	72	59	34	63	100	59	51	86	60	83	76	63	84	70	45	44	45	53	55	72	49	54	50	86	53	58	56	64	72	49	46	61	49	58	68	66	68	57	79	69	78	90	32	72	102	78	81	121	49	62	55	63	114	56	80	68	69	47	54	80	37	67	45	72	65	53	78	33	86	67	44	72	74	90	83	41	71	69	33	40	57	38	53	88	60	61	70	50	93	68	68	41	44	42	73	54	95	54	49	54	31	40	42	54	42	48	47	45	82	74	57	47	38	64	56	93	81	81	73	47	30	68	37	53	41	54	41	52	82	85	35	76	51	91	49	54	112	84	50	61	36	47	62	47	66	50	63	56	44	51	44	83	68	62	61	49	59	49	34	42	61	28	26	46	63	52	54	22	39	41	96	56	67	43	68	39	52	38	84	62	47	64	53	48	16	27	86	45	35	66	47	36	38	64	65	63	68	145	42	25	43	69	43	77	45	36	54	45	57	26	29	61	55	63	72	29	45	57	56	23	57	27	38	56	42	94	38	81	49	25	63	30	40	45	49	34	30	35	24	46	66	54	33	24	62	37	63	51	49	63	45	43	37	31	48	42	29	37	29	30	21	58	30	24	40	30	37	61	44	41	32	38	52	34	41	26	60	41	46	24	39	47	44	27	24	61	63	30	82	53	47	47	54	34	77	42	56	26	41	40	45	29	35	45	27	33	28	43	29	24	35	36	42	37	29	25	36	32	32	54	26	40	29	43	41	39	23	56	24	38	34	27	13	29	40	38	35	24	40	36	30	30	48	32	52	27	35	27	35	26	28	41	34	28	29	35	29	21	30	19	26	45	32	24	43	39	72	12	19	29	24	23	25	43	21	25	40	19	18	40	33	24	58	29	19	16	29	49	38	15	36	33	15	33	34	25	30	18	26	30	33	26	11	16	59	22	22	8	32	44	20	18	30	30	30	26	19	16	24	35	11	41	54	38	12	24	26	19	25	12	10	19	20	16	14	40	40	32	29	30	28	16	4	15	4	22	10	18	22	26	20	38	19	13	13	19	15	25	23	21	18	22	23	9	23	15	15	20	14	4	9	21	16	13	17	18	8	30	29	7	10	5	21	25	26	14	18	17	8	9	23	13	8	16	9	22	31	16	31	8	12	6	8	4	18	13	37	9	12	6	17	8	20	19	32	28	24	26	11	15	14	10	12	6	3	26	5	21	3	9	4	7	7	4	13	8	10	6	15	4	29	13	6	10	27	18	11	13	7	13	8	14	8	3	6	13	9	5	13	6	3	5	1	8	7	8	9	6	11	1	5	0	10	2	2	14	0	5	20	2	2	7	8	0	0	1	2	0	5	2	1	2	2	3	2	5	7	0	2	2	1	1	0	1	2
ne0228	3034	3482	2227	2137	2385	1567	1609	1197	1445	1649	1483	1232	1229	1132	1462	1075	1168	1195	913	907	1233	1033	1022	1042	963	1182	1048	1241	1175	1311	922	941	994	869	1032	953	921	761	947	778	761	914	641	807	664	804	795	959	768	725	730	779	808	809	668	741	796	688	798	744	589	769	705	621	745	756	631	861	724	659	936	707	661	629	745	716	639	601	686	608	763	704	544	579	545	527	697	734	750	707	597	566	479	581	538	539	488	772	601	675	709	533	562	532	533	670	540	532	581	603	566	693	494	491	530	609	528	504	569	448	611	481	501	558	507	510	573	538	509	437	644	559	693	506	570	521	413	607	410	484	507	563	351	501	482	489	491	533	528	569	544	488	459	518	322	524	533	385	403	375	413	529	503	521	337	569	593	561	592	517	597	493	454	641	373	487	544	390	449	362	559	553	508	340	410	608	441	393	501	410	357	390	367	524	451	423	338	375	399	471	352	448	334	473	399	494	457	532	415	521	383	408	427	464	300	566	421	449	369	485	416	368	372	461	585	456	456	447	423	483	291	476	368	394	389	444	338	487	325	398	472	325	382	364	341	586	416	348	384	362	402	399	288	355	366	318	464	408	422	375	330	400	364	354	456	351	360	537	467	370	383	321	344	324	342	280	345	372	325	393	328	447	435	247	562	257	401	254	293	389	395	505	365	423	342	384	279	335	324	327	324	334	264	286	418	425	341	455	266	364	259	520	322	349	316	243	401	327	315	327	367	334	323	556	351	316	257	368	383	312	317	383	329	319	424	379	432	462	292	367	291	405	325	199	494	300	371	369	391	276	295	281	263	235	398	310	246	270	270	384	270	331	289	327	302	337	298	460	320	361	219	300	392	285	271	196	319	438	398	223	360	244	217	328	289	296	277	222	336	330	390	243	220	190	309	291	279	254	194	297	346	500	338	328	325	259	333	241	271	238	367	257	294	340	277	201	197	233	328	339	254	218	394	281	270	320	259	262	238	290	244	264	295	281	235	249	309	255	222	228	272	315	197	262	371	251	296	211	229	212	238	251	234	253	206	249	182	247	187	236	246	237	195	244	207	208	211	309	228	207	105	213	200	220	300	176	232	250	232	146	197	242	188	178	221	197	206	209	249	199	414	286	173	259	190	252	189	207	177	204	284	192	256	190	214	211	190	177	265	271	176	186	200	261	261	223	192	204	212	242	203	204	178	201	235	205	205	301	195	223	311	288	222	228	205	337	322	160	152	239	186	228	206	183	182	147	155	212	194	235	162	253	163	156	234	193	282	276	139	189	226	245	197	157	146	177	143	273	248	196	221	125	228	352	196	187	175	200	195	247	210	168	173	167	221	164	187	252	230	198	146	156	197	125	199	213	217	206	202	206	232	153	101	200	167	226	145	286	254	140	348	157	127	114	207	203	174	134	155	178	125	202	166	241	268	188	236	218	200	163	156	216	155	193	172	153	193	132	193	144	231	121	186	151	149	217	193	123	113	283	265	202	256	286	157	157	149	126	155	202	198	158	153	152	238	158	113	197	178	146	269	190	184	126	177	208	172	154	141	178	133	121	182	156	271	140	203	287	209	145	239	274	169	179	102	170	134	203	127	227	152	151	170	246	162	137	100	124	103	218	164	213	161	113	164	181	159	147	158	150	164	98	141	127	87	170	128	198	125	127	98	151	164	168	130	144	143	135	190	92	100	123	240	143	164	253	101	175	140	130	121	128	144	125	89	169	129	187	92	106	123	189	118	120	110	124	95	181	297	161	158	136	200	185	163	197	106	132	129	135	125	102	161	169	173	173	123	156	159	120	126	76	113	235	312	195	121	120	140	113	108	85	117	114	167	99	147	134	87	148	122	96	121	226	215	189	169	155	142	112	193	192	111	180	135	120	91	136	87	116	99	164	138	137	133	125	117	131	134	146	145	154	96	189	145	201	52	139	136	154	154	81	79	114	109	185	91	145	95	295	197	191	169	115	104	136	100	112	92	108	121	125	127	116	198	93	127	127	108	99	153	120	100	126	105	142	96	75	90	122	105	71	150	141	152	167	119	186	65	155	99	161	126	101	129	149	199	59	176	105	149	101	151	100	80	109	126	184	130	115	106	135	117	114	147	130	126	101	118	109	73	118	120	110	168	120	144	131	100	86	85	106	102	144	122	102	94	99	155	102	75	80	106	72	116	105	87	162	106	81	58	82	62	91	91	134	111	65	109	316	58	85	96	84	131	103	83	96	150	94	50	83	114	111	81	97	86	91	87	91	93	83	98	127	78	84	105	83	118	90	103	108	97	92	109	85	73	97	78	95	71	88	110	117	197	114	64	82	74	140	131	98	100	87	53	95	65	92	91	83	121	104	82	104	69	102	119	56	73	106	72	87	168	125	46	83	98	89	87	75	60	94	81	132	79	78	90	78	75	84	82	90	112	107	51	92	91	85	97	65	90	128	74	122	85	56	82	120	53	49	93	73	77	77	77	46	63	59	129	98	101	126	122	75	97	140	69	120	78	88	75	91	187	92	64	75	85	91	76	93	74	80	73	102	59	84	60	123	124	73	81	73	56	138	52	76	83	102	55	79	71	79	88	71	76	89	122	65	103	78	48	104	85	109	103	43	63	47	94	116	82	84	75	33	182	87	71	66	79	112	74	95	68	81	88	77	32	162	63	81	60	47	63	109	94	57	92	29	49	83	87	80	73	37	68	48	58	54	71	81	62	59	74	126	96	151	120	47	48	55	68	105	65	46	79	72	42	45	59	30	68	51	66	100	54	52	62	47	138	59	91	103	47	54	110	39	81	90	53	65	98	67	117	57	57	101	69	96	41	38	61	87	61	38	74	59	72	57	68	54	86	53	34	40	41	48	74	95	47	40	55	77	68	61	231	45	78	69	79	57	54	76	88	52	37	67	82	57	73	56	72	66	73	37	79	58	62	73	74	77	32	110	58	28	69	48	78	80	43	55	48	80	49	86	36	40	63	62	43	79	89	237	39	77	55	37	37	47	101	66	60	32	48	26	31	45	52	23	58	30	35	108	65	89	74	64	48	66	37	80	41	33	40	45	55	43	58	49	45	54	78	56	88	28	81	50	27	48	57	52	78	36	44	31	60	66	38	93	60	51	66	70	46	29	91	82	35	34	35	56	42	32	52	32	34	44	42	43	42	71	18	32	50	57	152	62	36	50	58	50	21	67	25	48	56	54	47	21	59	65	56	32	48	38	37	44	74	44	40	36	100	28	42	34	50	29	35	28	53	45	28	42	34	35	26	55	34	45	31	24	68	52	21	68	28	35	32	25	26	47	21	78	36	53	35	37	25	32	24	32	25	33	30	84	50	30	25	50	35	67	50	47	64	47	60	56	32	56	39	32	37	54	41	38	87	33	50	23	27	72	106	33	41	30	91	32	33	33	28	52	27	46	24	35	33	53	14	21	58	60	21	63	66	46	42	35	23	86	34	33	35	45	33	48	42	25	55	16	35	58	28	34	26	20	26	20	34	45	23	18	14	36	68	46	21	32	55	35	32	22	48	30	33	20	24	22	21	52	35	27	36	16	24	28	10	36	21	40	29	24	42	31	28	29	48	26	17	22	32	26	31	16	10	50	33	53	20	31	27	68	10	17	32	27	39	44	37	32	15	42	15	6	25	17	20	45	52	32	16	22	33	19	13	31	27	29	45	40	12	26	15	45	27	22	25	13	5	42	24	18	8	10	18	15	15	25	46	20	31	20	14	20	44	8	30	25	18	22	22	19	54	12	14	9	13	39	13	23	17	24	32	30	17	11	11	3	10	9	19	13	13	19	6	25	29	65	12	7	12	15	7	21	5	7	6	21	17	15	21	15	13	21	16	10	12	5	11	9	15	7	28	37	11	12	12	15	6	12	19	28	18	9	8	21	11	11	18	6	14	15	7	9	11	4	2	7	8	18	7	20	20	10	8	24	11	26	24	13	4	7	12	0	26	18	9	12	9	1	6	2	16	13	7	21	12	6	21	13	3	14	11	7	7	9	3	17	16	18	5	3	6	2	5	5	9	8	2	7	2	16	7	8	5	7	2	0	8	4	13	6	4	8	6	6	10	3	4	11	2	2	2	1	2	3	4	2	3	3	1	2	1	5	0	2	0	2	1	17	1	1	6	1	0	0	0	0	1	0
ne0229	4342	3752	2620	2479	1787	2341	2183	2017	1744	2152	1472	1902	1578	1501	1601	1385	1332	1581	1473	1661	1522	1456	1358	1336	1202	1047	1417	1336	1244	1457	979	1111	1074	1213	1025	1283	1070	1105	1166	973	1159	1094	861	1095	851	1105	1010	935	969	902	1193	998	900	745	989	1115	899	1109	952	926	1070	692	745	935	842	942	1005	848	909	1008	981	822	890	721	771	1079	894	880	896	786	824	791	824	753	737	777	632	871	795	881	668	778	797	735	750	724	663	699	794	691	790	703	673	695	780	707	625	739	654	820	659	698	696	746	754	743	724	690	648	768	718	700	708	708	772	673	554	592	688	717	660	609	606	624	778	545	588	582	663	572	656	541	496	545	515	589	644	601	486	710	611	619	620	582	691	525	574	547	607	789	660	592	626	705	771	475	560	632	477	635	545	615	599	802	625	561	658	610	487	570	488	620	589	629	505	633	599	547	560	527	525	466	415	527	544	679	416	550	609	528	494	457	412	676	465	601	510	431	455	485	566	590	400	565	584	509	576	602	426	696	665	479	571	505	653	465	586	692	421	548	553	502	434	378	530	538	386	557	614	525	540	511	514	413	397	426	454	448	505	424	497	427	559	496	424	491	381	536	481	420	404	492	467	410	439	399	343	371	684	401	420	429	545	452	502	290	480	460	542	454	351	451	442	436	359	469	416	376	291	391	533	533	465	440	317	490	484	522	448	443	389	501	361	454	419	429	396	494	362	517	441	399	457	358	368	360	445	310	424	539	457	507	376	272	311	371	388	425	334	381	333	385	392	596	412	374	447	361	355	370	346	385	483	392	341	307	357	371	381	294	428	376	407	331	399	475	355	276	295	342	278	393	361	320	292	515	477	412	388	376	347	299	396	400	366	307	442	363	363	381	218	279	382	305	512	363	438	427	334	377	302	298	302	299	360	326	277	363	370	398	424	294	297	320	339	246	309	348	406	381	375	399	310	325	436	305	306	257	417	336	348	430	372	393	290	455	350	344	296	304	343	270	271	318	290	311	253	271	280	245	306	295	202	360	288	284	233	299	282	300	273	249	276	281	366	338	397	327	252	222	348	240	262	232	317	277	237	278	228	202	162	261	266	334	379	334	322	157	242	232	243	286	261	384	233	175	245	277	331	245	260	325	250	187	272	288	223	252	300	226	218	330	333	249	299	278	276	230	240	254	202	370	346	208	294	253	259	186	325	247	261	200	354	312	264	237	311	272	339	335	283	235	268	297	243	266	229	314	330	249	220	219	282	304	150	168	190	423	313	287	246	251	243	262	327	326	265	241	171	198	268	255	236	233	233	233	218	200	237	299	231	248	178	286	225	236	208	291	220	236	306	225	218	215	316	223	229	175	245	238	171	209	213	280	280	212	185	272	205	225	189	246	213	255	237	188	226	280	249	126	193	475	268	214	240	190	239	212	202	275	202	237	216	226	272	252	184	212	206	243	215	295	191	282	184	340	185	178	208	333	201	140	186	206	193	217	287	207	293	207	229	162	167	156	217	174	217	208	250	176	261	197	229	178	189	187	232	146	176	139	373	173	206	210	235	176	256	251	205	197	201	205	299	140	119	163	206	153	136	183	182	226	114	146	151	249	159	249	126	110	192	232	198	198	184	242	133	167	133	210	136	216	196	141	156	233	201	172	222	151	210	175	186	234	289	194	124	187	166	267	178	168	155	189	212	117	97	162	216	102	185	203	205	161	166	185	136	175	179	166	140	169	219	139	203	238	185	111	150	183	163	299	192	185	176	100	173	122	207	308	106	161	165	240	149	190	223	136	129	191	233	133	187	210	302	204	148	173	239	152	251	188	265	183	138	156	125	206	207	172	109	208	119	133	187	164	209	138	136	126	106	139	131	197	167	289	156	170	129	133	311	120	117	114	135	141	114	65	157	183	110	252	125	144	155	117	155	128	89	113	205	137	164	135	174	152	121	209	215	96	139	144	104	134	86	134	174	186	188	134	129	96	160	165	131	105	156	147	116	268	169	170	107	136	141	96	160	125	202	141	200	141	88	244	156	119	144	210	156	106	139	390	214	146	137	115	155	83	129	142	156	143	181	184	146	122	197	121	164	121	141	138	119	140	103	143	95	132	133	210	128	100	68	134	168	97	108	160	144	64	100	92	136	143	208	117	95	135	63	159	156	99	84	119	155	130	125	136	121	163	173	137	74	150	109	193	80	96	163	118	99	89	137	102	112	150	104	111	126	94	127	80	136	125	127	217	105	109	147	92	152	85	235	105	154	90	105	93	78	108	105	103	106	96	107	149	131	151	100	135	100	112	78	104	162	185	91	85	122	98	102	99	104	91	97	130	93	128	98	91	126	132	143	110	146	127	111	105	93	103	66	94	94	137	87	152	84	76	174	83	120	81	116	90	62	90	86	118	133	107	162	115	127	89	105	128	160	87	134	130	114	66	95	130	191	116	81	74	124	72	132	162	79	69	178	154	91	121	76	100	74	86	97	125	63	92	52	90	113	83	115	92	126	131	93	170	74	85	90	89	107	105	96	101	105	110	101	73	110	88	49	82	85	85	105	80	79	96	80	119	44	82	88	98	53	78	123	119	78	127	100	109	109	133	113	117	166	59	93	133	99	124	64	73	117	84	257	86	171	60	94	93	68	74	111	95	111	85	88	79	98	57	61	78	77	109	32	146	73	92	54	101	88	87	78	56	88	95	81	127	60	85	122	94	110	63	235	103	93	81	84	70	95	82	100	84	125	91	69	82	140	120	80	91	70	56	102	55	92	83	62	60	67	77	127	144	44	82	121	74	74	46	76	103	61	98	66	92	75	60	83	50	48	73	68	55	76	76	53	50	85	68	84	73	111	88	47	106	80	67	94	86	91	57	47	39	79	61	73	31	74	69	59	83	58	52	39	78	84	106	55	68	59	71	95	47	113	79	56	62	78	45	28	93	60	50	74	54	96	62	136	47	53	52	69	79	49	148	106	68	61	55	48	81	49	43	50	56	45	55	84	58	69	53	73	63	89	35	72	61	42	51	55	83	42	84	42	50	51	119	51	46	65	51	44	95	93	79	48	50	42	55	77	79	72	46	49	49	45	52	54	66	137	64	75	44	32	50	36	45	66	87	58	57	93	63	50	70	53	65	72	46	38	44	38	41	63	57	41	65	80	46	46	40	81	37	77	28	106	40	53	61	57	51	38	51	37	54	36	60	47	50	70	44	68	65	30	67	58	50	90	68	44	82	52	236	29	86	53	27	46	107	44	91	90	42	25	40	45	24	46	45	27	33	27	76	27	50	38	26	34	48	67	58	31	34	50	44	35	38	64	55	27	49	11	42	41	27	48	33	57	45	33	39	74	28	65	30	38	21	45	52	49	38	42	40	39	28	41	30	47	42	49	14	31	27	13	39	28	49	43	46	57	24	36	55	43	53	21	10	44	27	41	48	52	54	56	29	38	56	24	36	54	27	15	24	62	36	48	51	48	36	52	46	17	22	21	50	31	38	18	39	41	25	33	61	9	47	56	29	39	33	39	34	23	25	33	27	19	30	120	42	30	44	38	25	36	22	22	25	30	21	17	35	17	38	41	37	19	22	11	33	34	31	15	35	41	9	25	24	49	26	18	15	30	37	17	32	34	47	26	20	16	21	26	32	26	14	29	48	8	22	34	37	14	34	25	29	30	18	35	38	30	42	35	15	14	42	11	40	29	12	33	16	33	47	13	27	12	9	4	16	25	21	30	15	21	19	26	16	27	17	18	16	27	17	8	12	43	19	4	12	180	18	22	34	15	15	16	19	17	11	30	24	23	13	12	15	17	12	12	9	36	24	7	16	12	13	16	25	18	8	19	21	8	17	14	12	10	32	12	21	26	6	11	18	9	11	5	3	26	15	18	11	9	9	17	13	21	25	14	2	8	13	5	21	15	28	21	18	9	10	19	6	6	25	7	16	13	15	12	5	26	32	9	29	26	7	7	5	8	11	20	4	11	30	12	6	15	13	2	3	5	21	7	9	1	5	10	9	6	14	5	15	3	4	34	16	38	3	7	7	3	0	8	0	6	2	20	12	3	6	3	8	2	7	8	1	54	3	3	7	1	5	3	2	4	0	4	5	4	5	2	0	5	3	1	31	1	0	0	1	1	27	0	1	2	4	3	5	1	0	0	1	0	1	0	0
ne0230	4432	3573	2799	3212	1873	2783	2168	2322	1820	2325	1575	2203	1948	1674	1435	1786	1596	1398	1472	1914	1521	1417	1339	1520	1395	1143	1317	1376	1296	1462	965	1185	1163	1512	1031	1144	1140	1124	1309	890	1103	959	963	1143	948	1272	1430	1097	975	884	1433	1046	963	1018	1041	1021	849	1072	1001	939	1328	900	658	747	744	995	1253	897	997	895	1005	822	901	816	655	986	1123	911	945	707	878	872	1056	744	733	1043	719	850	717	842	614	891	1086	770	750	707	955	699	772	772	825	661	618	975	843	690	662	997	748	866	679	792	1027	1045	1005	816	989	771	494	1072	626	1036	662	759	737	652	611	639	953	972	630	647	631	677	703	323	536	602	938	668	656	674	650	657	458	696	645	458	664	731	634	576	647	644	660	448	614	563	919	910	675	571	559	732	807	582	601	495	456	633	555	612	553	754	877	560	681	846	541	530	615	607	596	626	429	490	476	497	604	594	441	435	354	512	618	700	549	818	538	604	430	516	452	582	339	665	462	501	403	510	818	527	438	590	517	513	496	432	351	726	689	432	471	551	624	486	589	592	491	552	544	593	426	292	636	453	370	562	608	520	431	537	496	328	279	475	566	551	427	470	614	373	581	500	436	750	424	457	474	375	437	501	505	367	388	444	382	368	463	384	464	421	681	536	518	343	541	451	599	420	306	547	413	286	381	214	399	403	273	464	521	565	481	527	292	407	391	540	373	507	365	572	261	477	432	410	417	485	274	470	421	440	510	399	309	199	475	294	418	605	387	428	429	233	477	359	493	427	383	429	419	493	492	452	543	432	445	265	440	417	453	421	488	305	476	403	369	376	260	274	502	375	489	411	376	514	341	262	216	275	260	361	356	286	319	366	554	367	362	416	279	273	431	443	387	268	340	357	376	391	345	264	470	409	340	369	485	431	394	375	309	285	322	254	396	369	285	293	224	432	415	288	439	298	374	235	328	300	460	449	348	366	337	395	310	320	252	318	395	481	389	157	354	430	300	465	374	395	194	312	304	232	237	362	362	408	301	208	192	326	321	230	233	251	303	358	264	202	297	347	305	270	378	307	363	280	406	320	245	222	384	289	244	247	242	327	223	298	263	156	164	247	276	363	338	275	290	213	175	232	224	346	214	302	331	193	335	273	297	253	246	362	188	210	286	334	363	239	343	270	226	350	353	228	307	294	201	244	258	335	228	329	303	214	333	242	339	227	283	307	283	209	360	221	266	274	291	318	337	400	293	226	293	302	177	262	221	389	262	286	269	181	283	305	124	111	166	464	287	351	209	227	275	281	303	299	312	228	206	279	252	290	299	263	252	293	255	335	200	299	271	157	207	269	278	215	164	308	263	300	312	221	235	230	334	206	221	230	233	260	179	197	263	218	295	188	257	228	274	287	208	224	205	338	273	189	191	281	272	153	211	432	254	136	243	167	205	263	220	313	148	291	204	233	260	193	203	220	225	216	225	273	214	171	216	313	195	206	154	250	204	120	173	230	180	266	248	185	240	222	212	190	222	199	266	167	200	170	258	159	236	220	214	215	243	206	288	163	150	196	145	126	226	183	278	160	178	275	191	251	175	190	245	148	108	144	223	136	161	147	188	247	182	183	83	274	189	193	175	140	195	234	217	180	172	252	150	184	207	214	165	205	183	105	187	235	208	163	212	149	184	153	201	234	249	190	152	212	214	194	118	149	140	206	167	96	80	197	266	80	195	181	217	126	234	180	96	159	141	121	150	214	154	129	202	276	176	145	117	159	138	330	220	169	179	90	169	158	140	327	91	129	232	246	201	209	183	140	137	149	255	148	238	180	283	166	204	187	254	154	222	223	253	204	124	161	183	220	166	107	161	208	84	163	188	135	265	150	182	130	102	133	174	162	185	233	147	178	148	99	218	120	152	139	194	155	161	73	135	161	130	248	121	161	196	161	178	134	74	166	177	123	156	134	167	279	177	168	168	81	178	191	182	168	74	132	145	165	189	142	158	142	183	145	157	132	101	136	91	103	134	150	69	168	112	92	181	128	139	204	179	133	88	174	241	147	150	192	149	129	106	69	196	148	150	141	175	119	109	147	169	142	159	169	116	113	265	127	93	109	103	133	161	107	114	143	78	117	141	193	171	128	110	176	146	114	135	112	139	80	81	179	133	117	196	101	102	102	82	126	124	108	70	144	183	108	146	120	122	202	152	100	60	186	105	147	68	90	121	119	137	87	99	128	93	158	148	109	111	136	100	72	164	92	95	199	144	129	161	98	119	84	215	104	81	133	109	97	74	96	110	96	64	104	98	106	99	129	115	145	88	107	74	98	120	128	100	63	76	126	116	131	98	60	159	140	64	129	99	116	148	140	125	87	92	154	108	101	104	98	84	94	108	198	76	147	125	84	131	102	96	105	102	113	40	37	66	78	114	118	182	80	155	119	130	71	154	63	108	116	86	79	113	148	217	101	66	87	108	121	102	175	78	89	65	124	126	164	44	101	67	73	66	145	39	79	51	91	112	69	106	94	88	130	123	198	50	110	122	92	98	127	140	101	94	80	68	96	98	169	39	116	32	55	119	76	60	128	96	81	62	107	114	115	56	102	112	71	51	134	130	84	90	102	79	110	156	50	86	115	52	27	73	87	106	77	114	62	153	88	72	89	71	43	205	125	92	135	84	89	120	99	30	59	47	68	26	107	94	73	52	110	64	108	70	62	95	52	39	76	97	97	164	44	139	38	43	104	108	62	110	63	114	96	95	103	116	103	48	119	144	108	52	124	34	57	79	35	44	62	62	86	67	137	128	84	40	33	134	68	76	126	90	108	61	91	59	100	53	79	61	44	57	64	62	93	96	45	32	37	80	55	81	64	81	60	68	93	54	37	98	67	78	69	32	26	77	90	58	34	61	57	48	142	60	47	47	96	96	96	63	60	93	62	95	51	151	101	48	61	65	49	62	50	52	58	68	79	73	58	155	47	73	44	72	122	73	105	104	77	73	59	69	102	29	33	67	85	47	65	62	74	30	42	68	24	78	27	63	62	39	75	71	59	26	98	37	45	50	104	20	74	66	49	88	138	92	49	31	65	30	44	51	56	70	42	33	49	37	53	93	74	117	39	85	58	40	38	54	54	42	64	53	30	95	63	70	76	50	61	60	48	42	32	51	75	73	44	39	57	67	30	43	21	89	42	49	32	87	80	34	50	63	31	89	58	17	59	52	66	49	75	92	53	62	72	21	76	61	55	64	66	51	57	47	47	36	96	57	92	57	59	48	37	77	39	11	33	37	39	56	46	30	34	21	58	35	62	30	11	87	50	58	64	19	42	43	21	39	19	112	30	27	59	27	44	49	29	31	28	29	50	61	26	74	38	39	41	33	25	46	37	32	32	29	41	43	34	28	21	51	36	55	23	59	25	30	34	27	50	42	43	57	14	43	63	31	54	14	30	44	22	20	27	37	39	31	36	49	54	38	42	23	33	23	12	38	26	42	47	43	38	35	80	22	16	55	33	26	19	47	52	53	27	17	28	23	29	77	38	48	22	74	24	23	32	35	32	13	29	40	20	24	34	36	30	24	34	20	15	13	20	32	22	13	24	26	31	29	24	37	53	12	20	14	24	20	20	57	67	44	26	20	9	30	40	8	49	16	54	16	16	19	28	34	49	47	16	26	55	11	24	14	13	23	34	26	30	13	12	39	10	17	37	50	4	53	80	7	30	26	7	48	17	37	23	22	38	15	7	2	7	9	26	23	27	41	15	19	10	36	19	46	20	27	27	15	8	33	13	37	7	26	16	25	31	8	12	18	9	18	17	16	17	16	14	16	15	29	24	7	14	14	21	7	32	8	8	37	14	7	4	22	21	14	17	11	17	17	24	27	23	29	16	13	17	15	3	16	12	11	1	15	12	10	7	26	5	18	13	10	4	5	16	1	24	19	12	29	26	2	11	15	3	4	15	7	9	15	5	6	12	18	41	8	29	38	13	6	11	15	1	7	4	4	0	11	0	17	0	14	8	15	20	6	2	8	4	5	7	6	8	5	2	3	16	16	11	0	5	9	17	8	6	4	0	4	4	4	2	29	6	4	6	3	1	2	3	6	3	5	3	3	4	22	0	4	2	1	0	3	6	2	2	10	0	10	2	0	0	1	4	0	3	0	1	0	4	2	0	3	0	13	4	0	0	1	0
ne0231	4376	3795	2869	3600	1967	2486	2292	2020	1697	2406	1669	1864	1633	1534	1552	1549	1444	1538	1351	1640	1483	1482	1375	1549	1331	1240	1336	1351	1281	1475	1003	1160	1160	1298	1126	1162	1071	1132	1205	931	1113	1022	1274	1147	962	1123	1190	964	1111	983	1168	1041	924	1220	1163	988	909	1118	891	945	1094	942	728	894	796	933	1063	896	959	985	1110	809	935	822	772	1082	1161	944	817	819	836	850	1004	850	748	839	715	878	787	836	684	782	994	732	754	805	766	752	828	741	746	722	759	775	855	712	731	784	614	722	694	669	828	817	829	878	780	673	643	910	655	834	765	706	747	682	600	689	730	771	672	675	627	664	704	434	550	606	781	646	645	629	616	679	510	664	589	527	610	664	663	614	625	689	685	548	592	691	692	848	653	616	607	705	791	512	617	526	500	673	555	622	596	785	673	611	708	670	616	521	845	639	611	579	521	588	519	506	559	596	465	415	494	552	579	676	544	652	481	560	528	488	427	652	478	565	613	462	463	472	649	537	495	575	497	502	598	383	387	662	678	451	438	462	591	456	559	643	449	577	532	522	379	360	552	525	443	561	609	547	411	500	546	329	379	432	504	613	564	493	497	455	604	659	440	565	470	449	519	374	417	555	547	344	365	397	354	438	534	349	463	435	643	497	507	406	511	462	539	453	336	568	466	328	469	222	451	506	320	437	525	495	410	572	313	506	466	538	399	470	539	609	277	502	387	365	359	417	294	373	426	414	396	598	329	326	404	224	450	548	403	470	437	362	455	344	470	505	393	524	410	442	464	438	447	384	397	346	464	467	351	386	560	367	442	342	322	417	335	348	463	391	420	501	357	404	486	367	302	355	303	350	424	312	401	365	425	358	300	360	381	271	398	439	394	248	360	351	348	398	529	272	357	380	358	377	456	359	365	398	391	260	329	255	446	358	328	362	246	425	398	407	467	339	364	268	360	346	389	423	392	419	379	359	331	320	293	315	370	425	366	177	351	492	274	229	401	306	239	328	319	281	269	321	388	391	277	291	241	301	300	293	291	312	311	314	260	235	275	308	316	282	374	339	347	290	397	341	250	240	398	446	295	255	261	295	288	355	259	271	278	232	254	372	300	288	238	266	223	214	245	409	235	336	320	185	323	326	288	229	245	313	247	199	267	280	299	344	308	268	243	296	317	238	280	316	222	224	230	292	210	377	291	284	270	198	256	211	299	262	253	181	347	268	290	235	276	296	329	292	278	213	314	235	207	314	258	327	281	284	236	207	261	381	138	161	220	486	277	362	256	263	244	241	258	319	289	248	191	233	264	296	281	303	303	304	230	307	222	260	295	144	235	292	263	202	204	318	268	284	304	235	208	221	339	220	342	211	282	246	260	191	328	209	267	153	266	278	256	247	250	308	223	358	264	246	202	273	282	131	216	400	261	152	202	167	261	269	226	252	138	213	202	219	305	215	206	233	213	225	251	300	246	183	219	303	152	222	167	271	241	111	208	236	198	258	287	210	225	230	179	257	234	159	240	210	219	191	240	191	265	241	209	209	235	213	223	173	161	181	155	186	213	166	267	188	231	252	199	212	210	186	239	159	165	143	172	183	104	149	182	211	196	226	138	263	194	202	132	82	230	236	168	181	196	234	184	163	195	263	227	181	211	117	177	272	178	206	279	133	242	163	199	198	255	149	188	214	189	204	148	198	140	187	189	111	103	197	193	123	201	182	185	150	227	168	85	148	163	173	160	194	197	124	193	206	171	193	99	214	182	219	181	205	220	122	187	190	161	303	132	156	197	230	177	197	153	166	187	205	234	134	242	165	272	222	147	156	260	133	367	149	151	189	152	161	199	228	182	118	170	225	118	156	185	198	220	163	180	170	146	137	178	152	178	256	170	154	177	147	281	121	204	185	177	206	179	85	178	156	177	225	125	125	153	142	176	139	110	218	151	156	132	123	205	261	235	200	195	115	159	152	202	173	101	131	138	183	152	157	141	122	165	147	126	136	149	136	102	110	123	131	96	166	179	111	187	129	140	186	180	128	108	167	223	126	179	157	130	154	129	89	188	129	115	139	171	122	107	144	180	164	157	191	148	161	182	99	138	129	104	158	136	148	144	126	109	133	137	212	177	119	214	153	181	114	145	106	173	103	115	149	154	161	181	113	101	116	82	154	147	132	146	150	164	127	152	137	101	154	150	133	75	166	117	167	102	71	180	136	140	117	146	141	95	148	128	103	155	147	106	114	138	92	112	202	138	131	201	116	147	100	238	101	96	116	108	106	104	119	136	93	106	104	85	137	116	135	127	147	113	119	106	96	154	132	146	81	160	108	145	117	124	90	193	152	78	118	110	104	125	121	121	93	106	192	109	121	110	128	82	122	105	165	73	128	110	97	137	88	130	112	94	139	58	41	105	137	134	124	188	67	176	83	110	101	171	134	128	116	80	95	147	122	138	110	89	98	118	139	151	148	71	72	80	127	111	144	59	96	100	59	56	115	80	125	51	110	95	62	132	100	128	131	80	163	43	76	103	95	111	135	116	141	140	100	64	79	110	131	56	83	36	60	98	101	70	125	69	111	65	102	224	100	79	108	156	107	96	150	123	100	84	146	102	115	138	79	69	86	54	57	93	83	134	84	81	48	140	115	82	72	68	51	153	106	109	112	97	110	122	115	55	68	85	103	38	66	103	62	53	96	89	104	110	69	98	94	47	92	103	102	146	54	126	61	53	110	62	78	112	55	115	72	78	85	93	125	49	89	80	105	53	93	45	61	90	81	58	81	64	75	58	93	108	101	59	40	127	86	100	102	81	105	84	119	65	101	78	67	78	35	72	81	76	58	74	100	54	94	99	60	72	67	82	79	45	108	67	43	69	62	78	75	56	37	75	106	56	49	106	62	59	91	68	58	67	80	94	119	60	80	51	91	70	58	131	84	47	73	77	52	76	65	65	44	66	67	76	50	96	115	67	43	77	42	85	122	112	97	77	38	69	87	40	56	67	91	63	78	88	83	63	57	69	32	58	32	70	83	56	82	47	34	36	83	47	42	57	106	52	57	56	84	100	128	71	62	47	57	42	55	74	74	90	79	41	68	37	76	65	86	83	50	66	39	51	42	39	64	35	84	48	31	91	77	73	56	66	67	63	47	35	43	46	59	58	55	51	44	48	44	65	26	72	54	50	25	66	59	43	62	91	66	57	80	20	61	63	55	53	56	73	41	78	57	37	61	70	72	57	81	64	63	53	44	37	84	50	71	47	63	67	37	60	46	24	32	64	49	46	52	51	44	31	53	38	58	22	48	58	53	36	40	29	23	28	43	72	21	165	68	34	70	45	52	41	29	43	58	41	48	49	39	94	50	60	41	43	23	59	42	52	45	65	33	49	49	29	26	35	27	63	26	37	56	34	31	47	62	48	73	33	33	27	57	31	62	10	34	49	50	36	23	56	43	31	33	52	42	31	43	20	29	24	18	50	42	60	61	59	30	30	75	25	19	35	55	54	17	32	32	43	35	31	39	44	45	79	22	49	37	43	24	216	23	33	31	30	18	36	50	37	38	39	37	30	50	31	28	23	46	39	20	12	19	23	34	21	26	124	34	20	51	21	25	25	20	28	33	52	35	9	27	23	28	19	45	30	33	18	25	20	29	48	45	45	15	27	43	19	16	20	28	11	26	35	63	16	22	18	31	30	33	46	18	45	55	29	14	53	28	38	13	27	41	9	25	9	11	9	7	15	26	20	23	30	28	32	25	44	20	32	13	34	33	12	12	46	19	23	16	12	21	22	32	11	6	10	22	18	16	17	17	22	35	9	12	16	22	31	13	17	18	9	18	16	8	19	15	9	9	11	18	22	16	19	18	15	29	19	25	34	16	12	17	30	15	10	7	16	7	14	11	15	10	3	7	14	5	12	11	14	18	9	24	65	8	43	15	16	12	17	5	10	11	10	11	8	5	11	6	29	36	11	26	33	22	9	11	13	10	6	10	3	4	21	2	12	0	4	4	8	17	11	3	6	12	17	12	0	6	20	3	0	62	20	18	6	9	10	10	5	2	9	4	5	7	3	10	5	3	13	11	6	1	5	9	3	4	2	2	3	4	25	3	1	2	0	2	2	2	0	3	4	4	8	1	1	0	1	3	1	6	0	1	1	0	0	1	1	1	14	0	0	0	0	0
ne0250	1417	1044	713	704	489	618	675	474	465	605	430	467	484	418	484	412	598	463	420	377	311	461	361	423	345	328	269	364	349	325	267	450	299	438	269	245	446	267	319	218	375	316	209	309	298	366	340	378	337	253	337	281	231	325	310	326	182	224	256	276	247	187	160	150	255	271	301	248	276	268	193	185	198	250	194	153	263	285	247	288	352	220	274	231	141	233	255	200	203	243	261	194	256	214	124	168	227	195	235	260	218	204	201	212	245	185	217	247	240	293	190	245	225	257	206	287	205	246	156	172	157	232	171	228	174	239	235	180	201	207	182	178	146	150	176	177	170	169	201	170	257	354	251	157	112	229	235	157	235	228	224	207	227	201	135	114	254	108	236	240	259	118	168	168	165	137	187	89	142	221	155	209	175	244	172	135	150	195	125	146	146	207	168	144	197	100	160	222	166	185	122	124	161	201	177	181	172	188	119	181	135	113	163	213	170	249	146	152	155	157	183	164	108	127	105	100	176	98	161	147	91	144	98	143	112	158	168	132	156	182	110	161	154	146	166	149	103	77	104	162	168	127	138	129	85	150	192	127	174	125	129	116	110	79	170	158	95	162	119	145	118	101	126	104	117	173	165	116	132	128	142	133	188	132	118	117	116	216	110	100	71	88	100	145	64	116	97	155	101	163	138	228	80	97	127	116	145	151	110	108	92	126	126	103	145	105	128	65	93	119	88	84	66	144	92	68	142	90	160	112	111	99	119	89	83	161	136	92	120	78	189	219	114	119	120	117	126	73	158	132	120	139	136	80	182	100	111	95	67	75	109	102	111	69	90	188	107	103	58	79	90	148	146	96	134	128	122	141	119	109	94	104	100	120	123	113	88	85	101	110	136	92	93	197	90	96	93	62	75	93	68	89	142	112	104	96	84	135	100	107	115	61	188	123	129	89	59	72	129	89	66	81	60	169	152	63	94	77	95	137	108	63	112	114	122	111	138	91	90	84	116	76	48	72	94	87	84	105	73	80	72	59	62	110	95	90	75	58	78	100	94	103	100	75	67	54	68	73	75	93	124	60	55	78	84	74	57	80	73	65	106	87	103	73	105	71	92	52	78	112	86	79	78	100	80	88	153	107	110	60	74	92	50	51	45	67	58	87	109	92	34	96	83	102	102	86	60	73	79	82	91	62	85	43	80	34	72	48	122	101	84	67	42	83	105	84	58	68	64	72	63	90	73	71	80	70	50	73	58	71	89	46	32	62	54	77	63	125	47	110	61	82	90	78	42	66	65	51	107	70	74	80	94	96	61	117	77	57	85	77	99	44	34	58	82	106	84	113	63	55	58	100	77	47	79	66	103	73	61	118	57	60	61	30	52	93	84	81	81	92	87	52	64	129	58	50	43	44	50	47	57	65	32	35	55	43	51	63	66	59	103	27	60	31	45	109	52	62	46	82	64	18	54	67	42	29	31	83	56	54	74	68	38	54	38	57	70	69	32	45	27	47	55	50	59	53	70	103	46	58	95	93	51	81	53	47	47	62	56	73	54	30	45	108	54	31	55	57	81	33	66	54	76	43	62	28	49	25	46	44	44	47	48	44	53	33	71	30	79	29	58	74	68	62	70	65	55	43	89	43	59	41	43	37	53	40	45	50	87	41	71	42	73	19	40	44	37	60	47	68	85	37	72	47	57	32	38	92	45	24	64	42	60	88	52	50	40	34	56	36	35	49	36	68	25	65	61	59	50	39	49	33	57	38	29	24	30	53	54	45	38	72	55	34	37	39	60	44	56	58	37	65	75	77	32	45	70	45	43	33	40	53	39	24	27	43	53	64	44	78	47	60	30	57	60	46	45	38	72	42	19	29	54	23	27	82	31	74	54	50	84	79	29	60	82	35	46	35	26	27	44	39	26	47	52	36	49	48	21	34	67	28	87	66	34	96	29	21	34	36	32	48	33	30	30	23	26	18	27	32	31	60	24	57	44	30	31	46	30	36	32	45	62	47	34	33	49	39	56	60	25	36	41	73	12	37	46	15	55	63	46	45	27	26	40	38	71	41	41	41	39	33	51	20	27	22	24	43	31	45	36	54	21	34	32	36	18	42	49	32	68	40	20	45	27	27	22	53	57	30	20	57	46	34	39	37	23	32	24	45	14	32	39	70	39	67	35	40	15	56	25	42	31	33	36	28	46	80	30	22	15	17	37	86	29	22	45	45	28	13	42	45	20	56	42	20	58	36	22	32	37	23	19	34	40	32	71	34	20	46	27	18	20	25	34	25	40	30	24	56	34	36	19	23	32	41	36	29	11	62	34	33	27	33	50	31	21	26	37	49	38	25	54	17	29	25	68	34	25	46	22	23	39	53	22	35	25	12	42	28	39	15	26	52	18	26	30	30	57	23	31	49	48	30	50	11	26	24	22	20	26	50	33	41	12	27	17	21	32	35	41	27	30	20	28	35	20	23	6	34	31	39	17	67	31	27	81	21	17	29	33	37	20	32	18	16	33	17	51	19	17	53	38	18	16	33	44	16	29	43	24	54	15	42	43	39	44	38	23	33	21	34	15	17	19	83	21	32	22	33	33	25	28	38	34	21	18	14	14	30	23	35	29	31	23	45	31	31	22	14	34	12	34	25	35	22	21	35	17	29	53	9	16	21	27	21	22	26	18	14	22	22	23	38	14	24	25	17	18	10	27	20	14	50	25	14	18	16	59	27	45	27	30	23	20	20	20	24	27	11	26	22	10	31	15	19	19	12	16	22	16	31	18	52	15	26	11	22	22	17	24	4	28	28	12	15	24	32	15	21	15	15	25	24	24	4	51	33	14	14	20	17	38	18	36	28	16	51	10	31	22	17	5	18	7	11	9	14	22	11	14	17	15	23	9	16	49	23	17	16	16	33	19	18	18	49	15	17	20	9	8	23	15	11	43	38	28	6	19	8	26	39	13	7	20	46	11	36	13	14	21	18	14	14	18	12	25	19	19	16	10	4	24	32	15	10	11	8	10	23	18	23	15	24	8	14	27	12	11	21	20	25	24	27	10	14	19	15	13	11	10	39	20	18	8	4	22	11	45	18	12	13	28	20	12	21	17	8	8	37	43	11	17	25	12	13	22	62	14	16	31	22	39	15	7	13	19	28	20	18	11	4	9	14	21	8	10	27	10	9	19	9	26	7	34	17	26	19	14	13	15	23	25	20	26	14	6	18	21	10	26	5	27	16	21	11	20	10	8	39	48	15	10	9	18	16	32	21	7	30	8	5	9	19	19	16	16	6	23	9	9	19	13	9	8	10	12	9	22	13	17	14	18	14	8	16	20	20	4	9	5	10	20	14	7	47	12	11	2	9	13	14	17	10	25	14	2	21	3	7	18	2	8	1	4	11	6	9	6	5	8	8	9	4	12	12	6	13	11	5	12	6	17	22	13	15	12	7	13	8	20	14	23	5	28	2	10	13	19	8	6	29	18	8	5	12	4	14	6	11	6	9	19	10	5	15	4	3	13	18	12	5	6	9	35	9	9	35	32	2	0	10	10	10	6	6	9	8	6	12	12	35	0	18	5	13	0	5	7	4	5	14	9	1	4	6	6	12	2	13	5	8	6	2	5	4	6	12	4	17	7	12	2	12	5	7	7	5	5	10	7	1	22	4	23	8	7	4	10	2	8	5	17	4	9	3	1	6	5	9	1	4	10	6	3	1	14	6	5	3	11	10	9	6	7	13	6	10	4	7	2	1	4	5	7	23	3	3	9	14	3	5	8	3	12	5	4	24	12	6	4	1	5	7	3	0	3	1	6	4	5	3	5	7	9	4	7	2	5	0	4	3	1	3	6	1	2	8	6	3	8	3	0	1	4	7	5	4	1	2	3	6	7	2	1	5	1	11	3	6	2	5	10	2	5	10	2	13	6	2	3	9	6	8	3	3	1	3	6	0	1	0	2	8	2	3	16	1	1	0	1	2	4	2	0	4	14	0	6	1	5	1	9	2	1	6	3	5	3	7	3	3	2	0	0	3	4	6	5	2	2	3	2	0	2	0	1	0	1	2	14	10	3	2	2	0	0	4	1	0	1	0	1	4	1	0	3	0	0	1	0	1	41	0	1	8	1	0	0	0	2	0	0	1	0	4	3	3	0	1	0	0	7	0	1	0	0	0
ne0251	3378	3638	2508	2464	1655	2054	2099	1583	1523	1311	1516	1702	1618	1339	1332	1430	1584	1449	1311	1313	1245	1445	1074	1255	953	1304	1001	930	1107	1105	966	1365	983	1161	998	740	1124	894	1027	771	1026	965	1006	837	1166	1072	1108	747	915	982	961	906	746	1111	808	936	1123	787	743	764	926	837	621	759	749	761	982	869	815	808	776	612	696	755	751	741	761	759	688	956	848	772	897	759	552	871	787	723	681	650	665	622	915	574	620	661	783	670	740	676	622	568	608	836	728	681	624	828	585	634	597	593	761	778	764	628	741	622	587	719	575	864	513	655	583	767	677	620	715	715	640	517	656	564	515	601	548	601	746	644	651	647	695	626	477	540	640	707	649	433	747	611	538	572	436	591	582	531	728	648	611	510	608	459	594	522	525	493	666	655	549	610	618	605	663	504	480	718	590	581	623	658	518	498	489	534	456	459	573	480	461	405	536	618	506	652	519	663	458	519	377	519	546	579	652	556	524	426	487	466	635	438	461	379	373	472	467	417	506	449	387	483	425	429	379	571	396	428	499	495	412	444	667	434	498	536	381	294	384	497	510	361	626	467	450	400	539	411	527	441	424	386	463	462	423	578	339	486	343	648	347	386	431	300	345	429	396	624	452	426	496	425	449	339	425	386	400	480	416	469	375	256	424	698	500	521	319	401	386	398	329	496	348	373	389	375	457	341	382	384	354	358	343	294	359	578	433	340	287	388	352	363	322	507	359	406	354	359	435	356	352	337	382	524	387	354	286	441	383	371	485	351	321	515	340	400	382	409	470	344	398	364	442	310	345	365	338	336	352	374	336	387	396	255	277	381	391	468	288	382	308	309	350	355	368	392	372	371	294	303	343	336	236	350	345	575	346	295	294	285	418	282	276	299	347	349	545	266	252	335	391	308	439	428	284	330	315	361	360	253	287	459	346	282	318	317	384	275	304	313	263	247	306	326	361	276	225	303	240	317	287	258	442	347	379	276	310	377	241	321	273	287	238	283	376	275	263	273	246	307	250	250	325	310	240	264	363	232	264	320	280	244	259	253	231	222	280	236	327	246	352	215	241	307	213	306	226	248	222	254	312	228	280	304	349	222	259	296	220	362	219	264	217	327	327	318	350	302	235	276	375	307	234	291	217	267	248	290	237	222	228	267	235	230	243	272	343	280	279	245	236	240	258	216	208	230	241	228	257	276	260	234	214	289	272	253	239	191	173	262	228	294	211	274	265	197	204	227	175	234	325	218	204	270	252	320	294	244	161	349	210	245	239	213	155	143	238	200	266	263	208	247	252	218	261	294	200	228	249	240	213	197	217	220	258	210	361	214	186	189	210	177	189	225	189	340	255	248	212	267	254	193	275	156	191	237	209	226	159	191	188	202	179	199	190	193	184	154	152	281	336	180	178	179	168	162	186	205	217	161	239	166	172	153	247	273	150	153	182	251	318	137	234	230	149	150	158	223	202	195	188	166	211	146	150	206	211	206	156	187	188	239	179	281	209	217	215	196	194	210	216	251	220	250	209	227	191	200	203	208	189	125	205	242	179	242	167	141	293	175	142	156	171	159	303	204	165	293	154	185	154	156	152	189	248	137	189	93	201	134	181	148	230	161	155	151	154	162	279	150	144	142	170	114	146	166	152	150	174	186	118	160	167	128	141	165	169	219	169	197	215	146	179	193	217	202	157	195	195	130	147	125	119	195	212	118	149	183	149	140	164	160	151	164	175	185	151	149	224	181	163	158	120	146	153	122	310	176	153	205	124	171	152	156	147	165	148	214	156	136	169	170	199	151	128	127	144	136	180	195	123	154	120	146	268	113	123	152	120	143	147	134	136	177	161	180	168	162	212	119	164	147	224	87	99	196	127	185	191	149	267	215	139	204	175	147	180	141	101	118	202	140	118	180	120	107	169	101	111	122	151	98	172	128	149	143	170	108	97	131	162	121	128	132	101	139	94	139	167	262	132	218	86	129	120	98	115	128	96	133	128	145	142	118	232	114	122	163	163	158	114	104	162	148	101	129	132	82	218	119	111	108	111	109	131	147	109	137	103	140	133	95	153	82	151	115	305	113	133	132	118	146	146	161	102	140	84	120	135	96	147	118	123	135	103	124	90	156	107	119	101	135	116	86	135	148	92	134	113	108	88	138	130	178	104	143	126	177	92	91	150	97	92	106	132	94	130	136	85	73	87	139	98	197	144	101	124	131	88	233	147	88	78	134	108	83	90	137	132	117	93	94	67	122	108	84	95	104	131	154	84	105	73	105	91	123	88	69	158	98	147	73	102	115	109	102	112	111	96	126	165	119	107	122	115	106	82	122	107	119	82	95	102	95	120	130	172	125	58	92	112	84	100	86	97	95	86	86	132	76	126	41	101	86	86	98	93	153	165	71	97	93	90	104	84	99	77	90	107	71	105	112	105	85	94	82	71	97	79	139	114	87	130	107	100	116	61	73	62	91	94	75	111	135	103	95	221	145	111	89	79	75	116	109	81	88	74	130	77	89	92	130	93	162	59	105	83	114	84	109	115	148	113	120	110	142	106	85	77	113	112	95	85	96	86	148	89	91	116	98	113	87	99	77	110	72	70	101	76	46	70	53	78	115	60	170	102	151	66	57	91	74	123	58	58	72	90	130	76	141	130	79	96	91	144	73	110	79	114	70	95	112	81	67	95	66	88	58	63	71	92	105	68	142	76	71	98	80	92	85	129	55	62	95	77	84	62	67	86	98	105	63	58	85	63	102	60	58	90	100	34	99	52	85	69	69	55	118	57	57	68	43	65	109	65	52	51	54	105	87	74	69	80	90	129	48	87	103	80	70	102	83	65	54	57	77	45	74	73	134	64	74	79	93	56	81	75	101	65	150	42	57	48	83	191	86	89	77	78	79	81	60	76	64	99	83	52	70	40	92	57	60	68	54	80	103	73	57	50	45	71	86	65	67	49	59	66	74	75	68	70	62	88	49	76	53	63	43	44	48	71	183	93	97	65	54	48	52	33	95	64	59	65	47	37	58	61	68	70	98	74	44	85	43	69	38	219	43	36	66	59	57	71	36	39	60	54	52	52	64	37	60	93	80	31	66	94	25	64	86	56	51	55	123	43	55	63	50	52	60	97	49	119	71	55	83	48	62	45	53	35	25	71	55	41	49	29	64	42	50	80	57	98	106	39	53	121	49	31	48	68	50	56	54	60	58	32	56	56	52	75	50	51	46	64	48	59	28	64	69	47	40	72	34	33	50	44	79	51	69	43	40	60	51	34	43	48	26	56	73	61	52	56	68	61	48	53	48	69	36	76	53	51	44	49	36	52	60	44	65	76	46	33	66	40	115	34	50	48	62	35	45	38	46	56	53	37	30	54	88	34	25	72	34	26	41	29	57	81	23	48	59	26	68	52	35	39	59	73	25	48	35	27	24	26	29	30	36	51	60	46	41	59	39	75	15	29	37	37	60	25	27	19	18	82	48	35	25	50	56	44	25	30	38	52	57	46	36	47	38	42	49	51	22	76	29	39	91	36	24	88	50	32	34	52	41	40	14	32	38	37	76	38	42	25	61	25	18	17	31	36	32	17	41	23	27	15	13	19	31	27	28	35	12	20	32	34	42	17	26	36	42	72	29	23	13	27	45	17	26	16	21	71	15	74	21	24	35	24	12	17	29	44	25	22	49	18	28	11	38	19	15	16	19	27	39	47	27	30	26	50	65	31	29	26	27	17	25	18	19	32	42	6	33	36	16	15	51	25	24	22	37	23	11	23	25	22	86	29	12	37	18	10	32	14	17	17	39	25	27	38	15	22	12	25	16	26	12	17	16	25	14	9	14	11	11	31	24	20	11	16	23	16	8	18	14	32	37	31	31	21	24	24	50	6	27	10	19	24	36	16	19	10	19	31	12	20	20	16	8	19	13	10	6	8	11	8	11	5	25	23	28	14	11	27	9	34	8	8	11	10	21	13	9	7	18	50	15	24	9	33	17	10	16	8	9	10	13	14	13	25	29	12	14	14	19	9	9	13	11	16	8	5	11	6	8	4	13	29	9	8	6	11	12	4	7	1	10	34	6	7	1	3	4	16	5	4	3	5	2	8	2	126	3	5	10	3	2	0	4	10	0	2	2	1	16	3	2	5	0	12	0	1	2	4	2	1	0
ne0252	1919	2458	1574	1348	1615	915	1174	658	1107	852	1048	665	550	533	653	614	431	864	584	636	907	533	632	680	709	729	700	589	645	632	724	628	587	342	559	696	515	723	699	548	489	466	615	427	401	282	344	370	348	535	264	492	395	535	364	363	583	540	458	433	295	500	667	564	497	450	301	480	524	553	534	420	442	641	770	696	665	459	467	544	370	447	210	393	636	285	395	398	318	379	358	341	199	406	490	407	247	466	364	403	453	301	484	185	382	343	317	234	290	231	345	319	253	177	227	287	218	277	1086	172	452	174	466	305	329	386	353	438	215	219	372	314	470	490	377	386	433	378	183	376	312	199	301	386	350	295	393	332	289	267	253	394	268	285	256	359	227	435	155	318	355	334	308	341	304	342	296	344	944	216	378	348	299	214	183	314	313	144	418	362	625	306	327	315	267	905	259	244	301	378	304	230	354	342	370	182	353	121	340	260	274	312	333	312	372	243	310	286	190	305	163	383	326	216	160	350	262	326	169	317	348	206	288	216	271	411	264	342	327	238	293	241	382	556	273	198	318	271	312	319	408	250	204	244	380	301	182	257	301	194	285	301	335	408	255	99	270	233	334	384	208	266	289	209	434	181	145	370	356	215	329	217	184	290	367	277	222	169	210	298	287	183	281	225	472	533	209	236	210	187	260	212	283	220	136	250	229	297	150	284	247	254	303	164	172	194	319	276	192	264	247	265	299	260	166	289	180	309	213	221	283	197	303	277	193	169	171	228	197	310	159	142	148	142	151	179	256	265	199	197	166	195	193	189	119	280	146	201	289	236	241	175	204	154	211	130	370	265	185	238	194	219	120	242	300	205	184	235	175	149	238	313	225	199	209	366	197	139	199	187	241	189	230	114	183	182	183	171	165	207	252	261	182	169	182	194	225	255	376	156	227	163	141	196	144	221	189	116	131	184	179	294	170	143	134	219	167	193	264	104	162	426	182	189	116	244	131	182	240	162	126	201	209	184	178	141	193	226	210	242	159	238	200	202	168	175	188	188	116	136	155	180	131	178	180	204	171	210	255	159	115	132	198	125	190	122	211	254	189	164	113	104	106	161	118	143	165	254	171	155	213	187	146	232	118	179	148	164	93	122	203	174	289	187	170	220	200	150	141	144	155	177	187	73	85	202	248	135	99	117	123	169	191	209	175	216	188	160	114	162	187	210	142	104	123	148	158	114	251	142	147	125	203	195	121	184	263	113	213	288	186	177	211	148	264	113	139	112	165	140	139	156	155	171	176	248	149	148	63	180	226	135	113	231	157	128	239	132	113	177	137	146	154	123	146	119	138	117	158	115	117	77	126	138	132	137	109	128	131	91	145	110	199	198	135	117	88	135	77	128	85	155	175	112	186	119	115	91	142	129	154	151	140	241	137	164	134	123	101	110	134	130	122	90	116	91	123	76	161	149	107	113	125	93	173	139	238	76	186	172	109	74	163	177	171	111	137	83	117	97	131	132	140	184	140	82	109	70	84	220	75	114	156	101	133	135	125	117	157	131	142	171	92	60	111	167	141	186	82	100	121	131	88	133	235	126	156	138	131	169	118	99	124	153	190	150	72	115	52	116	127	103	97	171	88	116	137	97	60	89	152	179	113	99	112	116	83	120	80	62	60	166	96	144	136	105	79	118	131	180	70	105	141	125	125	172	155	69	102	149	83	104	103	72	104	73	251	94	111	83	156	122	153	105	137	100	103	87	122	174	89	67	107	106	173	201	87	76	97	103	162	94	86	92	79	86	58	131	80	83	111	78	100	64	108	129	51	80	108	152	77	83	59	110	129	34	74	74	128	120	94	103	138	75	89	91	102	91	63	49	142	108	60	124	75	78	99	89	129	116	74	86	146	68	48	101	80	121	111	109	119	92	121	83	102	74	84	77	106	101	73	125	33	90	97	102	197	96	140	126	95	100	63	134	156	108	104	114	122	138	85	94	40	135	77	115	108	65	153	110	77	129	95	97	83	111	68	68	69	72	95	72	67	76	55	106	117	85	102	71	78	119	66	88	118	96	41	54	97	65	64	84	132	29	59	112	65	59	119	59	66	48	121	103	62	65	96	72	78	46	53	86	120	61	99	95	84	28	82	119	77	74	79	78	72	69	79	45	73	69	467	77	68	37	61	94	94	45	78	73	112	75	100	89	107	67	141	72	67	58	61	83	121	52	29	89	72	54	59	83	81	28	125	63	73	55	46	65	89	46	68	107	40	100	129	86	44	89	86	79	52	85	80	154	170	89	122	80	73	37	163	80	181	83	79	93	42	84	96	59	54	65	78	75	77	58	83	59	102	99	25	58	42	58	79	78	54	96	57	54	90	77	60	77	62	75	62	117	51	65	60	70	104	23	169	122	45	119	39	44	51	54	48	48	61	95	76	62	75	45	32	77	26	57	40	54	35	81	52	62	78	59	78	68	93	61	98	54	84	32	79	61	73	57	63	67	47	80	57	126	54	41	122	56	56	64	129	113	50	197	90	34	26	56	95	57	35	74	62	30	70	36	75	80	43	44	33	74	66	40	67	81	90	60	106	41	77	51	77	40	48	59	81	59	54	50	97	56	73	81	39	80	153	82	89	50	57	64	45	77	41	52	55	99	33	29	66	29	37	31	40	53	36	59	61	51	100	63	54	49	127	76	65	40	47	52	50	52	41	52	23	46	77	46	42	230	75	44	37	57	15	17	55	84	61	43	87	31	40	43	34	66	29	52	60	57	46	59	49	44	21	41	59	24	49	46	33	67	47	27	59	61	50	59	88	98	64	38	80	48	62	79	32	35	56	48	53	88	79	36	51	79	20	47	30	63	37	29	61	70	31	50	63	50	136	41	41	38	70	47	57	52	38	44	94	59	34	39	71	40	42	54	63	44	40	23	49	64	61	65	61	29	72	41	72	26	49	83	24	48	35	20	20	20	49	50	40	36	56	59	57	29	38	37	51	237	30	40	22	44	9	74	22	39	28	158	72	92	49	35	67	30	70	34	59	45	37	42	38	48	22	43	25	59	18	28	24	43	216	31	12	14	32	42	44	45	44	49	28	38	34	35	36	47	36	124	12	75	59	19	22	57	37	50	43	40	56	37	51	48	20	37	36	77	34	36	63	28	41	35	34	47	15	26	38	42	54	74	28	26	25	26	73	31	28	64	58	24	30	23	23	15	30	19	24	63	133	34	26	26	62	18	62	38	32	23	40	44	56	23	49	40	20	38	56	18	28	4	22	14	117	33	34	34	23	32	42	31	17	25	28	75	71	34	18	18	21	33	48	50	132	43	33	5	26	25	46	19	26	70	32	33	9	37	42	10	7	58	55	31	36	27	29	22	15	24	45	13	26	14	48	18	30	40	37	20	18	22	33	36	32	40	64	31	24	15	40	28	18	28	47	54	20	95	40	26	12	16	25	31	28	22	57	26	20	71	23	25	51	14	13	49	30	32	28	4	18	26	12	25	41	8	50	49	25	9	25	14	43	17	8	38	27	21	15	42	18	11	5	49	44	2	18	12	12	14	26	30	29	24	44	3	13	22	10	20	7	14	27	37	34	8	77	22	86	12	42	13	6	27	6	14	36	29	12	9	22	6	25	19	36	57	30	26	72	20	9	10	25	13	39	17	44	56	22	15	6	11	17	16	10	27	2	6	9	52	49	21	47	14	18	44	28	3	35	9	35	13	35	17	29	10	1	18	17	7	8	13	12	3	29	10	12	11	11	21	6	16	8	5	8	21	14	34	6	16	20	3	7	7	14	11	16	22	23	12	16	1	11	24	43	11	44	13	5	6	26	7	6	54	4	5	7	17	20	14	7	23	6	5	1	6	16	9	14	11	41	5	25	71	8	5	18	22	17	6	3	3	4	5	5	9	36	4	10	20	23	6	6	12	17	4	3	4	20	6	25	16	5	16	27	7	44	6	23	19	4	24	8	2	6	10	6	26	13	11	1	25	4	21	5	25	4	4	3	2	11	21	5	7	3	3	6	6	16	14	13	2	13	0	12	14	4	5	7	32	1	8	1	11	1	2	15	4	3	0	2	0	2	8	1	0	12	3	3	5	1	3	0	0	3	1	1	6	7	14	0	0	36	0	1	4	2	0	2	0	1	0	0	0	3	1	0	0	0	1	0	0
ne0253	2969	4014	2508	2683	1922	1660	1920	1348	1428	1169	1350	1145	1201	1277	1875	1049	1062	1265	1241	1113	1212	1051	1023	1165	1052	1232	1164	940	1134	1322	1145	873	956	766	1176	1267	1082	896	1033	1058	937	970	767	546	761	849	679	832	800	885	715	865	719	812	687	677	732	906	781	827	603	815	912	785	889	589	531	790	788	833	953	669	758	620	732	794	655	681	725	726	726	661	534	799	621	599	642	859	672	633	682	713	470	584	594	638	521	536	622	766	776	615	777	538	614	635	689	446	666	602	503	490	487	406	469	637	537	581	629	427	530	439	695	577	561	566	547	770	524	458	637	461	699	580	637	715	584	626	380	566	555	474	447	493	547	658	516	545	477	530	524	542	464	523	522	463	377	529	366	524	504	482	623	695	520	518	534	636	591	644	622	606	564	806	395	591	475	347	425	568	646	561	584	388	648	647	562	506	401	489	555	401	691	551	465	440	492	322	457	432	447	400	615	486	568	406	455	471	348	428	363	404	534	350	483	541	453	511	436	485	485	532	469	317	729	435	518	512	470	426	435	363	472	577	386	531	420	445	577	496	397	448	356	503	376	352	370	369	432	346	405	400	487	503	416	280	592	497	536	471	447	412	461	371	381	357	356	414	430	417	502	430	324	448	407	441	719	322	439	337	397	402	345	455	473	478	433	436	348	233	366	405	446	385	422	422	429	315	314	409	359	511	441	312	239	378	406	422	300	337	416	425	379	298	341	238	261	266	476	358	374	413	441	421	242	401	323	306	343	324	296	276	242	425	359	245	450	534	277	321	281	235	399	386	258	349	244	536	431	332	357	316	312	229	313	289	453	368	351	318	382	357	331	302	290	372	283	335	426	245	331	207	280	259	347	375	207	469	387	333	407	377	388	245	281	272	248	273	294	315	429	299	234	350	402	308	241	410	414	367	393	512	275	343	197	177	255	318	300	295	295	286	218	231	537	260	311	281	365	228	248	416	277	386	206	261	291	270	333	238	315	314	268	371	218	178	255	350	273	320	328	395	221	320	286	297	156	223	329	228	273	409	254	339	263	263	233	278	277	248	202	231	301	218	244	153	270	269	211	270	264	214	197	290	325	207	314	225	194	357	278	321	280	269	164	320	175	247	240	212	312	296	313	248	250	323	248	232	229	192	246	219	264	326	226	260	252	225	300	228	176	219	214	186	296	230	267	188	223	198	268	236	245	356	206	336	205	152	463	133	220	318	250	219	289	244	228	215	321	366	191	230	205	210	247	297	250	244	290	165	242	252	171	195	342	456	223	212	267	249	221	257	207	191	221	203	284	167	189	206	320	165	211	199	301	221	265	283	229	141	218	162	225	154	243	163	208	206	284	183	165	275	218	272	122	148	170	203	165	217	139	226	263	269	279	137	240	228	176	263	243	271	212	328	234	205	164	202	129	218	212	191	194	382	306	196	233	206	233	221	116	227	189	223	194	244	201	200	176	181	273	154	288	201	166	152	194	201	207	208	244	162	155	216	195	201	148	172	199	146	131	123	172	160	239	142	209	268	209	230	92	274	214	152	160	177	174	264	182	241	199	181	144	206	289	159	187	287	183	138	210	154	247	159	266	194	92	286	112	205	147	146	158	183	151	160	205	211	117	249	164	251	311	186	180	170	275	157	172	195	106	174	179	206	190	170	131	159	207	179	105	122	166	140	174	149	138	93	123	168	176	123	145	104	80	164	285	97	184	167	175	208	153	149	128	127	124	183	129	147	195	111	154	187	179	169	142	133	180	140	168	158	178	174	129	156	87	122	99	120	140	200	177	100	140	113	131	250	150	196	128	170	142	163	222	79	134	148	142	159	130	143	149	136	216	106	140	190	95	121	196	162	83	146	99	203	149	128	146	172	229	127	153	81	95	130	119	112	176	177	51	192	127	96	153	139	117	108	145	139	116	136	136	164	161	129	120	162	196	177	105	153	123	161	105	135	113	123	148	216	141	117	98	156	158	127	108	156	146	108	131	190	177	122	123	139	108	170	103	152	121	86	116	146	139	143	132	154	87	129	160	127	123	124	190	78	75	110	133	97	110	140	149	70	114	173	86	87	99	101	124	83	148	112	102	139	141	132	164	94	101	103	159	111	97	176	105	69	106	140	81	121	127	120	110	177	133	95	124	104	107	77	95	100	91	159	142	69	127	103	115	100	116	109	152	84	104	133	129	104	85	95	157	64	102	103	101	97	88	147	123	74	174	155	103	106	76	97	124	135	119	174	155	84	72	180	78	113	103	140	122	78	134	90	108	91	153	88	96	89	131	82	147	105	88	103	78	118	101	136	53	100	100	95	77	80	117	89	139	199	78	77	77	81	74	118	137	130	65	86	57	93	114	111	61	126	69	147	95	117	68	95	136	87	151	194	79	126	73	129	80	120	160	64	91	81	120	107	102	93	77	76	68	75	95	127	79	89	129	87	86	109	101	64	104	103	105	86	57	112	95	83	81	64	78	122	95	64	84	77	114	60	107	86	70	84	83	78	79	126	134	70	89	120	108	79	110	108	77	52	100	84	138	66	64	102	63	74	103	67	130	127	83	89	149	67	90	96	127	92	51	57	76	81	71	62	84	79	62	102	120	89	138	95	99	78	70	103	100	83	81	51	59	91	64	54	83	31	143	65	88	91	112	96	57	63	127	70	44	79	101	87	73	92	88	85	81	101	110	105	104	85	89	71	68	103	58	64	65	108	36	56	122	175	92	77	142	50	61	44	53	117	69	52	54	90	74	65	108	83	82	55	75	111	56	64	66	95	111	77	170	47	62	50	69	106	83	84	98	97	89	131	44	71	61	63	88	58	93	59	101	51	49	72	38	87	49	63	49	81	96	68	58	97	136	71	49	50	94	52	66	92	63	61	132	55	98	75	78	71	105	67	60	70	44	44	101	69	71	85	62	52	92	48	60	104	72	58	62	64	75	66	70	88	86	76	61	60	47	64	54	54	66	39	97	96	57	40	60	55	155	133	74	60	36	89	170	77	77	82	52	62	103	31	55	55	59	37	115	68	34	52	71	45	61	54	47	53	51	32	66	54	36	80	92	31	43	45	54	36	79	94	77	79	58	83	91	33	58	46	57	44	58	67	66	100	46	51	72	50	32	85	32	63	29	39	50	46	69	34	65	35	61	69	45	65	82	37	66	31	21	54	55	67	40	38	55	39	35	33	45	45	71	37	58	92	82	25	45	57	54	33	71	39	40	43	53	52	66	80	51	48	21	52	72	40	74	44	46	90	61	39	46	66	47	59	62	50	50	28	28	26	34	61	30	37	35	50	66	37	48	52	57	38	19	32	39	27	73	32	49	28	89	64	48	33	21	37	39	46	74	39	40	26	43	75	69	35	23	20	60	34	40	26	39	29	28	37	34	62	73	34	141	52	50	73	47	16	31	53	35	29	55	59	21	35	52	59	56	59	74	46	28	46	32	66	33	36	28	27	15	35	56	51	19	17	34	59	31	24	39	33	36	31	62	30	32	29	33	38	13	14	32	40	19	20	29	34	22	18	40	10	36	33	15	69	38	22	34	28	20	24	29	34	23	38	10	29	25	28	23	19	49	24	25	26	38	20	32	21	35	41	29	25	19	21	36	26	25	37	49	69	19	35	43	26	12	27	18	29	17	17	52	21	35	16	36	23	35	31	20	22	36	50	17	13	52	17	17	22	20	15	36	20	33	18	14	22	24	28	14	30	36	17	22	22	20	13	13	14	26	17	19	22	15	61	58	11	25	5	12	14	8	12	21	24	28	9	14	9	18	45	22	19	20	15	8	13	22	9	41	34	23	10	24	27	45	11	13	15	20	8	5	13	11	28	13	17	17	35	8	33	11	12	24	20	19	36	35	6	18	28	36	8	16	26	12	9	9	7	12	10	40	14	13	2	9	25	22	42	15	13	6	4	10	13	24	11	13	11	16	5	6	9	18	7	6	26	0	11	1	9	12	7	11	28	3	10	5	10	7	15	4	20	5	2	9	5	14	9	10	7	8	3	5	4	25	9	25	8	8	4	6	5	4	6	3	8	6	6	16	9	9	22	8	5	13	8	3	9	1	8	10	3	15	1	6	1	1	2	4	2	2	3	3	7	3	4	1	0	1	4	1	0	0	1	0	1	2	0	14	1	0	1	10	0	1	0
ne0254	2772	3619	2198	2574	2586	1485	1513	1191	1534	832	1992	1026	921	919	1483	993	799	1643	881	864	1135	1004	1020	885	1071	1105	1138	893	1110	1061	1325	846	915	668	892	1170	913	1185	1144	1300	824	882	1623	667	905	628	565	666	500	901	622	863	857	598	656	669	1221	923	702	923	594	856	996	1125	902	650	528	782	782	877	697	714	861	640	970	1142	564	817	633	1151	672	796	404	912	1040	519	761	805	657	579	528	632	298	622	930	751	432	705	585	629	566	565	733	360	635	657	480	385	833	471	644	494	341	277	365	497	381	446	834	344	643	342	708	472	595	517	544	1191	378	410	703	406	570	568	653	751	1540	564	360	413	569	382	575	461	615	473	486	632	635	363	586	574	378	423	569	961	336	797	285	370	580	661	631	536	419	511	430	477	748	474	496	631	608	494	278	558	439	254	584	617	445	540	795	377	762	763	867	426	461	510	561	306	992	567	555	314	526	232	387	392	448	874	971	506	774	316	542	409	313	458	256	524	965	260	317	552	588	515	328	507	480	494	479	277	490	388	440	469	438	474	571	295	951	765	376	348	744	545	531	540	346	324	342	379	671	343	266	413	648	311	377	462	359	710	362	188	441	419	479	1052	391	350	586	270	444	281	315	526	494	438	429	323	318	409	402	416	729	263	442	458	611	322	272	633	451	680	320	462	348	294	389	294	466	434	377	526	361	301	265	304	487	413	474	302	266	328	461	335	269	422	406	349	441	362	456	432	276	358	329	376	295	313	416	411	279	318	271	477	333	551	415	163	222	415	317	216	317	367	237	292	312	209	284	332	191	387	207	368	450	533	317	343	323	238	378	220	364	585	579	441	335	334	257	391	331	412	322	396	421	218	570	460	242	306	352	467	232	344	267	276	192	424	271	184	322	233	374	331	211	367	390	458	371	378	279	283	309	378	494	281	372	247	189	292	186	366	439	348	201	318	331	377	280	217	543	271	312	316	296	233	255	449	189	324	182	167	247	190	357	301	309	299	375	278	295	174	259	435	276	264	248	312	412	329	257	209	335	279	216	175	254	364	264	286	309	291	191	352	235	245	204	231	355	224	310	166	253	185	324	489	319	162	196	242	520	288	256	308	334	407	289	226	208	410	172	293	204	203	134	202	405	264	308	317	356	231	295	338	246	151	221	271	272	270	112	274	477	248	161	133	259	166	303	289	226	207	218	306	249	217	261	359	285	171	257	185	315	143	272	176	215	172	213	214	294	274	295	202	276	341	240	316	265	327	431	763	496	204	147	192	316	504	226	270	232	271	193	207	186	216	341	264	196	312	292	201	221	188	216	271	258	182	333	186	235	96	248	141	231	126	195	187	254	241	239	245	230	201	183	127	219	270	177	247	175	257	140	222	62	214	157	272	260	155	214	158	216	261	297	367	190	204	276	294	230	300	208	153	169	210	221	194	209	384	182	253	204	160	214	266	160	154	210	175	292	243	206	137	288	354	217	178	210	219	340	261	162	152	220	181	279	388	176	202	183	173	249	183	154	347	132	192	189	175	212	138	196	215	186	325	238	390	146	81	142	237	263	258	257	135	253	250	165	265	160	110	242	181	141	336	211	136	311	233	248	208	124	142	87	183	208	173	134	102	179	266	148	134	133	149	224	161	206	140	274	221	158	192	171	91	111	144	180	236	221	230	95	139	136	172	134	213	159	137	297	296	195	180	100	432	115	188	142	102	77	130	381	156	229	222	172	153	230	345	212	116	133	185	171	166	263	117	112	149	217	225	443	81	156	178	199	209	75	125	93	187	159	73	146	165	80	155	158	172	139	172	135	147	185	183	126	135	192	233	143	103	163	109	146	110	86	216	435	162	144	207	111	157	108	124	156	125	86	262	121	97	184	115	122	155	145	129	179	67	95	117	119	101	234	102	136	212	104	284	135	116	117	187	156	120	150	252	51	154	138	81	93	223	185	173	183	185	104	86	181	139	153	132	151	175	167	148	81	195	149	243	150	186	275	123	97	177	116	43	113	180	140	146	175	154	103	77	182	116	135	94	100	144	137	126	166	173	155	162	126	72	51	123	92	78	103	101	191	68	115	278	89	107	136	205	75	70	170	148	132	108	239	91	94	164	94	78	120	155	137	192	122	32	133	181	241	108	164	185	140	96	109	62	146	106	254	66	89	103	60	113	147	52	154	97	138	92	117	129	171	141	101	110	126	210	32	107	155	83	93	121	121	138	143	42	192	86	101	65	148	210	89	105	96	89	98	125	141	194	91	131	78	107	146	110	131	71	183	136	268	130	154	95	97	82	202	88	102	75	93	172	83	147	152	130	104	54	145	128	43	116	206	101	110	84	68	124	74	222	89	111	118	117	78	120	122	118	82	91	76	143	65	108	73	108	87	98	90	67	206	198	61	186	77	137	105	80	64	52	88	236	124	201	109	116	68	84	50	43	67	48	68	116	123	85	167	102	192	72	217	141	70	113	73	221	147	29	185	84	53	117	195	68	48	409	85	129	158	80	67	96	324	134	102	99	127	63	56	118	171	151	75	160	132	49	222	72	163	59	75	113	72	34	102	110	107	150	104	42	134	65	114	44	159	35	27	113	83	87	120	73	87	106	52	72	134	98	78	93	129	56	97	116	103	146	45	93	166	103	70	54	130	26	178	55	65	100	244	118	65	128	102	49	110	76	220	132	156	60	153	161	65	78	171	139	50	72	84	72	40	156	103	51	434	110	45	103	115	73	77	41	118	42	74	59	70	75	160	102	67	165	85	115	179	126	54	43	188	56	75	63	73	136	89	63	99	61	44	109	97	168	128	43	138	84	71	135	58	51	45	60	67	60	182	48	137	165	69	77	64	115	100	66	88	102	63	137	34	52	73	117	105	39	145	68	43	83	142	75	31	62	93	57	81	82	94	55	49	94	44	65	98	75	75	82	123	128	138	140	52	57	59	110	58	65	68	38	47	59	94	110	37	36	82	83	52	52	78	39	147	82	55	73	76	72	73	32	154	104	82	136	97	146	107	56	64	66	54	61	114	87	60	20	38	40	83	40	79	34	65	68	179	65	82	58	33	83	41	40	69	90	143	109	73	73	54	45	60	114	43	121	121	55	72	25	17	48	60	80	37	91	71	45	103	83	32	52	52	103	39	52	52	41	75	31	64	72	46	47	62	42	67	32	89	21	35	145	108	117	17	40	79	41	34	28	20	39	58	121	66	35	128	39	52	31	64	31	39	43	59	51	49	27	69	41	29	75	97	50	61	321	86	55	20	24	104	18	60	86	83	84	100	34	44	46	48	15	144	92	54	70	25	38	11	49	12	75	65	16	50	43	19	44	69	57	73	40	73	103	17	28	29	23	57	51	93	34	31	44	22	11	50	34	70	101	57	39	36	57	31	65	47	25	24	64	71	62	76	379	48	31	79	38	42	65	38	42	30	86	31	39	24	37	44	67	34	22	43	67	86	36	57	23	46	21	60	21	46	35	43	9	45	58	21	44	36	27	80	114	39	106	54	19	40	90	10	34	28	26	15	30	69	38	43	14	108	44	53	26	49	19	41	39	39	46	29	14	14	35	34	52	28	23	50	39	53	10	60	37	41	28	59	40	20	30	199	74	53	62	25	25	76	6	71	25	103	156	46	17	43	12	17	37	49	20	41	84	76	36	38	11	58	17	44	44	37	30	11	18	12	82	27	14	19	48	27	18	21	12	36	25	29	10	31	75	67	36	71	52	31	18	9	17	6	6	28	13	4	37	8	10	38	73	12	1	50	33	39	29	30	28	67	20	46	5	20	20	29	24	29	14	25	34	13	34	58	18	43	31	4	15	20	12	35	43	30	8	19	15	6	19	6	21	15	16	9	6	23	37	16	35	38	100	13	86	35	14	17	23	45	20	4	6	12	18	14	24	6	10	11	11	29	4	19	30	70	6	4	4	10	12	22	6	7	15	12	13	18	7	28	0	17	34	2	18	10	13	8	12	9	33	13	11	2	14	7	8	8	11	5	11	4	26	9	4	19	16	16	23	10	23	37	7	52	3	7	6	16	17	13	48	7	10	41	9	2	5	25	19	7	2	9	4	14	12	4	3	11	23	0	12	5	3	5	14	6	0	18	8	3	12	5	3	3	3	3	1	5	0	1	2	2	0	15	4	18	5	0	1	5	0	0	0
ne0255	2631	3219	2301	2309	1990	1214	1694	1081	1335	954	1343	886	805	814	1165	779	701	1202	828	855	1070	982	908	993	1001	1062	1111	785	1107	890	1000	1050	843	560	1011	994	856	892	972	758	704	790	872	596	733	412	523	630	496	785	405	744	671	701	533	537	811	795	733	766	419	752	778	814	690	661	419	872	724	704	819	564	686	803	1010	751	877	637	689	704	636	729	279	585	608	432	551	703	382	600	558	570	227	513	922	642	364	875	637	575	562	426	605	279	644	535	575	281	431	366	513	456	242	202	238	434	293	347	834	239	551	269	665	508	462	626	479	575	277	290	523	474	611	515	517	651	594	598	254	516	503	317	556	485	507	519	570	671	450	443	503	590	415	469	418	564	310	506	150	566	514	496	550	496	390	434	513	494	804	383	493	587	456	370	196	550	453	158	475	471	912	304	365	386	357	1042	473	325	447	468	467	367	600	471	524	322	470	148	475	320	375	368	499	403	668	370	529	316	316	365	161	485	430	287	321	523	357	441	304	521	383	456	384	335	480	514	468	493	381	393	354	379	486	521	426	420	367	419	417	471	486	422	350	326	639	302	270	452	385	202	428	315	330	511	347	105	451	362	428	488	388	365	439	306	729	348	269	336	446	460	472	432	273	444	350	388	341	279	389	522	486	361	253	462	576	607	261	391	312	283	332	314	368	276	213	308	433	317	250	385	360	403	386	262	270	288	547	372	263	705	587	449	371	262	325	334	287	324	386	353	449	295	431	278	248	260	276	361	276	410	326	181	215	250	350	245	364	381	215	260	261	268	297	374	195	330	217	356	312	453	379	304	298	290	443	216	626	398	253	297	367	263	161	297	310	280	291	338	294	238	290	506	219	294	302	408	242	272	311	298	287	296	337	176	248	280	334	266	244	319	312	249	258	393	276	300	332	228	580	241	350	197	170	274	231	262	284	211	185	267	289	341	233	190	417	239	243	291	278	165	225	628	162	296	230	279	226	277	332	216	276	330	301	296	228	187	244	349	316	364	227	239	210	290	201	276	224	287	338	182	262	318	187	306	234	272	214	290	225	190	217	157	343	160	230	185	312	261	246	219	282	178	148	278	162	203	308	279	219	290	298	222	192	311	171	273	351	242	102	192	339	257	311	219	205	303	339	243	274	123	225	253	191	150	97	242	207	173	160	169	233	188	262	226	277	210	272	223	193	199	275	203	223	146	225	250	225	105	309	157	147	162	205	268	131	204	194	157	286	243	285	160	237	237	321	341	169	138	219	161	203	208	206	246	261	282	205	205	155	337	226	229	141	247	218	246	256	199	221	219	316	198	150	211	253	180	238	205	261	129	192	142	224	163	189	280	207	210	173	114	237	196	238	301	238	175	189	171	92	216	193	182	219	212	259	182	217	129	160	112	169	161	193	406	198	168	166	200	163	189	217	185	187	156	166	173	198	136	218	192	208	190	197	192	183	209	458	184	243	236	184	51	242	150	176	197	171	125	195	242	206	187	174	221	268	126	154	118	131	260	120	179	266	167	154	160	187	185	298	214	209	204	187	86	144	204	204	260	219	152	153	181	145	245	285	222	250	307	160	262	214	107	188	197	309	194	114	183	68	122	182	113	167	102	134	189	194	134	125	107	113	220	144	151	167	145	140	149	97	150	112	154	157	193	154	132	94	136	192	187	98	120	76	198	195	175	215	147	147	129	139	157	114	101	102	164	221	131	98	167	229	207	156	165	122	129	152	117	188	324	182	113	112	136	210	243	178	112	86	137	156	177	101	186	107	169	113	73	116	187	149	136	100	147	131	128	99	137	142	198	169	144	102	164	118	48	149	115	170	130	112	110	97	74	137	145	144	176	154	114	171	189	106	243	128	97	172	204	212	174	160	112	182	135	101	132	112	61	113	169	182	176	173	117	121	115	140	148	123	148	135	150	65	128	141	132	342	129	216	107	175	177	113	128	136	135	141	103	150	128	131	121	39	171	132	114	91	154	123	85	142	146	68	119	43	147	116	129	101	127	127	82	110	167	80	117	131	127	210	128	155	164	134	109	189	104	38	97	120	77	89	73	205	59	131	124	71	126	101	138	137	87	115	128	80	117	97	128	88	74	70	193	172	60	102	137	91	49	112	116	93	110	125	143	80	93	126	63	156	87	178	116	121	109	82	100	101	43	108	57	106	117	91	141	138	73	319	64	164	101	100	120	130	59	141	90	119	80	79	67	100	213	122	104	109	91	78	101	91	67	80	164	58	97	99	171	83	252	160	103	88	83	121	195	142	129	101	98	122	47	138	77	181	100	95	114	65	94	151	115	131	94	97	84	41	84	128	85	119	87	36	82	90	121	78	92	194	148	64	111	79	103	114	115	68	117	73	134	62	148	93	127	104	36	270	172	57	136	66	96	45	87	90	60	79	72	81	84	152	92	63	92	44	84	57	56	32	170	80	130	143	79	98	109	106	75	123	100	104	65	161	77	112	69	59	121	77	102	71	130	70	46	116	73	74	92	91	121	147	182	140	76	44	100	108	86	64	88	85	44	79	82	139	60	74	69	77	77	93	43	94	115	88	68	139	72	104	60	138	30	80	77	155	93	71	123	74	60	50	93	77	56	189	126	89	70	72	118	107	173	57	65	75	85	60	68	90	20	82	84	79	69	118	49	137	70	153	58	57	111	110	73	145	70	151	53	77	90	81	80	83	60	87	105	52	238	106	56	42	108	35	60	79	81	75	58	82	47	82	46	77	83	65	56	44	86	44	75	167	57	66	91	96	55	136	62	16	123	80	81	64	51	81	102	237	72	61	115	105	51	89	106	36	94	82	67	72	31	89	37	65	74	41	63	104	101	63	61	103	199	69	67	49	83	164	73	57	56	71	45	38	52	71	42	56	141	126	77	74	92	50	54	58	48	43	52	76	53	77	58	74	48	56	69	51	82	41	61	30	74	52	31	48	73	93	41	82	36	50	111	41	64	87	51	86	148	43	70	68	54	44	41	91	88	54	94	94	151	69	47	78	53	45	63	45	61	37	21	30	58	107	51	49	52	124	58	24	72	87	44	44	46	201	54	28	43	101	58	25	48	63	42	60	70	56	47	107	87	52	25	19	57	37	110	55	87	61	54	50	48	41	97	57	62	28	45	50	43	65	36	60	39	63	36	53	33	63	84	51	92	32	49	62	76	40	43	105	41	40	26	10	36	47	34	54	62	55	49	49	22	49	44	53	53	51	58	35	59	38	31	34	52	23	47	71	42	20	19	40	16	44	61	51	57	38	42	65	32	21	23	42	92	45	122	32	59	18	27	85	34	231	54	41	13	20	58	42	34	37	51	104	33	25	42	27	51	22	45	49	46	88	35	23	45	26	14	83	16	45	18	42	40	17	33	21	39	31	46	33	40	33	46	92	30	16	25	46	56	100	31	32	43	25	38	36	37	26	17	28	33	19	19	75	34	25	53	33	26	20	14	19	86	32	35	18	4	21	31	30	20	32	15	45	39	109	30	34	21	35	42	10	29	47	22	32	86	48	45	13	27	12	4	24	36	13	24	45	21	32	57	50	27	37	55	62	32	17	36	68	37	49	10	53	20	15	23	31	27	14	38	12	37	98	28	17	22	28	14	76	28	47	42	57	24	32	14	10	18	97	30	75	17	80	28	36	18	7	19	25	43	28	37	13	26	21	8	25	16	99	25	23	14	28	25	25	17	10	11	44	17	101	38	55	23	10	28	20	27	8	14	21	19	14	14	13	27	61	8	17	2	12	41	34	12	13	32	15	6	8	15	8	2	15	21	23	25	14	5	15	17	23	9	41	52	13	1	9	16	32	31	73	10	8	14	14	13	3	23	9	19	7	10	25	24	14	12	22	14	12	19	8	16	10	20	12	10	9	8	11	16	9	13	68	7	17	8	9	89	11	16	7	9	16	16	13	25	8	12	7	5	6	4	28	5	6	7	1	15	7	20	12	10	12	25	12	229	6	185	13	18	6	8	12	9	1	1	3	19	7	7	13	25	2	145	5	11	39	20	272	1	5	19	80	7	13	0	2	7	17	12	1	6	32	6	6	4	11	4	11	9	4	4	2	5	25	10	3	2	4	2	4	2	15	138	4	185	9	1	3	1	0	1	2	0	2	1	3	0	3	1	3	0	1	0	9	2	0	0
ne0256	4118	4391	2993	2728	2864	1732	2204	1412	1883	1195	1484	1316	1435	1252	1549	1212	1392	1242	1283	1171	1288	1237	1455	1287	1218	1364	1151	1051	1426	1379	1082	1300	1007	844	1336	1225	1310	928	1082	975	932	937	1273	821	1103	800	799	994	1099	936	760	859	1110	1412	1143	885	747	924	984	1050	639	994	800	929	796	833	777	963	808	808	1160	740	885	870	805	660	904	735	823	890	759	750	678	952	661	717	596	719	631	764	910	731	559	719	872	768	626	724	770	593	709	710	814	609	721	651	670	528	921	819	738	624	581	478	486	880	566	771	631	476	789	488	767	720	616	754	618	653	564	525	646	584	596	604	680	613	829	669	458	636	675	584	798	658	602	619	588	541	570	658	563	569	509	691	640	636	515	537	444	605	623	645	579	659	568	567	741	731	527	721	760	612	568	554	403	813	551	380	721	541	835	594	721	489	1128	496	1038	585	562	503	740	524	1090	531	560	498	733	427	599	511	416	564	591	512	686	470	605	506	484	504	390	616	604	382	461	767	481	493	538	532	386	631	431	457	622	734	604	533	425	393	457	482	597	555	474	676	469	496	485	552	567	665	386	954	456	355	401	418	472	482	502	564	406	532	499	338	495	530	554	591	507	430	445	443	305	629	387	403	545	477	589	582	379	479	394	485	462	390	629	454	555	430	389	454	340	724	356	441	374	379	366	396	488	369	1187	497	531	426	381	485	478	457	440	318	399	531	554	410	447	388	354	458	442	467	448	382	388	574	439	490	363	313	444	387	439	551	354	358	417	303	405	342	284	398	341	369	447	357	304	316	392	384	402	463	345	461	343	378	334	482	354	291	318	380	401	282	498	402	401	430	325	689	527	374	459	312	308	472	559	359	451	192	244	279	400	631	316	325	308	323	745	309	376	318	303	324	246	319	328	365	376	1165	456	647	341	276	272	262	504	357	357	295	467	358	322	333	336	393	298	282	301	279	324	346	418	340	263	318	299	286	290	261	235	351	354	172	269	333	384	306	359	432	352	293	223	230	267	276	220	341	308	233	277	321	338	263	322	406	401	309	325	334	221	355	282	366	310	311	338	287	264	282	273	296	293	259	307	298	258	398	1242	278	219	364	532	258	386	250	280	458	303	247	219	358	232	351	327	371	247	269	268	284	181	253	322	306	351	280	266	241	223	214	224	451	221	269	309	223	289	273	258	244	285	234	316	248	273	413	263	264	271	287	227	480	265	437	211	237	334	188	304	387	226	234	435	231	236	293	333	242	218	231	208	265	255	384	412	163	208	203	365	287	293	229	260	296	193	195	322	305	241	227	223	293	311	242	276	231	175	246	240	292	276	197	286	263	348	222	343	199	218	275	317	177	267	314	276	206	174	171	197	278	375	194	168	369	213	180	194	221	203	174	179	297	282	148	251	175	209	1560	219	195	229	157	198	247	226	237	153	199	375	185	239	208	401	254	269	199	197	277	153	326	223	284	209	188	165	266	200	192	274	331	319	180	269	169	212	324	203	193	273	225	150	211	225	227	192	229	355	159	154	187	154	195	182	268	178	322	376	244	113	193	192	200	133	190	243	222	230	197	349	196	152	203	189	247	313	100	121	115	197	187	194	171	228	175	147	208	136	207	152	161	178	284	170	186	260	213	156	178	159	231	206	136	227	225	205	135	231	289	164	166	156	145	121	250	199	167	220	169	160	147	177	188	182	177	222	144	180	225	134	122	165	168	179	160	246	177	167	279	280	206	180	268	217	142	156	182	231	158	239	115	153	165	163	177	231	218	130	138	220	285	210	137	143	180	181	109	154	141	144	177	150	172	100	104	172	194	113	135	149	185	118	145	157	137	238	139	151	171	138	149	162	186	184	157	170	258	140	155	173	185	123	154	243	135	139	174	219	148	170	170	155	118	143	142	155	132	176	236	77	177	173	265	163	132	99	143	129	161	139	193	157	158	182	94	297	180	194	132	122	210	148	167	91	155	162	101	127	115	130	147	104	193	192	141	77	164	198	164	151	126	250	131	105	195	130	125	108	158	204	117	199	191	90	136	133	138	154	161	142	111	95	164	223	141	98	122	105	115	89	147	168	75	164	108	139	207	104	153	110	84	135	122	99	156	124	103	136	125	127	117	181	100	206	223	130	104	126	126	240	149	173	118	119	192	145	103	113	134	86	120	74	119	139	149	147	97	129	120	142	101	103	115	121	85	226	212	252	120	105	139	137	116	118	139	104	122	86	90	159	69	112	126	166	90	132	91	129	184	113	206	168	118	75	146	95	76	214	122	197	100	101	89	174	131	123	113	102	85	83	98	67	93	78	139	120	114	72	140	109	92	85	124	48	125	140	119	127	122	128	131	118	71	69	146	176	187	112	101	84	80	127	86	67	122	118	112	86	150	117	77	135	367	113	80	96	156	100	143	91	180	111	82	122	70	58	64	78	129	85	156	81	84	51	91	113	56	146	76	134	113	250	53	133	103	117	69	95	153	62	122	138	65	106	105	181	156	87	79	84	66	114	62	85	118	164	127	109	75	125	87	113	112	107	100	189	97	127	56	174	64	93	108	49	66	71	73	53	139	119	140	99	91	106	99	74	128	96	80	67	84	84	92	115	69	75	75	92	97	85	104	95	209	95	186	99	91	86	77	73	128	136	48	48	80	145	44	99	88	70	67	113	57	95	77	110	69	61	68	104	65	77	56	83	71	60	77	59	63	68	71	92	164	66	43	185	145	70	77	58	241	71	86	75	89	122	43	151	68	69	92	62	60	64	105	76	73	89	75	143	76	53	68	100	51	69	122	72	87	108	44	78	99	67	92	66	59	53	87	83	140	37	87	68	64	69	66	116	400	69	89	57	77	51	86	84	64	66	135	95	65	66	75	48	78	71	72	58	113	99	76	82	61	63	99	92	69	99	101	68	59	86	39	75	45	51	65	69	61	63	43	89	65	64	196	66	66	76	76	77	109	73	424	75	78	75	59	49	94	79	39	41	65	54	34	60	54	119	66	45	52	82	63	70	113	70	52	75	65	52	54	64	76	84	63	192	45	198	44	81	67	81	50	43	50	33	41	49	39	374	77	37	57	62	68	82	50	120	52	34	55	64	69	68	54	197	28	81	49	48	52	54	95	50	97	71	60	54	42	90	125	43	83	50	42	59	54	42	39	67	62	62	56	42	54	68	33	54	55	66	58	81	78	24	59	86	47	31	65	48	44	42	37	69	86	65	50	45	73	46	43	42	53	62	64	66	28	58	52	68	47	137	54	87	239	113	147	32	118	43	49	30	37	35	37	67	31	155	91	85	23	57	64	50	31	32	27	302	45	124	59	25	32	29	44	48	90	36	61	32	58	138	114	32	38	44	26	54	63	97	29	41	25	72	84	30	44	42	97	76	59	46	44	40	26	46	69	48	43	80	64	70	123	55	30	49	31	52	27	43	29	51	35	26	26	26	82	48	45	91	36	65	75	35	46	38	27	32	30	33	29	31	46	60	22	21	69	55	37	42	50	24	53	24	172	76	26	45	58	30	12	77	37	20	38	18	35	62	18	50	28	46	40	32	38	35	19	31	39	43	53	46	60	33	50	29	23	26	38	30	33	49	11	38	18	35	15	27	34	28	46	21	23	49	18	23	22	31	31	77	36	40	46	23	88	14	39	40	17	26	21	53	29	41	41	110	13	16	35	22	18	20	15	22	82	24	23	24	16	26	24	22	23	25	20	28	36	32	34	25	86	18	8	27	14	35	13	10	26	30	26	15	9	27	25	14	72	11	12	18	26	21	20	19	14	24	18	22	13	21	18	8	19	23	22	17	93	25	22	43	53	35	19	17	44	31	21	22	24	13	23	11	21	7	25	23	30	31	16	11	24	7	33	19	43	9	93	73	17	4	13	20	33	10	37	8	14	18	25	25	15	31	9	21	6	12	5	26	33	20	18	8	8	8	12	8	18	43	4	10	6	14	2	16	12	10	15	31	48	9	11	22	11	2	4	3	12	21	9	6	19	10	12	1	2	11	11	12	12	22	6	7	3	42	13	18	51	5	89	7	9	4	3	4	11	6	1	23	12	18	8	18	17	2	8	9	10	5	3	4	11	12	2	29	2	3	3	13	2	1	3	1	4	5	5	1	6	5	5	4	1	7	0	14	2	0	0	14	0	24	2	10	0	3	0	3	0
ne0257	3792	4266	2792	2901	2404	1904	2247	1576	1682	1317	1373	1214	1463	1360	1858	1294	1494	1284	1276	1362	1433	1228	1211	1331	1139	1225	1134	1161	1530	1391	1075	1401	1060	864	1357	1246	1110	922	1004	1225	932	989	1183	797	1079	882	863	946	987	978	769	903	982	1032	871	807	752	1002	905	1024	693	1031	728	1083	891	820	639	893	891	858	931	755	908	923	743	710	927	760	873	838	725	865	623	941	619	693	734	767	635	731	862	819	555	818	746	663	640	817	807	829	847	738	811	548	661	682	979	540	784	545	746	587	545	493	519	785	599	579	846	500	697	501	699	803	529	746	679	687	573	537	615	591	765	610	703	509	851	663	498	601	638	527	718	603	551	641	540	595	560	644	538	649	590	686	565	608	523	567	405	566	574	580	560	707	584	517	597	737	567	667	725	585	555	656	440	747	589	410	551	596	872	495	689	512	687	701	719	507	527	425	693	524	931	533	539	486	576	404	636	488	496	665	705	498	684	463	580	554	493	485	419	538	634	408	490	705	476	592	491	552	384	686	492	429	707	671	544	560	538	478	515	429	527	759	445	613	345	466	501	535	555	393	478	946	449	471	444	440	521	411	447	542	387	478	415	328	583	539	580	501	499	387	471	437	385	473	377	365	501	589	621	518	378	444	460	435	429	403	506	362	441	393	397	490	358	521	427	512	414	301	388	406	395	470	681	584	485	486	428	493	407	492	363	341	348	323	436	430	453	371	313	422	389	358	393	367	345	382	573	423	432	406	441	428	321	523	323	377	384	377	441	309	296	376	350	333	350	430	338	359	362	326	398	393	298	465	299	454	321	458	343	307	324	309	403	330	441	469	302	364	343	406	330	350	389	440	298	382	448	307	445	243	278	326	351	415	343	461	306	339	482	385	408	299	365	330	305	323	300	295	410	558	391	508	432	275	294	340	498	422	339	548	321	353	297	446	363	246	311	309	298	305	327	324	462	405	309	335	385	299	301	354	217	415	296	357	260	327	372	332	439	356	320	318	209	265	352	374	278	333	309	332	328	358	301	287	263	368	393	340	314	458	212	309	292	287	297	300	312	280	238	498	340	206	299	258	265	263	246	430	544	244	222	351	441	261	277	246	309	444	305	316	267	373	234	381	353	358	263	314	285	298	261	312	273	298	432	317	266	205	271	248	262	269	250	307	314	283	283	239	254	223	234	265	302	243	281	246	244	211	285	276	218	289	242	355	228	244	330	234	269	307	217	264	316	260	271	234	250	351	244	392	220	258	313	313	318	243	301	158	285	281	259	298	290	305	188	193	268	297	230	293	200	217	223	249	323	216	248	195	283	291	238	237	300	247	499	305	270	203	252	243	238	189	222	254	353	266	275	163	197	306	319	199	188	216	198	226	145	199	235	216	212	298	270	221	230	132	180	494	191	216	237	212	217	195	250	226	130	214	282	154	219	274	347	184	214	215	207	289	176	197	225	292	215	254	246	319	192	203	291	217	266	163	196	168	218	258	182	187	253	217	208	222	218	210	178	220	213	224	144	185	152	176	196	199	205	263	282	235	161	172	232	166	133	219	197	239	266	192	201	206	162	203	217	205	237	184	204	126	192	180	229	202	326	180	147	218	128	133	181	129	153	253	185	223	225	215	145	185	135	229	236	189	192	238	228	129	181	236	150	134	223	178	188	230	181	163	207	143	159	129	153	166	237	133	182	268	156	211	183	155	134	166	140	174	330	127	166	234	170	197	182	223	154	135	193	175	230	169	251	120	176	178	141	129	163	207	276	162	203	162	158	199	181	164	170	101	320	121	161	271	165	175	153	145	245	224	127	349	143	196	198	123	172	123	173	152	132	175	124	157	167	116	204	176	136	205	155	152	144	175	174	166	142	138	117	214	178	159	142	156	175	110	141	178	177	91	163	186	196	158	143	199	146	118	92	157	128	212	135	205	140	163	149	112	183	208	186	98	123	313	137	138	107	171	153	148	130	134	141	165	98	161	225	124	107	151	158	144	141	161	414	118	111	141	143	153	118	165	181	135	168	284	116	85	118	134	233	114	179	107	116	154	186	113	69	97	127	92	108	123	153	94	130	114	160	135	158	180	123	112	157	163	149	145	131	123	137	123	139	130	209	101	147	120	117	129	122	91	116	157	181	150	141	189	130	111	105	129	154	97	64	104	106	146	144	85	118	104	122	84	86	167	140	78	106	184	160	120	122	113	145	92	218	141	119	89	76	98	125	58	127	86	144	138	125	125	125	231	135	220	195	114	83	163	83	95	150	133	194	109	99	103	143	156	106	140	118	67	173	99	97	107	112	122	80	169	133	123	107	104	67	176	78	125	109	116	109	121	80	128	88	91	77	127	293	140	125	97	78	109	144	101	118	101	92	92	64	112	231	96	118	293	124	141	95	105	97	148	155	100	133	78	115	75	77	85	100	117	77	146	60	95	54	67	86	69	167	82	211	103	182	49	96	86	120	91	55	87	186	101	115	75	77	126	127	104	78	79	104	60	115	81	79	106	106	164	97	57	126	74	96	110	104	87	95	112	113	83	160	89	117	72	76	111	64	97	109	146	88	121	95	79	99	110	91	131	124	82	52	74	52	121	98	96	83	90	60	135	132	74	66	169	104	253	136	125	90	88	72	193	100	49	97	54	130	35	164	97	65	75	94	84	89	74	106	90	49	67	106	73	94	72	114	82	77	76	63	51	49	69	93	175	53	77	167	84	54	107	47	114	77	90	99	64	128	51	130	62	71	100	135	38	76	74	82	72	122	100	59	80	86	81	100	109	53	157	88	99	133	44	63	96	98	78	49	63	87	84	71	105	42	55	61	65	67	106	113	126	91	74	47	77	88	88	67	87	228	158	104	67	68	81	50	90	70	58	66	101	95	63	92	121	88	70	90	82	86	83	96	51	78	51	110	60	70	80	77	66	66	65	75	84	68	74	78	74	61	72	82	82	65	160	98	118	85	69	35	83	62	52	43	59	81	56	57	60	82	66	101	82	74	133	58	65	61	84	84	64	58	78	92	164	71	84	41	37	72	36	43	39	95	53	43	62	37	60	110	39	174	54	41	72	82	40	125	76	63	34	37	62	78	71	52	65	119	43	76	60	42	33	74	117	34	80	62	41	41	53	56	109	66	77	28	54	81	67	58	63	117	36	62	55	70	46	71	43	73	46	53	97	109	74	69	57	111	42	21	44	30	50	67	43	80	83	52	64	49	94	57	28	69	50	71	36	66	63	64	51	64	48	54	59	81	225	67	45	51	108	36	48	43	52	56	49	51	36	85	43	69	36	49	54	64	127	40	38	120	43	39	54	46	36	28	29	61	64	26	74	63	41	124	123	46	18	31	33	50	52	74	26	63	38	62	82	51	31	116	42	75	29	30	40	58	48	155	53	51	61	83	56	57	88	53	74	47	39	42	19	45	29	41	36	75	53	19	79	31	60	73	43	43	37	24	43	49	29	50	39	19	33	32	64	41	26	33	47	43	54	49	37	43	41	30	20	72	35	28	74	17	24	47	28	15	29	22	26	73	19	20	34	34	34	146	49	40	21	105	18	39	32	38	57	24	51	36	23	24	23	37	42	26	21	22	20	44	35	24	31	19	35	34	24	27	13	24	32	18	30	53	72	26	44	31	57	15	78	36	31	25	33	58	29	43	46	22	22	21	30	17	23	15	26	16	90	46	23	43	32	24	46	22	22	23	37	36	30	169	33	21	29	25	9	21	22	19	26	22	21	20	25	16	15	17	23	13	36	23	7	15	15	20	32	19	22	21	9	8	14	27	32	12	15	20	15	11	16	24	25	31	48	39	12	17	30	28	10	21	15	8	28	16	13	16	20	8	23	46	11	4	15	18	86	22	32	25	36	14	15	25	14	14	15	20	15	8	8	8	20	16	8	18	10	19	7	31	15	13	24	15	9	11	11	13	5	13	11	30	58	13	9	6	15	20	15	6	36	8	23	9	8	7	19	11	5	1	19	22	14	4	8	14	7	6	6	9	15	5	6	13	12	5	2	9	16	16	30	7	61	11	6	5	5	11	6	5	9	14	4	9	11	26	13	7	4	10	4	4	10	4	7	5	1	3	2	8	2	6	5	2	2	0	5	2	2	7	1	7	0	1	1	2	9	1	1	0	1	1	4	1	1	1	1	6	0	0	0
ne0258	3980	4482	2976	2688	2749	1993	2594	1658	1825	1306	1862	1387	1356	1359	1714	1537	1366	1407	1592	1325	1511	1344	1296	1695	1196	1382	1512	1078	1425	1301	1331	1445	1201	848	1260	1275	1258	1124	1088	1085	986	1120	1028	1074	1139	865	891	972	940	1115	837	1118	1101	899	1082	907	1175	1004	894	1173	763	1048	1065	1314	1003	837	716	1178	959	885	1064	1239	926	751	1056	1170	909	791	871	869	860	817	834	791	989	708	735	1000	745	793	989	829	545	635	902	994	669	1030	934	1059	776	865	908	478	855	851	750	544	633	806	700	677	549	468	525	778	621	651	669	489	816	547	730	757	601	778	621	856	602	558	835	725	661	726	603	739	723	769	507	704	695	451	766	691	623	654	731	659	558	650	663	739	589	713	548	557	481	764	394	804	612	638	740	622	558	637	602	731	546	866	749	633	700	635	449	714	663	393	544	618	700	538	794	531	767	615	721	531	555	559	705	585	684	663	615	697	611	380	565	526	493	592	667	503	660	488	548	514	487	504	400	647	478	486	619	707	456	656	474	746	705	757	567	464	634	805	576	578	484	406	595	452	659	643	402	630	543	657	697	569	615	395	508	604	612	504	402	457	413	366	513	501	483	572	520	327	523	543	554	604	687	499	570	498	564	603	398	396	498	520	693	568	387	474	529	438	537	385	427	464	547	472	530	359	526	396	434	609	536	297	497	497	618	407	449	454	726	421	414	479	496	703	450	336	387	399	564	461	389	578	497	504	569	408	411	403	345	523	569	459	499	395	445	462	338	609	286	509	469	510	402	263	369	452	442	364	428	431	395	412	354	368	382	357	269	409	339	434	486	569	420	322	424	358	495	295	535	629	400	427	455	400	506	486	386	346	390	455	477	311	400	481	327	335	388	407	279	471	380	320	394	411	354	236	297	333	351	442	282	377	360	355	367	496	434	327	306	286	315	447	367	369	239	391	309	439	402	316	285	383	394	352	312	258	479	321	293	400	361	267	332	366	260	346	350	309	285	401	399	295	543	445	337	333	288	233	306	383	214	357	377	375	346	344	287	292	324	394	417	351	311	428	467	351	364	385	285	338	204	332	250	264	325	259	335	259	427	485	303	348	296	286	263	369	330	286	379	443	328	277	269	406	272	360	197	321	446	403	437	218	325	274	290	304	376	369	390	329	270	236	370	315	242	445	417	337	363	231	320	315	361	290	310	337	341	282	289	286	195	288	317	366	342	337	260	325	293	162	341	260	249	235	297	335	285	298	353	233	279	309	237	291	345	276	357	272	315	335	278	254	319	246	307	269	282	311	222	240	247	325	321	297	179	277	323	233	275	237	240	228	346	247	290	283	304	482	372	307	317	226	316	223	282	186	232	433	352	231	248	182	256	316	433	324	251	260	224	179	197	251	211	257	236	256	288	219	315	239	238	272	263	223	315	222	241	304	250	237	216	316	215	275	257	211	284	212	263	163	216	308	206	216	256	289	260	305	375	266	221	248	241	107	343	218	244	180	242	207	298	257	279	306	247	246	270	210	210	383	236	270	164	210	262	208	221	238	204	251	435	233	326	236	226	361	200	346	216	234	336	199	262	180	159	255	320	212	249	187	206	297	224	191	240	201	163	197	170	234	129	241	200	164	192	213	146	236	267	198	117	165	205	240	225	180	201	222	261	186	135	241	140	201	172	273	195	216	163	166	212	226	138	170	184	295	242	255	352	196	158	225	157	183	232	140	122	182	284	208	155	233	167	212	158	239	190	145	188	198	246	209	268	135	217	217	224	181	157	181	152	147	320	238	205	188	259	202	139	220	156	159	232	207	165	167	149	204	221	236	117	278	155	189	118	259	196	97	150	135	188	160	154	160	188	138	237	167	152	283	120	157	235	150	122	263	175	161	165	246	281	228	250	225	157	126	171	189	147	124	195	195	193	188	189	154	233	123	143	152	167	165	146	190	320	193	152	225	167	175	163	160	195	192	153	219	146	176	178	180	226	175	246	221	83	161	137	211	153	191	205	164	190	178	138	160	131	201	144	163	142	123	159	152	158	219	117	183	154	232	126	144	184	111	135	186	201	139	62	128	151	101	95	161	207	96	133	162	123	132	175	171	129	107	188	183	130	111	234	107	137	92	161	177	196	93	105	176	119	70	141	140	123	111	148	182	112	137	180	78	129	134	141	159	102	163	173	151	186	94	183	104	154	113	144	163	156	82	96	150	135	143	133	143	152	84	120	148	139	154	155	146	160	61	131	102	131	132	93	91	166	157	101	177	228	142	101	162	92	136	228	141	194	133	136	150	218	184	175	139	172	60	195	125	97	137	114	151	121	128	134	185	116	104	127	143	96	121	165	120	123	110	66	127	124	147	83	124	236	214	114	97	89	125	131	73	109	128	81	184	93	177	112	101	147	97	159	108	81	134	79	120	76	117	106	83	100	118	107	82	134	143	72	133	139	94	80	84	68	156	130	87	166	127	271	93	171	94	120	103	78	78	141	102	116	109	102	122	142	146	77	142	113	84	138	76	107	100	170	151	86	83	110	118	96	110	149	113	74	127	135	89	95	75	118	104	87	83	82	99	121	95	113	131	126	87	173	69	136	77	131	64	63	94	132	115	115	139	99	88	98	131	105	112	98	218	128	180	116	100	82	163	55	123	107	114	42	54	124	42	76	98	109	99	157	101	131	92	159	108	68	67	132	108	68	101	144	77	110	92	110	121	87	80	124	64	62	64	120	97	102	106	65	89	119	114	121	77	111	78	89	68	94	128	93	70	97	86	75	116	132	144	81	107	89	75	85	85	80	64	118	74	110	57	125	131	175	100	106	63	117	87	90	135	54	106	81	114	65	106	160	69	113	110	58	90	46	83	169	92	74	78	80	78	86	118	57	122	86	77	109	109	80	72	97	80	87	127	107	109	116	108	91	98	89	69	91	62	67	83	130	85	109	70	81	89	73	99	70	132	95	83	65	66	47	85	92	76	115	85	69	125	93	56	98	63	95	50	53	67	68	69	78	93	64	86	69	110	111	67	105	84	71	82	74	67	70	62	58	42	48	78	59	97	88	66	66	48	55	86	59	68	60	78	47	83	54	64	112	75	66	53	98	65	52	73	66	47	74	51	82	52	45	75	52	58	70	109	84	84	86	82	40	98	49	80	48	92	91	62	55	83	71	87	61	41	47	46	66	121	74	44	38	41	70	116	53	71	75	53	38	55	33	53	62	51	78	67	72	73	52	45	68	58	60	40	54	63	71	77	42	27	71	76	39	57	63	82	48	33	40	75	71	62	49	37	65	61	69	45	37	40	73	68	59	112	64	45	49	36	61	79	72	67	36	26	39	59	56	72	43	101	81	43	50	68	48	14	34	45	71	50	94	42	72	43	57	64	32	22	48	28	35	86	80	70	64	50	47	49	73	68	82	72	82	88	51	29	54	59	43	33	62	39	54	70	60	34	39	46	58	58	97	28	104	38	45	41	57	35	40	18	48	43	29	91	64	16	78	46	42	28	48	38	37	42	37	33	50	27	48	23	26	52	71	54	20	39	41	48	35	13	46	38	36	45	28	35	28	46	44	25	60	20	35	35	53	73	34	36	58	45	33	14	57	52	33	31	39	41	35	55	29	48	33	60	66	36	44	30	58	30	57	65	61	48	46	20	21	36	32	30	38	26	85	33	34	98	18	23	38	34	36	40	19	33	14	22	30	20	15	62	41	37	45	19	22	21	13	29	33	16	76	54	36	23	58	14	17	34	22	31	33	18	50	27	36	32	26	16	21	11	17	26	23	18	13	38	34	21	35	19	25	28	22	30	31	32	13	14	14	48	18	25	49	33	22	22	11	18	8	34	34	32	6	16	11	27	27	31	22	17	9	25	30	24	36	26	18	16	2	27	19	16	17	41	27	38	5	7	9	15	36	34	13	4	34	15	9	35	8	35	8	12	12	17	13	11	22	17	16	9	37	4	16	6	36	17	24	25	12	31	12	16	19	16	12	13	0	35	9	17	5	11	7	9	5	4	5	39	7	4	15	19	38	33	12	11	60	22	15	19	10	12	7	12	9	16	3	13	8	14	6	3	33	20	10	7	8	7	9	8	28	4	7	8	3	5	7	3	7	1	6	1	0	3	14	9	9	1	7	5	1	4	4	0	0	0	30	2	1	2	1	2	2	0	7	16	2	0
ne0259	3491	5044	2748	2839	2457	1845	2258	1402	1696	1319	1734	1091	1368	1300	1972	1377	1417	1226	1452	1298	1556	1145	1660	1061	1050	1106	1377	1191	1174	1591	1125	1547	1015	780	1593	1474	1104	972	1101	1348	850	1044	892	710	744	888	720	908	1221	1113	709	980	1030	1000	750	891	884	898	936	847	679	922	1048	942	900	749	562	769	739	838	938	930	1109	757	1014	1140	720	705	878	748	728	815	505	726	1028	584	664	965	938	787	815	871	396	690	698	1007	447	715	624	543	892	797	797	458	653	676	704	474	663	563	684	645	502	362	409	1085	483	677	516	352	644	472	703	889	751	642	591	505	481	473	715	639	520	696	686	569	658	563	401	441	571	470	701	475	1508	748	623	536	466	578	587	557	617	744	644	448	501	676	312	520	581	637	681	882	799	649	587	731	491	614	836	556	607	868	349	770	662	320	467	607	469	676	586	369	651	657	769	592	573	472	754	504	503	702	524	534	497	325	599	448	525	518	396	478	456	432	549	574	529	445	306	440	481	403	528	726	399	683	492	647	730	573	640	399	988	538	546	690	492	420	630	415	512	492	418	674	753	578	707	442	471	463	592	524	449	507	453	417	434	453	373	436	513	506	524	236	621	555	538	554	548	466	543	462	327	539	381	414	517	496	476	465	297	420	447	381	489	329	550	454	625	471	335	306	466	369	497	447	913	270	486	471	571	421	342	443	452	328	354	385	495	489	611	429	348	429	505	652	345	386	479	476	479	587	491	312	337	468	345	446	519	518	422	362	246	441	302	391	396	402	293	269	315	365	351	324	473	381	294	354	345	312	502	392	238	520	323	438	366	494	363	419	438	392	362	330	450	491	441	312	430	370	402	403	421	494	313	524	412	276	413	280	391	282	295	315	234	452	346	317	581	569	342	227	333	316	241	425	296	295	334	336	279	516	282	268	301	273	354	278	495	414	513	382	250	347	324	303	287	395	352	333	296	216	482	232	357	408	402	251	326	295	208	531	308	505	294	427	272	288	385	371	369	391	241	217	293	365	268	274	336	320	340	293	314	308	309	284	428	308	306	263	229	286	395	280	313	292	254	365	222	229	414	220	277	190	288	305	281	294	258	271	224	281	371	222	326	312	272	212	304	320	493	285	189	272	284	249	309	326	248	357	201	230	417	276	360	331	258	211	199	325	245	278	300	222	342	203	334	302	250	325	226	213	358	326	222	312	207	186	296	349	371	1049	222	252	226	203	467	213	277	314	179	318	652	344	210	244	313	292	257	206	375	286	232	148	674	210	409	167	386	252	200	266	425	365	222	236	135	229	247	287	246	194	258	227	248	188	177	218	229	192	182	213	256	312	234	204	306	249	320	179	273	185	269	245	657	239	257	194	228	395	321	317	154	198	217	202	173	240	243	252	228	207	262	161	338	250	238	226	195	293	347	210	309	208	276	184	201	321	177	223	211	309	295	191	270	249	212	247	138	228	233	312	237	351	128	432	139	154	296	198	328	243	201	166	247	197	302	196	318	241	192	208	185	338	195	180	273	188	158	126	189	139	279	196	182	269	286	257	140	221	182	165	191	144	193	278	197	237	219	177	178	190	223	126	179	159	288	181	202	205	151	157	149	152	149	409	100	227	129	166	204	221	154	202	217	181	107	197	250	236	307	254	240	214	234	189	455	234	94	200	121	307	216	195	120	196	182	159	140	135	215	133	208	179	176	118	203	318	166	163	158	147	108	141	245	144	168	216	184	196	178	196	147	179	172	236	197	112	207	119	254	217	165	151	109	214	158	130	186	205	225	163	137	157	119	177	117	131	202	234	232	143	135	129	120	211	141	204	170	142	135	245	165	105	134	148	123	154	91	164	177	395	209	144	179	272	128	132	205	200	112	142	177	261	154	214	185	163	295	187	188	62	114	168	174	160	439	177	104	155	139	93	171	130	114	125	181	124	126	208	145	204	181	104	138	165	211	217	120	171	58	148	106	162	177	145	240	151	212	148	87	200	116	204	78	154	334	157	143	215	177	137	184	223	148	163	152	117	188	104	225	174	104	156	119	241	116	90	196	122	117	181	204	124	62	163	133	100	134	384	260	96	163	224	142	108	114	148	213	70	137	155	106	148	231	167	190	105	129	158	123	88	99	159	126	121	137	156	125	83	173	188	136	146	167	126	84	124	150	93	66	97	83	123	169	281	152	124	180	81	145	178	148	69	350	144	188	130	87	162	148	101	118	127	144	101	123	121	150	98	152	104	166	93	85	129	176	93	161	136	147	73	93	279	68	106	151	128	215	87	154	181	129	195	222	128	101	70	121	106	96	108	130	137	73	118	88	134	102	90	105	104	108	102	186	105	130	134	92	111	119	106	84	97	150	160	111	99	99	135	125	118	117	121	89	156	121	145	93	64	167	112	147	88	92	128	101	231	72	92	185	88	81	90	98	112	104	117	80	82	70	99	39	131	415	88	130	60	178	148	169	73	149	92	85	95	83	119	97	107	70	72	52	137	69	101	95	82	86	128	115	79	79	78	103	75	79	141	156	72	112	156	155	123	98	160	108	66	107	89	102	96	55	121	53	113	109	114	146	141	113	105	125	53	60	104	142	87	40	89	69	102	53	68	83	66	66	182	125	191	68	100	114	407	151	94	63	103	94	56	98	84	93	61	127	31	95	89	73	54	127	74	58	77	125	108	54	114	138	97	93	120	202	86	87	82	98	90	48	96	140	58	65	66	64	89	103	131	55	70	169	140	162	83	146	46	164	66	71	158	90	44	78	89	169	105	80	166	82	88	85	82	98	85	53	77	104	146	150	45	65	88	45	109	68	130	130	62	107	136	78	50	59	90	81	87	173	68	164	62	49	97	24	118	112	67	50	71	106	59	56	87	49	145	84	49	71	67	68	99	95	73	54	75	112	106	121	120	94	61	63	57	71	31	93	91	82	76	81	54	86	75	61	45	74	94	98	88	69	96	69	91	117	88	65	85	74	76	108	74	47	69	120	50	52	75	63	76	91	78	41	67	63	82	129	60	111	110	44	126	83	49	135	46	54	59	77	87	13	78	105	49	48	44	43	48	56	54	54	95	39	71	88	41	77	68	51	40	62	128	72	161	105	149	29	55	62	42	53	44	48	43	119	82	53	81	86	72	43	84	69	39	45	38	84	58	75	63	103	182	79	154	37	44	101	40	75	39	37	62	79	61	61	47	35	49	40	39	115	91	57	33	109	77	49	91	74	66	73	56	78	57	49	50	53	103	55	40	77	58	30	48	99	79	119	29	61	321	80	69	46	56	41	73	70	69	30	29	35	33	29	54	130	29	41	30	27	62	27	57	51	35	33	39	63	76	73	57	33	52	46	106	63	31	47	56	60	73	83	59	53	50	60	30	27	41	33	34	50	85	70	66	57	31	41	25	61	68	109	31	110	35	48	39	44	33	51	56	67	52	99	60	39	59	29	40	76	62	49	32	31	66	74	41	43	44	27	40	30	54	35	64	25	69	47	47	65	32	23	42	49	30	38	47	19	27	25	29	13	14	31	29	29	30	20	33	39	8	28	54	27	37	19	46	34	27	29	33	21	19	39	60	37	17	20	80	27	55	41	18	53	43	48	34	23	24	29	33	19	37	44	45	36	43	32	39	33	43	63	35	12	46	31	26	38	38	38	39	27	15	47	10	25	15	83	22	26	40	16	17	22	55	21	28	26	18	22	41	23	17	31	13	33	18	22	24	16	56	97	24	15	13	14	27	25	15	34	32	21	30	40	20	20	45	10	18	27	16	24	21	22	15	6	49	21	9	28	21	21	23	35	12	40	18	11	19	17	18	16	16	29	10	10	44	11	7	5	28	13	13	11	19	4	18	18	37	30	57	13	40	22	30	20	31	9	25	16	5	19	42	25	3	16	15	17	6	16	4	4	73	21	8	40	91	12	3	19	42	18	14	10	10	6	7	16	6	15	26	7	7	5	6	9	6	12	31	9	29	8	9	13	14	11	9	1	5	9	7	13	8	8	13	6	9	6	12	6	13	13	2	6	3	11	5	65	12	10	7	7	12	14	12	10	10	1	4	3	12	8	2	11	39	5	4	10	9	2	10	2	4	16	2	7	2	2	3	3	1	5	3	0	24	1	4	1	10	5	3	1	6	3	0	0	2	1	1	3	1	3	5	0	0	3	1	0	0
ne0260	4149	4787	3155	2934	2989	1951	2430	1589	2124	1297	2385	1333	1389	1285	1519	1378	1330	1828	1594	1184	1810	1346	1470	1626	1356	1574	1459	1137	1523	1271	1412	1484	1143	826	1337	1425	1337	1171	1288	1216	1273	1112	2001	938	1096	800	951	888	887	1214	729	1156	860	953	936	865	1834	1017	885	933	718	1032	1236	1346	1014	733	725	1120	965	1194	975	1113	990	1022	1235	1350	1029	850	856	1090	911	1238	699	1246	1319	646	811	1116	1066	659	931	714	436	791	1202	779	688	1046	876	1132	791	867	949	513	782	777	701	497	641	745	692	633	508	509	500	806	539	748	898	452	896	506	799	774	687	691	660	1042	521	516	843	558	624	654	821	632	885	998	512	660	856	694	931	615	766	577	683	844	444	564	775	696	555	574	556	1007	472	840	362	552	764	722	804	679	638	639	614	695	484	734	671	749	777	552	404	713	641	406	710	1292	622	1159	618	581	631	688	605	526	662	632	815	544	965	725	682	691	562	339	703	468	522	858	815	631	1137	539	636	530	525	435	366	651	767	408	372	702	616	673	430	717	692	522	588	336	734	741	556	665	539	669	588	393	540	664	503	507	529	655	784	541	606	523	532	496	1260	400	411	539	590	463	628	628	538	1328	489	269	866	536	844	540	584	457	679	452	628	508	397	740	561	449	761	494	447	553	581	460	529	384	571	608	602	508	568	568	634	374	445	465	489	379	518	626	586	483	381	499	632	488	333	580	393	471	436	389	294	557	649	504	479	475	552	492	576	2367	400	1028	261	432	484	515	546	367	486	497	440	463	311	489	464	1084	429	330	337	435	462	357	430	290	372	408	376	278	459	233	314	449	241	429	496	485	442	403	478	353	465	345	500	689	512	480	375	444	455	588	468	738	518	491	418	218	369	467	322	447	397	439	324	427	428	481	357	450	431	316	946	304	575	464	310	411	308	410	439	412	407	319	323	405	443	372	473	345	412	383	231	404	610	441	282	463	417	472	644	320	663	418	505	455	422	290	319	342	214	444	425	322	334	388	362	296	497	356	371	432	446	257	334	444	245	454	356	289	555	388	339	331	294	423	328	276	322	391	355	347	390	358	336	383	264	311	280	285	327	281	396	307	283	256	311	536	236	286	245	365	366	284	378	395	307	318	284	321	255	393	219	284	315	307	364	352	325	431	269	338	650	392	338	312	343	220	358	277	310	351	321	455	419	308	292	287	311	254	308	384	301	294	300	421	264	280	391	356	356	582	288	298	380	241	396	251	353	220	309	359	377	299	413	270	410	383	310	326	388	308	336	544	278	267	239	186	342	293	281	376	327	359	274	270	228	439	303	264	211	330	258	280	278	254	344	331	242	325	397	268	314	358	388	261	357	241	345	215	261	267	288	261	302	243	160	168	311	307	309	266	235	303	243	291	150	283	223	339	317	298	269	283	241	359	348	237	247	269	309	209	281	335	480	220	185	289	241	242	229	235	320	203	255	242	233	421	262	251	255	231	274	372	231	322	242	297	250	158	275	312	281	335	291	261	256	255	230	325	167	206	252	242	223	271	180	233	165	175	380	231	242	253	241	242	264	252	222	364	224	259	179	226	247	304	248	195	228	181	136	243	192	316	210	130	229	352	273	247	210	508	172	259	149	240	106	187	233	208	226	214	185	264	251	200	128	186	260	333	432	185	219	291	204	195	247	147	116	221	164	290	250	338	148	212	202	291	109	172	176	201	353	174	219	161	248	299	158	227	223	124	129	192	333	316	246	197	202	202	212	179	320	246	154	240	168	245	327	170	210	249	289	141	623	188	311	190	285	226	204	187	156	192	124	313	161	231	232	208	228	197	190	249	195	202	191	249	157	197	158	223	190	103	205	163	196	134	184	207	337	258	216	161	244	211	119	148	168	131	116	224	230	334	184	238	244	156	285	333	558	170	136	245	170	143	242	208	262	197	188	181	215	139	180	196	150	201	232	167	220	206	189	220	135	285	172	193	167	223	108	195	198	153	252	190	227	215	157	316	78	185	205	276	131	181	230	127	139	237	170	178	709	135	173	188	223	164	190	90	200	209	115	155	186	214	159	79	211	112	175	168	192	137	84	166	178	141	86	126	233	113	144	261	147	91	207	186	105	120	302	276	144	176	157	160	152	145	119	166	359	135	127	211	124	72	150	137	217	134	162	210	149	235	192	113	125	102	100	172	212	111	125	134	210	85	124	104	170	138	127	162	204	103	198	143	168	286	116	95	245	655	120	166	133	151	234	120	153	90	193	134	171	150	126	149	146	103	128	213	96	126	125	198	135	128	153	213	190	128	155	101	187	164	195	128	167	84	138	165	89	107	139	205	116	141	118	112	119	97	256	144	105	148	210	136	189	133	54	159	125	217	106	152	284	187	145	113	139	142	113	157	68	213	113	121	114	133	107	205	169	90	130	83	92	190	123	222	70	128	124	86	136	217	161	243	111	142	61	124	104	83	69	99	98	150	121	114	167	180	118	177	217	109	175	153	92	78	104	81	126	66	87	121	199	135	95	185	114	74	160	79	84	116	92	212	104	138	208	79	102	143	175	133	123	146	153	63	114	120	115	103	94	111	59	99	92	111	146	93	89	119	90	75	150	92	262	97	59	122	132	95	95	63	115	92	99	117	121	191	71	123	126	279	129	111	91	173	93	114	136	83	88	72	138	34	135	78	85	92	191	132	132	199	91	92	144	92	141	91	80	88	138	139	113	77	73	108	86	93	149	58	70	56	86	87	59	74	64	65	107	140	98	83	164	121	51	93	75	153	126	39	84	342	91	113	105	138	80	88	118	98	107	77	49	79	92	86	123	48	101	100	314	129	106	67	104	81	93	112	60	90	131	77	46	89	132	89	127	86	81	92	66	136	69	99	84	73	117	176	103	95	37	107	92	60	98	79	61	105	67	579	78	111	80	97	110	124	121	78	90	66	60	109	92	87	114	86	103	54	100	85	80	65	89	102	70	83	71	197	72	105	82	113	86	83	171	101	76	73	93	96	70	42	63	89	143	76	37	117	237	114	83	99	136	82	88	52	55	79	92	39	81	81	54	45	55	78	68	52	71	135	115	81	266	57	68	63	64	121	61	93	67	64	65	79	41	118	83	43	95	109	56	70	74	36	150	49	40	57	53	53	62	61	75	30	113	62	62	87	68	84	67	51	75	42	74	70	66	77	66	53	73	70	101	55	90	83	14	78	476	199	81	113	48	51	43	40	22	88	114	44	148	87	97	122	57	33	142	37	96	53	55	55	50	69	71	41	47	46	43	32	96	80	126	38	74	139	86	61	61	72	49	80	101	68	49	60	90	55	41	56	46	26	36	45	36	66	30	246	59	27	93	88	48	85	61	91	41	42	205	104	40	26	38	88	62	69	70	41	54	59	56	77	43	31	87	43	77	22	47	68	95	35	45	50	58	58	76	57	107	41	51	32	55	48	19	32	48	79	44	58	41	39	32	75	28	46	37	34	93	50	34	45	77	61	62	27	48	50	34	59	39	13	40	38	32	38	124	42	51	67	119	61	114	28	51	47	20	53	46	37	27	40	72	28	16	45	132	8	56	46	29	35	121	64	57	51	157	26	44	37	33	39	46	35	37	33	448	17	37	154	37	31	50	23	24	29	18	42	29	48	56	59	25	24	24	22	77	147	23	38	89	67	25	37	20	24	26	52	89	24	37	18	21	38	11	107	18	66	21	24	29	67	31	13	42	45	26	44	37	13	40	45	20	24	38	43	18	61	49	51	26	32	36	14	35	31	24	26	20	31	21	35	13	15	25	7	19	27	21	38	36	46	15	12	15	21	18	19	23	15	18	21	9	18	20	30	22	20	54	31	23	44	19	4	15	24	9	19	48	21	10	32	33	17	23	24	14	18	38	28	18	22	19	39	22	13	51	16	17	14	28	14	14	9	28	10	12	56	8	9	41	7	419	19	26	70	93	9	13	21	5	5	21	12	10	12	64	18	17	6	71	38	9	39	8	12	12	4	30	16	9	5	4	5	5	15	4	8	8	24	10	4	1	49	2	11	19	13	14	15	31	453	57	19	3	7	10	15	1	20	12	6	4	7	24	8	41	10	26	10	3	1	7	5	7	19	0	3	9	5	3	1	2	1	3	13	0	3	1	4	22	3	8	3	6	1	0	4	3	1	0	2	2	0	0	2	3	2	1	0	4	0	1	0
ne0261	580	874	533	396	483	268	373	218	286	203	290	241	201	207	306	214	169	262	263	219	250	177	254	200	225	232	233	155	187	225	266	160	143	118	225	209	205	167	198	178	172	169	187	95	204	150	131	114	133	183	121	165	164	154	178	138	226	201	134	192	121	211	234	222	165	132	87	199	157	153	189	173	167	127	248	200	110	125	140	159	121	155	112	156	174	128	161	184	141	113	121	160	70	111	164	111	88	123	114	153	96	133	145	81	113	91	93	85	245	142	120	132	73	62	76	95	94	118	160	49	148	77	170	116	131	108	132	193	93	77	109	76	115	120	107	146	120	150	71	102	102	70	88	110	110	77	97	114	97	89	93	116	66	87	88	103	68	122	63	105	71	103	115	80	133	105	174	114	139	111	112	114	98	128	54	138	94	59	95	130	171	106	96	72	121	130	105	83	92	92	128	67	164	94	74	84	87	52	65	65	88	118	153	80	159	71	93	76	71	92	56	58	73	38	62	76	67	144	65	92	131	119	117	75	125	85	129	87	100	106	125	94	115	116	76	95	97	119	145	89	70	86	82	99	77	44	59	79	83	68	81	61	105	96	72	42	96	99	113	109	82	65	114	50	61	93	56	73	108	86	92	94	57	72	53	100	126	60	131	88	121	87	98	98	81	259	106	83	53	59	77	69	109	64	81	88	61	47	56	79	90	108	89	48	62	76	72	71	49	56	118	99	99	54	82	52	70	76	68	62	69	57	75	65	44	88	67	69	72	57	77	55	42	73	52	75	58	98	44	41	63	72	50	63	27	92	71	84	127	91	64	76	83	58	69	49	75	85	88	125	72	156	73	85	71	51	44	103	63	58	81	69	55	58	62	162	34	117	62	71	61	85	80	34	52	71	51	78	50	55	62	77	52	112	126	56	80	55	138	69	49	92	32	58	50	55	59	72	52	69	50	68	53	45	69	34	51	54	43	37	45	76	33	42	55	64	49	51	58	56	61	73	42	49	59	36	51	52	40	54	63	51	56	53	61	60	33	37	62	45	60	110	36	49	70	69	63	61	66	53	23	38	76	45	61	36	60	48	50	97	60	30	46	63	59	43	62	50	47	91	53	49	54	75	27	80	40	37	60	40	72	45	52	50	76	54	45	41	30	31	72	22	38	72	45	22	107	50	49	36	40	34	24	69	53	80	55	53	30	26	57	63	82	35	43	62	50	34	54	37	46	90	27	29	52	35	90	48	71	60	54	50	81	43	54	49	38	65	46	28	57	37	32	35	29	46	48	49	39	57	33	43	47	28	34	51	48	24	39	26	46	31	51	47	56	55	50	44	51	32	71	23	45	35	42	40	21	40	63	44	37	57	42	69	20	38	52	33	19	52	37	38	40	53	48	25	30	26	48	51	32	32	57	46	44	43	29	38	33	55	79	39	32	56	65	41	67	40	30	52	26	45	43	43	44	67	54	24	44	25	47	98	44	39	48	35	39	83	64	38	32	34	24	34	41	33	25	28	98	68	30	22	59	31	48	35	50	36	35	37	30	62	34	34	26	48	34	38	38	37	34	22	14	41	75	18	30	22	30	49	50	23	27	37	68	23	31	41	13	45	27	28	19	28	25	29	29	18	26	49	35	37	35	38	41	30	49	42	27	33	19	37	31	59	42	42	29	27	44	18	16	27	35	19	32	48	46	23	24	44	44	57	63	28	13	39	49	26	35	41	39	39	37	42	43	18	11	36	44	27	42	21	23	33	24	35	33	15	38	29	158	25	20	29	33	41	14	40	18	19	19	37	40	24	13	30	29	48	28	35	37	34	18	30	23	22	23	30	13	29	19	36	43	16	48	32	18	27	26	24	43	40	12	43	18	12	27	34	29	42	32	15	33	16	21	36	15	23	30	26	24	26	18	38	33	25	22	30	46	51	24	23	26	28	27	23	36	26	21	40	13	22	12	16	34	35	18	21	45	34	33	25	12	30	24	26	25	23	30	23	23	22	41	16	51	37	20	25	26	26	28	6	20	30	10	27	17	44	48	11	28	12	16	21	27	20	18	28	23	19	21	20	24	12	29	30	12	19	26	28	19	19	18	19	22	26	24	18	29	15	12	18	23	13	23	26	29	18	19	47	26	12	30	28	28	35	42	10	17	20	60	9	15	12	16	21	35	17	28	17	18	14	46	27	26	14	10	21	26	18	5	21	13	21	16	28	14	10	23	17	19	15	10	25	24	13	9	24	27	14	25	29	25	32	11	9	12	11	23	28	22	13	35	16	45	19	21	14	16	17	27	3	37	17	28	14	15	47	23	14	19	23	21	27	10	33	37	17	24	25	12	14	11	17	11	38	26	26	16	16	24	25	11	14	16	21	25	38	10	14	10	20	23	6	23	19	9	25	34	13	16	28	12	19	15	18	21	15	13	30	8	38	22	25	9	15	9	25	20	11	22	16	25	13	23	6	9	13	14	14	22	27	14	17	17	14	44	11	15	13	14	21	24	17	6	15	37	19	8	9	26	10	11	9	19	12	31	19	21	6	27	28	33	16	15	29	12	23	21	26	26	14	16	11	32	27	11	12	29	6	12	26	9	11	16	14	19	30	12	4	16	32	16	34	11	8	30	17	15	30	20	23	15	17	11	7	21	6	17	13	7	51	17	21	19	22	47	32	8	13	21	11	17	14	16	24	17	9	19	33	8	16	18	48	15	21	12	9	32	9	8	11	17	19	6	10	17	13	13	4	9	20	11	10	23	28	11	20	25	15	17	7	22	16	16	12	13	41	15	5	12	14	12	15	42	23	9	9	24	17	28	21	2	14	14	21	17	26	17	8	13	29	18	30	10	40	13	18	11	40	11	17	4	13	20	10	23	13	16	11	15	22	18	11	11	28	14	17	7	25	19	7	14	16	8	11	18	8	23	19	24	19	14	18	9	17	11	21	19	25	22	9	10	6	5	34	5	7	15	13	11	8	12	18	23	16	11	20	21	11	34	14	9	16	18	23	17	13	19	19	12	5	11	11	16	15	69	6	68	10	8	8	10	7	12	10	10	16	23	10	27	6	11	9	18	7	10	15	14	7	23	15	16	9	14	10	9	13	9	16	8	7	11	32	31	10	22	3	9	12	10	12	21	6	4	12	9	5	12	8	14	20	7	16	10	9	8	10	4	6	6	10	11	13	6	10	33	8	5	8	14	6	10	13	2	3	19	14	13	7	16	8	14	5	9	17	12	8	18	8	4	15	9	7	3	26	6	83	5	4	10	8	5	16	17	7	12	10	50	7	9	6	22	13	12	4	9	4	4	19	10	15	10	8	7	14	7	4	10	4	16	8	28	11	6	12	3	3	12	6	9	9	9	13	5	2	11	3	8	4	9	9	5	15	10	12	7	8	8	8	14	4	23	127	6	5	13	5	14	2	8	14	5	21	9	12	5	7	10	17	5	6	1	20	6	13	3	4	7	4	1	12	5	5	7	3	8	3	5	4	7	2	14	2	7	18	14	9	7	13	1	11	8	10	10	10	4	19	2	4	18	2	6	9	8	8	6	9	11	11	6	11	4	13	4	7	3	10	5	5	9	1	14	7	10	5	4	9	1	12	4	14	9	4	6	15	4	0	16	2	9	11	0	2	8	2	4	6	3	5	4	10	13	7	19	2	7	5	4	11	2	4	2	1	0	2	10	3	4	3	4	6	8	2	2	1	11	6	10	12	12	18	1	8	5	4	4	5	4	3	7	3	5	6	2	12	10	4	2	3	3	1	4	5	3	4	3	2	3	1	2	2	9	7	2	3	7	40	1	6	6	2	5	3	2	5	9	3	5	2	0	2	0	2	2	2	1	1	2	1	0	4	5	0	4	2	3	5	18	10	9	2	4	0	3	2	1	2	2	2	1	3	1	3	5	2	5	3	2	7	3	1	2	6	3	1	6	1	2	10	8	3	3	0	10	5	0	5	3	0	0	1	4	2	2	1	6	10	1	1	1	4	0	2	1	2	5	2	0	2	1	0	1	1	31	1	5	4	1	14	0	0	0	1	0	4	3	0	8	0	4	1	4	2	0	1	0	1	0	1	4	1	2	0	7	1	1	0	1	0	4	0	12	0	2	0	0	1	0	1	1	1	1	1	0	1	0	0	0	0	4	1	0	1	2	0	0	0
ne0262	7567	9625	6079	4961	5867	3812	4699	3306	3064	2658	3276	2729	2444	2621	3183	2838	2522	3130	3439	2601	2781	2357	2828	2428	2437	2284	2361	2457	3238	2318	2347	2153	2075	1747	2631	2546	2322	1849	2168	2181	2040	2223	2571	1713	2074	1692	1690	1864	1924	2147	1600	2187	1920	1774	1989	1706	2121	1933	1842	1518	1471	2115	2153	1797	1982	1615	1261	1984	1936	1922	2012	1813	2106	1684	1789	1920	1632	1496	1620	1962	1594	1583	1318	1816	1885	1247	1812	1909	1816	1483	1718	1638	1010	1402	1630	1859	1282	1641	1814	1416	1454	1643	1656	1292	1472	1470	1416	994	1963	1471	1494	1500	977	847	979	1454	1144	1351	2283	847	1418	1035	1415	1445	1334	1254	1195	1215	1062	1013	1495	1195	1310	1223	1446	1127	1586	1509	957	1133	1404	1054	1277	1068	1208	1135	1166	1299	1048	1133	1334	1280	972	1102	1189	1292	941	1412	828	1145	1099	1310	1246	1099	1259	1238	1263	1272	2652	1213	1456	1486	1238	1211	739	1586	1227	824	1132	1288	1275	1061	984	957	992	1718	981	1080	1076	1063	1489	943	1575	1265	960	1207	1120	696	1123	971	1109	1189	1431	1085	1379	974	1478	1117	913	933	687	845	1108	827	1133	1041	974	1434	1033	1143	1307	976	1390	888	1319	997	1175	1184	1185	1134	1191	877	1329	1551	795	1122	1057	1218	1388	1032	844	942	1178	1009	1039	901	675	955	1158	831	778	1120	1099	1155	941	570	1115	1136	1259	1145	1128	759	1152	807	874	996	879	960	1112	990	1013	862	791	780	805	818	1080	759	921	1096	1248	965	831	1006	830	1851	1006	1004	956	879	1061	1189	1109	1073	777	1047	1080	879	888	829	976	871	975	758	732	1023	831	740	887	748	1137	1009	962	711	1049	838	660	640	664	849	706	786	802	760	482	899	629	870	840	834	831	643	683	595	792	698	771	572	734	786	681	641	791	714	603	949	664	854	795	962	659	866	890	724	852	540	783	1040	857	934	729	926	910	1062	931	905	732	1028	825	634	1032	864	789	673	644	1221	703	933	632	627	630	820	868	588	652	608	579	810	533	683	754	746	639	997	558	573	717	716	1638	509	742	791	588	810	538	750	697	732	506	733	748	1064	671	571	1004	675	645	589	601	606	647	1179	502	721	658	523	639	708	690	565	867	663	854	647	558	650	575	745	553	588	625	532	704	726	773	589	477	723	670	646	543	580	639	616	709	668	670	812	687	580	488	787	825	687	794	473	539	553	530	751	506	507	483	606	763	534	682	640	570	1035	518	606	596	856	501	912	534	604	609	537	624	672	676	491	669	549	562	671	433	388	464	473	568	750	607	442	715	595	582	523	475	429	534	549	572	536	552	420	646	382	623	835	617	662	636	592	662	631	627	745	807	420	391	522	647	633	631	633	648	535	650	568	640	676	709	645	479	463	456	384	802	492	503	620	580	589	471	534	340	521	440	471	458	900	499	610	514	529	969	398	222	582	515	496	522	557	734	371	662	463	586	443	555	458	546	499	357	444	468	380	476	578	572	681	396	496	437	461	333	557	420	493	349	550	489	445	447	466	545	462	504	500	607	562	496	504	519	364	345	580	780	421	560	451	669	522	663	500	422	673	437	565	444	549	423	630	430	440	508	360	511	798	426	648	532	436	459	484	549	480	437	634	431	432	393	412	482	523	309	402	346	331	460	320	371	593	473	517	527	469	465	510	400	448	309	483	407	494	520	426	519	372	477	419	421	340	372	371	295	510	495	572	332	336	809	266	339	397	310	432	325	429	362	442	368	402	307	399	297	357	358	402	436	410	424	383	532	392	287	397	274	420	436	544	345	433	306	304	380	340	256	328	382	414	437	342	362	368	353	497	329	415	271	379	298	421	723	281	422	525	307	359	430	488	312	354	287	358	573	396	551	283	416	446	359	359	457	281	497	478	674	394	320	333	348	378	313	286	412	312	307	395	349	347	267	448	426	485	284	560	397	402	309	336	328	226	338	252	274	334	231	392	577	291	496	352	295	380	334	381	273	270	286	507	440	488	357	329	355	299	735	316	290	257	318	362	346	263	460	390	299	333	275	366	380	267	279	306	357	417	350	373	372	321	323	297	310	353	328	394	243	422	278	283	241	303	337	301	411	359	297	275	171	383	297	545	225	331	586	321	287	294	321	230	259	364	312	324	422	279	349	242	298	335	207	268	243	402	562	224	356	209	205	311	330	238	177	278	306	293	232	294	425	191	325	298	342	255	588	360	310	234	218	268	281	297	293	280	269	244	257	198	406	285	323	282	246	151	282	293	348	228	398	419	256	350	371	226	302	196	497	221	218	232	251	249	384	202	276	248	274	199	287	307	373	166	219	272	266	441	183	203	256	267	358	241	254	173	296	169	241	217	206	231	269	189	176	271	244	200	201	406	315	209	192	368	195	152	297	387	354	254	286	382	509	361	295	294	208	137	419	194	333	212	290	222	192	296	222	235	247	218	213	263	168	293	348	249	265	225	154	238	246	162	144	306	384	284	241	245	207	306	171	168	262	327	191	222	172	267	191	211	203	207	530	192	156	305	255	347	269	254	259	178	192	171	239	208	202	279	140	259	280	159	139	152	174	261	320	145	316	205	279	260	243	156	172	160	159	205	205	238	168	148	191	282	382	308	145	165	190	192	217	184	144	142	228	186	144	241	290	177	204	238	295	134	208	176	302	129	228	182	406	153	167	273	146	124	245	286	278	206	219	152	198	148	159	282	221	166	141	227	134	220	216	284	195	145	124	213	173	131	189	221	282	163	284	214	155	218	131	251	245	233	168	131	343	69	244	150	154	179	172	169	175	211	212	142	160	196	475	140	333	205	205	197	166	159	218	231	187	176	230	436	133	268	127	180	193	245	128	188	219	220	192	145	209	126	137	160	136	209	143	130	191	381	178	199	310	158	237	108	187	191	139	138	149	604	181	214	180	94	181	245	115	259	205	117	199	168	175	239	109	154	119	160	116	123	215	119	165	179	159	194	134	310	92	217	217	453	201	211	85	184	251	120	207	152	161	142	158	183	124	179	137	193	226	269	160	238	108	133	120	112	149	180	131	107	238	199	290	137	180	114	132	118	129	385	125	144	208	121	95	163	168	164	137	135	97	210	103	144	114	142	171	230	92	143	205	120	127	137	122	184	145	183	248	169	161	124	101	152	166	224	250	126	90	111	92	123	77	135	153	112	96	114	118	338	270	128	126	159	166	117	166	111	122	176	167	123	181	203	303	109	178	175	115	114	80	92	76	105	145	386	121	163	134	110	148	91	121	152	71	135	103	93	145	131	83	130	138	122	101	119	134	119	140	125	105	59	67	104	132	105	116	152	382	101	69	132	97	134	94	92	149	127	179	183	102	77	167	86	119	118	114	92	99	119	124	135	114	143	94	107	129	248	98	74	97	123	135	135	93	102	143	120	156	129	186	68	77	101	121	118	98	112	118	92	108	152	80	87	77	92	50	98	113	96	97	133	183	80	249	222	82	55	91	66	80	104	143	103	109	249	59	80	149	51	66	48	94	103	109	156	46	84	162	81	74	117	147	116	161	258	118	121	115	67	81	71	66	90	104	92	141	133	67	124	83	150	77	44	60	154	78	105	56	66	114	78	79	70	62	55	68	41	49	74	57	66	52	75	122	95	80	96	112	64	75	62	36	53	70	68	63	83	53	57	47	54	104	18	69	96	58	89	65	52	36	66	85	67	64	108	46	44	30	69	62	51	90	27	113	106	113	65	90	65	34	67	74	87	132	66	86	77	60	29	83	36	73	153	90	56	167	53	40	58	87	73	46	39	166	107	120	85	109	95	57	57	38	80	22	127	38	45	108	35	74	76	35	67	74	32	68	39	87	85	164	149	134	89	42	44	57	66	72	28	57	54	41	30	19	53	28	55	61	37	47	20	44	31	31	65	58	65	62	23	24	24	42	66	48	39	23	37	57	208	25	49	43	52	61	37	38	69	71	30	26	46	35	15	25	27	33	56	30	28	130	24	21	25	61	50	48	90	28	53	84	68	47	42	52	30	21	18	18	24	73	23	20	29	20	23	60	30	26	24	27	103	21	25	21	36	20	16	39	39	17	31	20	33	34	23	21	44	20	39	29	33	16	26	71	46	12	28	9	80	42	37	23	71	17	65	22	18	18	27	15	21	56	15	23	15	77	22	84	45	24	27	11	21	29	18	16	16	10	14	13	13	20	13	19	34	7	11	18	17	13	26	17	10	38	12	16	13	7	6	4	7	19	6	0	5	12	26	43	40	237	3	2	10	8	0	4	3	4	8	4	4	11	3	5	0	4	0	0	0
ne0263	3987	3725	3012	2558	2129	2048	2324	1901	1752	1401	1602	1625	1321	1558	1288	1263	1293	1536	1451	1513	1531	1158	1314	1296	1264	1061	1081	1410	1184	877	866	1216	1213	1030	1025	1119	1067	801	1253	1306	1070	1031	1011	971	912	922	932	980	724	1098	924	1174	944	660	1042	710	1097	846	928	941	913	786	671	940	973	941	768	981	995	913	1050	730	904	844	790	831	795	849	1028	911	776	810	675	833	768	677	836	998	617	849	616	851	595	868	916	729	602	770	857	747	846	676	611	687	738	840	634	582	879	818	785	745	584	586	592	629	688	569	612	588	678	687	572	761	804	580	677	639	669	611	712	646	672	518	762	529	824	595	615	477	762	430	568	477	488	549	570	610	578	593	654	557	581	649	695	535	548	503	493	476	571	643	589	567	727	516	620	613	347	500	574	655	716	483	457	780	667	475	432	559	364	402	680	602	551	494	567	464	605	574	662	617	500	630	522	490	469	439	676	481	594	465	804	630	722	446	568	690	425	525	421	486	492	507	428	477	517	468	472	733	648	684	566	608	560	467	608	583	546	604	619	561	565	517	487	431	474	581	700	460	410	433	488	272	685	584	373	556	552	384	405	435	683	882	356	391	429	554	594	525	332	367	653	480	406	596	541	569	449	471	451	431	432	397	377	292	537	354	418	481	378	546	377	496	319	496	383	474	308	404	550	560	460	631	273	472	438	448	447	498	420	464	481	347	472	386	420	359	553	434	439	539	427	313	375	559	451	269	454	410	398	305	455	381	277	334	279	342	458	470	419	250	381	501	433	437	381	200	319	449	318	454	358	293	260	397	413	409	333	405	385	403	394	280	491	356	356	427	243	314	420	331	240	357	391	454	415	447	391	438	330	384	394	403	319	359	390	482	361	405	164	396	452	235	219	297	533	429	317	319	324	207	350	475	336	310	378	425	544	420	343	197	249	409	226	473	329	315	319	414	365	363	334	258	505	419	335	299	273	332	302	470	261	377	309	403	309	385	276	361	381	219	253	280	239	344	171	333	187	332	359	140	286	398	435	313	247	437	243	325	216	307	317	333	428	273	446	324	263	232	303	267	281	239	373	303	281	201	234	198	116	343	270	351	262	263	278	207	245	464	227	212	310	366	249	320	349	263	223	148	277	425	223	148	371	275	292	308	303	162	185	252	291	222	216	255	309	310	271	318	291	202	375	212	258	208	274	184	291	303	280	286	297	277	351	275	234	329	254	271	374	132	249	253	155	373	311	266	238	219	327	155	262	279	234	352	221	267	247	300	223	230	307	267	259	232	269	254	147	291	316	185	261	343	228	280	211	276	249	239	356	369	174	251	305	199	301	298	244	176	281	273	179	218	270	229	325	212	171	196	205	298	155	298	235	147	259	230	170	190	249	173	120	286	217	141	206	190	225	131	191	194	283	425	234	386	271	174	190	305	222	166	222	142	246	300	282	224	209	335	237	278	216	194	184	322	290	261	209	196	243	186	198	185	163	227	199	156	262	265	166	323	296	173	205	279	249	176	159	289	143	175	195	148	155	208	273	167	167	169	167	232	220	176	161	205	196	233	323	192	170	215	207	146	216	170	123	325	234	210	253	282	130	164	247	244	167	146	130	105	157	177	199	159	253	197	127	180	159	110	122	190	131	219	175	188	254	132	144	137	178	113	233	238	169	167	129	205	171	153	102	116	131	113	241	97	100	191	173	139	174	178	165	126	149	247	308	246	237	152	86	161	179	254	186	167	112	198	231	102	232	161	236	225	155	105	180	109	178	173	195	203	131	180	104	178	177	98	171	119	148	223	130	217	156	184	254	237	190	168	213	223	192	153	182	153	191	127	168	84	131	203	275	81	265	170	162	195	150	146	136	103	153	194	239	209	173	195	146	168	260	161	128	133	129	168	172	112	187	208	76	214	128	116	168	137	109	169	109	133	162	133	140	161	130	96	137	332	115	92	118	240	127	104	85	120	147	133	203	164	79	155	117	126	130	109	100	209	123	95	129	95	75	135	70	78	237	187	200	182	194	205	136	132	150	84	115	200	244	110	137	96	123	113	133	124	64	119	105	162	68	134	159	109	112	126	92	183	128	165	79	124	100	199	98	150	150	159	111	158	90	144	119	144	165	113	103	60	148	56	135	127	155	208	134	76	101	102	148	80	131	109	59	106	99	92	172	104	97	93	155	142	167	158	184	47	92	39	113	263	109	52	113	135	129	135	154	115	137	118	122	70	83	136	109	150	119	106	117	53	65	138	163	105	107	160	109	133	98	159	166	112	141	119	124	215	105	143	73	90	189	154	91	91	132	107	107	100	100	169	166	123	97	106	91	120	99	95	76	113	72	118	142	213	114	156	220	94	111	73	77	147	73	84	69	144	87	88	71	118	62	86	83	53	125	82	88	162	164	113	126	78	125	79	103	193	145	194	70	124	95	102	102	78	100	53	87	109	131	101	221	103	93	112	128	74	77	121	54	94	54	121	82	86	35	169	192	135	88	100	58	74	83	65	88	112	63	81	105	140	120	87	62	99	112	86	102	59	147	89	32	148	125	68	108	99	120	77	104	108	53	114	119	79	83	89	104	137	101	46	72	116	51	153	123	128	158	59	70	107	59	96	19	75	101	176	200	76	108	125	64	82	85	82	124	46	236	74	99	106	78	42	98	67	120	128	106	68	60	87	86	63	188	70	103	87	107	77	37	162	88	72	188	141	74	209	34	47	39	150	98	61	85	61	108	48	98	48	42	61	107	106	184	56	47	90	90	39	96	62	57	65	60	94	96	107	63	206	110	77	86	33	80	101	39	89	66	94	74	84	46	128	33	67	59	58	63	103	55	45	56	65	106	82	97	137	26	97	71	180	74	117	60	83	68	58	99	78	79	76	74	58	41	65	128	85	123	92	48	120	73	57	70	19	55	43	107	75	74	77	95	20	60	36	46	56	57	42	77	64	129	55	36	54	100	46	86	45	112	84	56	81	37	72	92	62	53	59	88	46	23	34	192	94	67	73	52	145	75	47	61	103	56	96	63	60	22	43	29	56	119	50	75	46	41	98	251	44	38	74	9	53	53	63	41	48	77	76	50	55	61	80	60	45	51	29	56	29	45	83	43	36	49	127	43	84	76	40	44	42	31	65	86	38	47	45	64	36	26	70	52	33	53	27	102	54	54	74	64	49	26	84	74	66	52	104	130	32	30	65	41	52	51	22	48	36	45	114	55	32	74	24	26	45	39	90	33	65	39	59	44	50	35	52	48	72	31	26	43	28	56	46	49	27	27	57	42	35	38	20	29	35	48	55	31	29	67	25	27	36	127	51	60	38	10	19	36	69	46	86	24	32	104	58	43	73	55	24	38	63	75	43	61	59	34	14	35	17	27	9	38	22	36	27	8	16	29	41	25	36	31	38	40	68	26	40	36	22	51	69	41	13	47	96	34	48	40	42	29	52	24	22	29	85	36	12	34	19	32	27	37	62	22	54	54	28	19	21	30	44	48	34	55	37	30	42	19	38	35	38	20	29	20	24	55	23	31	73	22	20	30	10	39	52	69	25	39	19	24	19	45	39	32	52	15	19	20	31	42	17	15	14	22	28	15	21	28	15	24	39	19	30	56	19	36	31	22	11	25	12	21	34	18	31	54	15	45	19	49	25	7	14	88	82	82	19	24	20	28	13	25	28	29	73	24	20	10	38	9	42	9	15	38	21	17	23	27	25	13	38	75	35	41	9	22	26	14	10	31	27	17	9	7	10	12	14	7	10	9	16	24	15	23	36	37	34	17	12	2	7	16	17	17	2	13	11	12	131	21	29	5	15	20	34	6	7	27	9	11	12	7	16	102	12	5	15	13	11	23	23	12	10	21	10	9	14	4	5	5	39	26	23	19	3	13	16	4	9	22	2	1	4	8	10	21	10	13	3	4	30	5	5	8	11	9	11	13	4	7	4	1	4	7	33	5	21	2	23	3	8	8	7	28	8	4	16	42	49	4	6	3	6	4	19	6	12	2	6	0	8	17	1	2	12	2	13	49	4	11	0	3	6	28	13	8	5	1	6	2	2	27	4	1	4	11	6	11	4	0	3	6	2	10	13	2	2	3	0	3	2	4	7	77	1	1	5	31	1	1	0	2	15	0	0	0	11	1	5	0	1	0	1	3	0	2	0	0	0
ne0264	5763	7129	4550	4144	4265	2552	2965	2127	2582	1612	2592	1949	1718	1741	2203	1752	1699	2311	1890	1644	2094	1712	1974	1535	1834	1660	1923	1940	2272	1747	1771	1689	1477	1171	1824	1631	1596	1515	1719	1749	1465	1578	2282	1162	1126	1059	1107	1267	1240	1488	983	1372	1425	1134	1689	1253	1640	1339	1411	1309	979	1292	1736	1851	1183	1259	852	1381	1351	1414	1467	1326	1452	1120	1503	1564	1166	1168	1463	1249	1077	1504	733	1139	1359	894	1397	1317	1022	1182	867	1031	625	1067	1302	1248	687	1177	1188	884	1058	992	1099	846	1034	936	1016	658	1401	988	1085	1114	575	570	600	1036	669	898	2741	515	1006	702	970	1038	989	880	981	958	592	691	969	796	1209	922	1267	1010	1546	982	646	851	902	650	998	879	952	801	876	946	900	846	843	925	733	927	1035	1089	701	1032	506	641	814	1072	987	923	885	967	933	990	2121	625	983	1051	827	742	505	1233	808	529	919	962	809	662	948	713	981	2115	918	818	916	924	932	662	947	781	883	561	799	456	934	735	683	762	1183	756	935	687	944	718	682	795	410	788	996	456	797	838	649	1005	694	942	911	831	972	758	904	814	810	725	819	769	881	732	981	1198	707	691	863	943	889	751	682	700	746	777	792	648	562	745	864	631	690	637	755	858	516	331	603	835	1011	1040	636	527	908	592	798	783	599	586	790	748	705	756	532	700	524	633	723	473	703	837	1061	804	691	652	602	1569	624	778	671	559	687	577	873	886	511	653	564	564	593	676	740	558	715	479	637	637	766	651	628	644	749	637	815	508	671	588	573	634	423	573	581	591	738	539	496	521	486	663	612	605	567	428	459	452	490	562	551	479	458	449	567	555	505	563	334	801	627	692	562	798	557	681	650	405	651	439	684	678	778	824	548	621	503	647	607	477	553	650	488	564	663	649	440	500	536	845	497	635	480	571	392	548	606	367	442	537	445	595	472	570	576	501	503	815	386	441	584	526	1246	410	599	441	378	523	459	558	577	505	386	600	538	679	437	403	597	485	372	520	495	477	453	1215	382	475	469	417	436	538	536	426	433	421	685	412	406	400	407	658	625	565	363	437	531	511	675	499	477	584	424	427	388	322	406	519	536	561	507	594	542	453	337	947	606	363	498	330	518	388	469	475	317	355	356	413	416	425	459	546	499	591	461	363	336	625	318	628	395	377	296	351	420	567	690	381	529	458	399	452	382	235	448	346	457	411	236	368	686	483	430	362	407	322	398	440	458	446	475	488	383	286	478	512	577	345	426	520	501	663	519	406	635	279	322	387	491	424	537	377	399	566	498	357	501	416	669	786	392	293	477	292	455	384	385	502	482	463	339	407	238	394	362	340	350	647	384	375	436	355	577	376	269	443	348	374	487	278	381	234	387	261	386	366	377	367	403	387	330	332	368	290	362	392	316	663	319	296	371	293	161	367	349	406	294	355	383	260	416	289	406	338	307	272	483	767	485	358	363	300	310	453	472	368	385	337	320	447	529	327	319	515	300	429	392	306	416	535	301	278	469	353	380	678	270	398	369	295	220	277	474	348	415	513	278	358	316	378	385	227	240	527	218	224	359	230	314	310	288	339	298	310	378	406	334	159	212	297	378	366	296	306	367	314	318	318	350	251	294	391	297	410	361	428	284	249	602	257	224	330	202	344	250	272	305	247	320	290	195	336	231	260	278	370	261	205	341	312	267	313	191	285	190	286	292	413	267	333	192	262	290	275	191	305	254	269	306	267	238	250	282	401	270	346	232	236	188	278	388	289	351	270	244	289	255	516	319	255	180	309	384	335	349	243	286	276	258	352	403	197	445	314	327	327	142	257	237	272	278	137	271	201	222	307	218	283	210	302	384	258	209	299	336	260	283	242	237	213	286	193	244	394	172	241	427	215	271	258	234	262	215	263	256	252	148	271	226	148	256	261	207	280	284	302	285	213	227	201	231	217	277	250	242	305	220	238	264	185	243	297	271	229	273	387	110	225	184	145	255	315	311	267	204	330	187	187	189	271	197	304	328	172	222	339	165	297	230	311	200	281	331	210	260	227	317	153	106	258	277	283	273	229	275	178	312	205	159	207	156	314	298	164	259	215	202	275	245	211	101	177	246	227	165	286	303	128	218	233	144	232	370	294	295	149	240	214	224	136	295	229	200	205	185	151	151	160	205	185	199	112	203	248	199	198	328	213	175	206	240	142	215	176	765	110	116	148	138	171	264	105	285	140	179	145	196	219	348	144	245	186	217	271	152	214	232	146	182	176	208	186	193	99	219	150	183	146	219	181	161	182	159	156	152	179	199	327	206	236	134	177	211	235	204	148	215	417	277	256	199	168	203	117	430	207	412	162	211	175	114	283	287	212	187	141	113	181	86	217	210	175	171	197	117	165	157	183	187	246	151	164	180	122	202	204	142	118	168	261	152	202	88	162	118	160	180	228	416	157	112	222	172	217	556	158	186	178	136	150	135	115	150	210	92	224	119	118	77	89	179	216	212	144	220	142	176	142	208	127	135	158	174	228	172	150	222	112	133	204	168	156	125	164	116	165	244	136	113	155	197	141	129	184	196	95	111	175	183	163	143	168	220	88	216	168	320	122	142	205	117	98	171	160	199	163	235	121	175	107	124	202	223	80	99	210	154	131	151	128	131	109	131	167	155	197	215	128	248	140	154	148	141	216	109	143	178	253	139	105	273	57	206	122	91	122	132	198	158	150	228	86	157	229	219	143	225	185	213	172	151	108	140	92	100	132	137	227	93	414	155	89	119	219	82	157	146	171	136	100	140	76	191	80	113	139	109	118	141	226	192	169	223	174	127	66	175	152	141	124	151	266	135	151	123	100	93	178	93	176	125	104	146	164	160	200	94	65	140	154	107	166	231	105	166	265	100	146	149	240	117	164	216	241	124	150	73	107	250	135	190	125	129	116	114	127	135	112	101	130	153	186	91	135	108	79	55	69	111	85	135	117	101	201	248	69	141	120	61	67	85	175	117	148	115	69	55	153	151	113	136	59	108	114	112	136	88	86	154	254	63	105	78	116	98	83	96	236	158	165	151	168	156	116	96	113	109	115	174	91	80	66	55	58	82	112	126	63	73	112	64	237	354	66	68	96	113	76	100	98	110	120	102	124	104	127	179	148	132	207	138	163	92	67	78	82	86	180	99	129	124	66	112	92	98	118	51	113	53	100	92	124	70	104	109	114	56	124	118	134	115	105	83	47	58	161	151	125	75	83	182	77	70	157	87	96	64	48	88	73	176	87	83	54	133	99	75	73	82	82	121	98	65	98	93	113	105	66	71	95	88	62	59	99	70	69	68	68	146	87	102	70	58	58	83	71	239	80	94	49	94	115	45	102	95	99	64	42	45	50	56	129	97	129	136	70	171	124	69	60	61	44	85	113	102	75	67	101	61	64	196	33	72	71	82	74	56	132	46	66	83	80	60	99	94	84	133	138	44	47	89	55	113	72	63	85	69	116	194	62	34	72	72	111	57	47	36	62	69	175	62	44	167	36	67	57	33	76	50	33	46	79	39	94	55	46	73	114	76	49	90	60	109	104	22	71	69	56	22	91	66	67	19	39	56	54	70	77	27	50	54	53	29	69	35	15	44	87	48	57	33	91	59	46	68	18	98	47	52	48	82	51	17	40	42	77	69	44	98	42	51	41	73	22	74	92	74	46	55	42	51	51	58	46	51	43	85	56	101	45	60	62	37	55	25	38	48	67	43	93	86	49	146	59	57	35	36	16	24	31	105	73	63	84	41	47	13	47	36	46	61	35	37	45	68	30	14	38	18	31	49	62	32	14	43	60	40	57	38	63	55	21	30	13	26	109	48	31	30	42	59	78	16	44	75	37	52	32	16	23	110	26	18	67	44	13	53	29	38	12	17	23	68	33	21	16	23	16	27	47	110	29	69	193	30	36	32	10	21	14	17	19	22	12	11	33	71	15	34	47	12	36	11	48	109	24	8	26	16	17	41	12	10	54	10	16	49	16	13	23	17	44	16	25	13	21	42	24	12	35	5	34	8	16	37	37	16	19	6	21	10	12	8	4	40	18	23	37	45	14	55	30	33	13	9	19	14	33	12	15	13	54	7	14	22	6	14	15	5	10	16	1	7	2	11	2	56	21	14	3	3	2	1	9	7	5	0	11	6	11	16	24	62	2	1	8	10	1	0	3	4	5	8	2	10	7	0	0	4	1	1	0
ne0265	6758	7291	4828	4706	3961	3015	3641	2666	3268	2243	2350	2113	2060	2271	2582	1812	2246	2088	2031	2073	2193	1888	2026	1572	1733	2617	1794	2153	2329	1950	1510	1774	1719	1427	1875	1882	1866	1349	1833	1903	1641	1668	2347	1565	1422	1385	1221	1675	1531	1578	1304	1505	1547	1201	2391	1313	1219	1403	1657	1452	1120	1318	1265	1445	1388	1443	1035	1529	1486	1367	1763	1227	1685	1139	1350	1340	1111	1055	1619	1330	1192	1450	828	1369	1119	968	1307	1424	1138	1449	1047	1251	799	1232	1222	1608	851	1168	1594	1141	1431	1079	1148	936	1121	1087	1031	862	1311	1776	1249	1208	822	781	774	1087	889	955	1263	703	965	857	946	1355	1185	1190	1029	853	850	756	948	935	922	911	1302	932	1779	1100	766	727	984	913	1134	733	882	985	883	883	959	987	987	887	917	1078	1019	1188	849	895	643	592	828	1012	962	1053	996	868	975	1140	946	1379	1228	848	934	899	582	1328	839	604	739	827	735	765	938	709	1106	1187	961	930	802	824	1093	865	1023	845	786	689	1453	602	1041	800	786	965	1036	989	1019	826	917	954	780	1103	532	884	1267	703	701	971	713	819	871	799	865	875	947	961	1023	958	836	1022	864	713	801	861	878	918	762	845	713	935	944	743	647	693	780	664	639	824	622	854	999	599	639	912	880	750	724	472	939	901	993	891	635	594	940	729	484	990	848	626	658	694	830	714	630	623	539	646	882	480	704	751	734	800	590	776	538	830	621	797	586	717	663	748	735	837	578	745	703	579	780	878	658	708	734	599	751	638	844	807	758	618	579	755	633	562	676	544	703	715	682	656	597	686	725	504	476	538	489	607	740	562	611	564	659	646	719	812	682	473	421	555	503	719	657	518	490	767	659	803	577	664	592	639	616	547	715	517	597	843	528	450	651	658	1215	483	633	584	595	737	608	647	706	497	504	502	584	708	502	798	604	616	432	597	687	430	387	579	423	609	515	625	566	452	512	814	387	460	500	496	762	423	586	513	502	588	421	437	562	427	474	543	575	533	647	501	734	519	546	445	539	450	494	446	450	625	449	503	528	559	457	457	541	490	699	458	374	454	301	724	328	615	481	327	474	637	676	475	349	566	523	507	464	357	440	499	492	375	601	524	343	462	422	780	461	431	490	352	492	326	382	381	258	441	366	464	432	341	568	391	561	577	377	397	489	549	386	445	392	550	298	323	422	563	393	254	393	409	384	443	356	338	360	348	519	1058	303	358	710	427	536	497	357	375	503	336	420	459	402	385	446	311	398	335	453	465	519	444	441	517	487	332	658	377	472	380	406	430	432	382	406	470	435	278	409	359	280	795	372	336	504	381	454	425	389	418	502	477	375	445	318	370	312	352	381	324	375	485	390	404	363	363	302	452	350	376	465	305	647	273	446	278	387	448	351	298	407	431	299	327	421	313	330	493	424	373	281	288	477	288	306	448	611	300	259	969	330	411	293	346	307	280	363	349	369	323	479	303	360	291	226	379	430	253	366	376	459	459	477	430	384	535	301	439	337	417	298	468	243	453	387	278	425	414	405	367	325	319	385	371	352	387	350	399	272	390	282	396	370	249	282	407	291	217	235	237	308	350	290	363	435	396	245	314	359	184	253	300	307	298	551	369	461	462	303	293	412	230	236	236	338	273	381	472	494	287	428	245	236	344	198	249	354	253	290	333	339	328	238	276	211	283	275	289	281	334	300	340	377	219	278	333	201	317	425	360	275	247	336	250	271	234	212	242	305	229	350	170	182	232	293	450	328	267	187	288	230	379	370	197	351	308	214	264	263	615	282	256	220	367	411	189	563	226	334	291	227	144	501	247	382	306	229	283	262	257	233	248	288	122	294	398	237	377	231	277	204	387	349	368	217	375	267	248	332	257	220	217	336	224	310	199	273	203	267	202	375	250	220	394	223	276	272	223	194	548	281	239	255	209	311	285	339	259	276	352	254	412	249	168	229	312	106	264	229	166	285	190	211	321	178	232	238	431	152	268	213	107	206	285	282	174	129	331	167	191	113	217	204	181	268	266	207	210	185	242	242	211	114	275	217	197	310	188	145	215	144	217	350	315	404	252	315	304	257	384	195	206	236	271	281	129	228	109	141	201	220	205	145	176	192	250	135	257	305	173	213	205	226	311	184	280	208	127	185	145	146	182	217	237	208	163	204	232	284	172	259	176	155	92	234	155	205	216	289	255	188	182	177	227	198	157	482	333	246	169	165	195	235	162	154	159	192	134	145	208	296	97	135	148	223	189	162	140	172	167	189	213	223	147	197	198	220	162	169	205	226	184	196	175	177	122	141	200	259	242	108	310	148	136	226	239	273	172	207	154	234	251	207	186	165	104	255	262	109	161	226	194	103	208	117	202	217	162	153	722	138	195	166	177	117	313	155	172	176	122	90	260	375	258	171	124	156	217	163	133	140	223	135	214	130	202	161	295	137	174	163	157	168	325	160	275	150	199	304	189	177	77	182	342	146	177	103	270	128	113	89	145	149	126	257	144	246	177	230	171	170	122	141	127	123	350	80	187	180	107	109	348	134	167	156	294	86	168	178	100	157	125	127	151	124	152	166	94	136	150	140	136	219	136	199	134	161	180	183	121	137	179	81	117	188	170	128	150	220	151	194	129	135	231	166	103	89	174	69	134	162	203	130	118	67	155	117	194	96	184	200	167	219	142	135	123	110	109	164	207	133	92	265	64	224	161	99	90	165	83	131	198	208	120	109	141	95	67	261	183	165	132	148	106	118	117	231	130	160	185	120	130	111	94	146	196	117	97	151	172	165	113	176	190	123	114	138	184	75	82	89	182	165	106	148	125	160	71	90	146	155	152	127	253	89	171	158	49	138	147	85	121	114	180	187	246	110	239	75	113	88	94	119	151	159	89	122	131	134	131	112	190	141	164	110	178	151	89	80	138	61	158	160	147	109	71	109	122	111	86	112	211	199	184	85	150	94	71	77	45	98	194	124	101	110	117	185	44	107	72	77	62	127	89	135	122	117	172	80	138	159	96	137	88	110	128	75	134	67	103	111	54	65	106	116	76	119	113	116	189	115	163	120	106	171	105	78	167	106	96	140	70	63	56	91	88	48	101	128	76	67	106	71	109	122	70	68	80	108	85	158	59	89	107	189	83	138	136	110	101	112	71	192	62	79	104	121	56	97	143	98	136	117	57	89	73	99	106	71	98	69	66	86	85	60	104	145	87	85	94	137	71	104	65	112	103	31	134	94	71	102	65	135	72	59	91	77	104	59	27	123	79	99	127	66	72	85	70	55	76	101	96	64	88	70	62	113	105	86	65	76	105	184	58	222	156	87	106	110	74	48	95	55	55	56	35	93	70	128	81	70	45	100	52	60	67	66	69	56	42	25	45	54	122	85	71	46	68	247	142	66	61	78	53	61	97	126	50	113	81	60	38	97	47	35	54	73	36	73	86	38	33	74	77	42	93	118	83	111	103	67	95	82	39	53	40	49	41	116	66	66	71	66	69	55	95	33	48	33	63	61	59	75	53	58	50	49	53	65	71	52	30	42	37	54	53	57	73	105	69	62	34	26	70	40	75	37	45	91	38	43	47	63	52	29	40	42	76	63	61	35	59	73	27	25	51	10	29	38	107	34	39	29	60	27	26	262	35	63	70	60	35	79	29	52	57	35	54	52	19	80	51	30	25	59	38	58	71	22	41	71	34	54	62	45	54	21	29	77	33	82	32	51	195	50	46	36	53	40	81	23	44	32	48	23	50	27	20	58	25	33	34	39	80	54	49	16	53	29	18	67	42	54	9	46	75	40	27	30	27	14	34	34	45	21	19	24	14	33	21	38	56	37	27	7	97	40	31	32	18	17	26	27	60	35	22	12	50	27	15	32	40	50	24	17	46	10	35	41	12	11	28	44	17	58	59	13	39	36	19	25	44	15	18	21	61	13	23	41	8	26	18	14	31	36	16	13	11	17	19	20	15	9	26	5	63	11	12	7	30	15	17	14	23	16	34	14	20	19	21	14	23	68	36	9	24	12	23	48	9	7	6	6	12	8	20	28	36	10	37	20	12	6	12	5	7	40	3	6	11	16	9	68	29	7	15	4	6	7	11	13	21	6	13	7	11	17	12	9	37	8	11	12	6	7	6	10	1	22	5	5	5	4	4	6	1	12	13	2	9	2	2	5	3	4	0	2	1	3	0	1	2	3	1	2	1	3	5	0	1	5	1	2	1
ne0266	3654	4324	2501	2483	2282	1776	2024	1593	1335	1330	1497	1471	1163	1297	1254	1177	1372	1384	1410	1112	1371	1077	1169	944	1008	844	969	1263	1224	900	826	1327	936	811	1090	1068	903	835	1182	1199	1051	906	1259	759	864	755	708	887	886	903	733	823	795	718	1122	783	837	817	1180	707	677	665	469	1089	703	1022	691	780	862	829	858	684	1190	922	992	803	704	737	1002	830	628	977	422	923	712	564	898	727	812	816	602	664	409	950	698	743	509	734	821	507	702	652	1196	707	660	568	612	442	613	1020	1219	815	431	515	453	1011	474	523	766	408	690	506	578	853	802	467	566	488	432	459	523	562	555	489	667	425	952	478	460	485	645	564	877	509	487	470	456	438	801	477	542	626	480	878	613	624	541	593	374	638	537	594	593	463	635	475	536	652	753	377	562	547	557	382	337	718	591	349	427	477	310	438	460	616	641	660	557	431	585	705	775	410	1083	461	498	409	871	319	682	382	458	493	522	567	523	433	571	550	460	606	305	450	647	367	533	450	502	480	477	520	370	390	523	578	441	473	481	552	659	467	430	544	555	739	531	337	370	435	563	568	400	306	384	320	517	467	332	373	499	376	300	487	546	491	462	258	430	450	556	582	411	336	554	394	287	512	499	398	511	412	338	371	446	347	429	633	561	373	411	548	620	413	353	353	267	437	397	531	339	427	413	341	340	498	289	611	322	437	389	379	451	339	434	310	551	275	449	356	553	339	332	458	333	291	439	426	454	279	311	331	373	387	371	269	261	315	318	329	378	386	564	267	358	195	262	469	335	263	281	290	327	445	384	433	242	579	504	298	313	451	284	414	376	310	374	273	271	450	267	365	304	361	250	321	352	323	393	495	349	491	910	370	315	410	272	289	430	361	218	331	250	361	358	236	242	284	319	346	265	293	343	291	378	398	189	276	304	308	462	219	331	348	249	309	220	437	277	333	241	320	311	395	345	297	356	462	335	272	274	554	503	279	308	293	343	386	251	295	348	348	233	244	355	259	256	359	152	322	269	273	218	152	364	303	320	213	219	444	322	299	216	147	365	299	344	203	409	340	192	331	223	428	237	217	347	191	263	265	262	396	151	261	181	268	206	225	300	197	231	628	226	212	233	289	217	330	333	292	173	222	269	286	292	158	250	245	315	288	213	166	161	224	253	233	162	219	434	356	264	238	295	145	271	335	220	190	224	227	318	173	218	315	275	293	261	197	224	279	273	212	325	151	220	248	152	295	291	235	252	257	351	174	204	268	219	439	259	189	265	283	397	328	285	209	254	256	303	222	373	228	216	151	433	186	217	261	262	219	223	271	151	384	241	170	221	142	338	122	285	134	210	196	247	234	295	195	308	183	216	130	205	534	251	224	145	170	244	200	178	248	254	259	130	171	178	215	150	189	269	151	190	186	251	231	209	159	185	162	151	245	198	133	230	164	246	264	247	230	152	246	225	170	194	192	178	257	152	243	254	237	238	141	172	220	200	247	192	204	173	209	193	439	218	190	147	178	236	110	157	225	148	178	195	134	164	256	224	229	154	239	142	142	170	92	165	134	316	210	148	169	187	201	172	168	130	149	147	127	247	230	225	244	166	191	239	169	202	180	392	135	143	198	172	168	228	171	89	206	132	143	214	208	109	172	233	172	251	172	403	137	116	170	174	195	185	462	166	152	142	150	107	159	212	111	140	85	117	234	156	245	175	162	84	106	177	207	281	159	185	280	85	133	243	311	183	140	117	182	186	124	228	149	164	143	181	122	300	96	267	191	125	214	104	152	122	171	210	86	200	142	89	192	149	210	149	162	479	197	160	115	208	158	167	203	121	140	221	95	130	105	92	198	232	141	143	176	135	141	149	167	63	96	130	137	141	92	172	134	150	86	160	160	126	243	212	158	139	73	185	163	68	166	102	442	152	132	117	184	110	118	198	190	72	123	125	57	136	193	150	114	79	398	134	138	98	142	135	102	160	183	145	141	120	176	252	146	125	152	148	116	92	125	121	91	58	147	185	131	164	177	164	173	162	99	133	85	85	141	172	81	164	106	86	113	138	112	85	99	129	168	131	148	158	103	130	207	79	181	274	168	194	88	83	119	74	136	83	113	101	153	94	84	145	151	122	96	121	58	117	78	103	138	226	151	136	69	91	63	107	75	213	88	62	97	101	91	140	84	99	94	116	68	70	166	128	46	79	122	113	123	69	84	107	147	124	114	100	108	129	56	131	92	62	160	174	101	77	96	100	64	83	147	153	133	118	146	125	120	93	113	236	60	159	101	147	170	111	125	98	61	217	157	75	71	109	104	88	175	143	152	111	81	121	63	68	126	164	110	114	88	70	163	104	58	98	170	236	124	104	83	111	115	89	75	144	138	95	37	74	118	65	99	87	356	155	64	105	90	117	129	112	77	98	75	91	62	140	71	63	110	73	119	56	71	62	50	76	122	165	94	166	74	60	57	89	89	91	74	66	177	47	71	132	82	83	126	147	86	88	65	24	85	102	71	57	72	77	59	58	87	126	95	52	73	108	77	89	82	131	71	103	97	109	48	104	81	68	40	46	145	52	102	134	79	43	60	79	133	98	69	95	124	43	119	81	97	103	69	66	82	52	46	65	79	89	100	150	100	107	70	73	22	98	93	72	66	176	65	120	69	71	41	67	103	81	80	64	127	84	69	110	64	132	91	98	59	72	66	35	133	59	100	62	75	71	139	54	53	95	106	68	59	88	59	55	59	66	61	64	63	81	84	35	52	77	107	97	88	124	103	100	52	39	131	63	103	128	124	54	88	44	34	73	140	61	102	52	49	104	66	64	116	61	58	87	95	37	48	98	46	67	104	95	83	78	123	37	69	110	103	75	62	38	56	62	59	100	54	83	74	74	73	116	87	50	75	95	88	36	98	54	52	35	13	57	67	79	42	62	73	127	22	97	43	42	43	48	123	103	87	95	120	40	33	57	52	43	42	93	74	111	38	45	74	86	94	39	89	68	55	40	104	48	96	94	110	88	55	71	45	37	116	37	71	82	48	51	45	29	49	50	39	52	24	34	72	56	131	84	26	14	56	62	48	43	48	81	57	54	71	54	72	40	58	43	46	150	47	47	81	54	29	47	62	34	74	52	29	65	40	49	67	36	55	37	52	60	46	56	56	41	25	30	29	99	44	79	37	43	71	318	78	58	60	41	18	56	39	35	77	27	27	20	21	61	48	65	72	51	40	58	44	24	46	35	28	107	39	32	65	49	62	71	58	36	73	24	24	61	57	61	69	56	39	35	83	83	13	68	15	45	64	116	61	70	51	39	44	11	52	5	54	38	51	9	31	78	73	29	102	40	50	242	85	19	41	56	11	43	53	81	34	58	44	33	7	36	62	13	29	52	12	321	39	22	20	44	31	21	36	61	37	69	36	31	48	41	25	28	77	44	25	58	30	31	36	36	93	30	63	18	29	11	21	21	41	30	22	36	17	22	22	35	35	52	27	25	27	18	20	38	25	73	61	22	17	58	15	38	48	24	18	16	54	22	58	23	44	22	13	12	56	34	33	12	31	38	15	13	35	17	12	20	45	15	13	10	22	14	19	20	22	32	33	21	19	33	14	24	17	48	42	37	12	46	6	14	40	54	12	38	98	13	26	29	13	49	66	39	17	39	30	48	22	57	33	23	53	36	19	17	24	17	30	29	49	17	47	38	30	18	9	17	15	17	19	23	33	54	40	23	4	10	18	12	7	26	8	17	14	39	12	14	8	7	34	51	29	12	13	62	8	10	24	21	19	12	6	10	15	16	35	21	13	17	13	25	2	12	9	12	50	16	6	7	26	21	18	28	18	7	3	27	19	5	11	10	13	154	15	9	14	15	18	14	52	13	2	8	53	12	8	9	2	18	1	5	23	20	4	4	26	21	13	31	12	13	5	0	19	11	3	14	16	11	7	9	6	38	5	9	14	7	11	8	2	214	13	10	16	11	5	46	8	2	5	10	13	14	14	3	45	56	23	5	19	5	4	2	1	8	8	1	8	1	3	47	4	3	3	4	4	1	5	8	0	3	9	1	10	169	1	9	8	6	4	8	2	2	5	9	14	1	3	0	2	1	0	11	1	12	6	5	9	1	1	3	0	14	0	1	2	2	0	3	3	2	0	7	1	0	0	0	2	1	0	0	0
ne0267	3537	4259	2671	2995	2272	1687	1989	1641	1298	1101	1192	1144	1072	1097	1128	1111	1066	1097	1325	1030	1005	1290	1127	1042	984	906	764	989	1356	726	835	884	816	729	1167	832	872	705	1002	904	820	787	1136	802	1053	853	774	752	718	859	754	798	1031	898	1379	497	628	610	818	987	585	692	631	818	676	821	598	700	732	532	930	628	900	596	668	401	577	593	790	997	615	779	712	950	576	561	867	651	654	642	693	578	651	576	744	673	506	758	760	614	571	734	736	686	617	505	537	446	859	928	766	606	406	557	462	645	467	336	637	485	549	546	471	547	615	503	513	745	443	463	495	407	566	518	624	435	824	544	505	445	548	400	949	427	470	365	399	511	489	437	557	486	317	484	574	609	377	523	449	487	435	674	499	370	545	471	526	414	549	565	621	545	584	351	345	850	334	386	646	439	496	457	564	424	747	539	675	400	468	508	680	362	863	453	385	477	575	355	430	381	425	588	869	489	566	323	745	417	346	425	348	381	680	269	540	304	398	411	380	377	300	600	374	387	351	326	392	427	520	478	434	408	676	581	337	381	431	390	407	382	331	339	482	493	342	308	248	412	571	409	297	447	475	454	362	299	354	495	523	664	489	303	577	317	314	528	431	374	386	380	348	366	365	323	353	431	652	373	420	342	480	441	331	418	278	627	344	476	387	343	267	330	336	550	582	460	425	310	318	328	396	403	396	250	354	443	342	232	354	264	350	343	247	372	410	305	324	331	338	350	298	246	356	331	252	411	239	462	378	230	415	245	260	443	349	327	251	229	287	279	398	300	356	314	147	384	313	327	269	417	310	409	294	302	419	230	408	460	352	343	294	423	668	281	379	347	351	428	380	359	340	261	237	326	210	482	243	362	232	313	359	298	298	205	209	331	198	307	237	286	319	499	381	465	235	181	286	352	425	247	270	266	276	269	252	273	320	354	199	203	222	315	279	241	563	281	272	290	202	454	301	464	279	285	235	270	345	268	286	233	394	279	406	231	151	291	178	305	253	199	182	184	242	279	378	237	266	307	229	302	230	232	269	283	197	251	364	252	295	235	293	294	375	292	287	269	187	202	203	325	1099	202	222	315	345	260	268	236	274	501	218	213	234	241	302	315	214	257	208	159	257	349	274	172	219	187	174	337	181	112	232	182	263	888	221	154	291	268	224	217	198	218	229	216	193	137	215	235	274	161	154	224	166	284	346	277	315	280	220	261	358	197	174	178	278	203	277	224	196	193	265	147	201	230	227	441	261	184	157	222	316	273	276	269	179	157	223	186	255	170	207	203	225	215	221	318	197	242	282	177	210	243	271	160	232	199	268	167	256	150	129	222	194	194	314	249	175	171	211	137	235	260	151	212	146	247	176	213	152	237	182	134	164	288	141	115	175	146	116	410	168	144	154	250	219	189	231	130	160	139	210	129	191	133	314	294	273	194	133	233	235	347	193	198	140	143	143	188	257	148	228	399	117	165	179	126	126	206	180	207	166	308	157	153	132	242	286	226	176	306	201	153	113	154	163	230	163	193	224	224	221	155	198	168	137	168	183	131	288	130	165	173	143	152	175	149	151	151	108	115	176	253	108	130	280	107	215	101	110	121	156	101	165	177	203	213	157	167	207	134	135	168	121	166	160	167	222	142	148	192	159	154	164	104	129	107	104	124	115	81	113	98	190	141	188	275	81	133	134	197	199	122	128	144	133	205	236	140	175	174	123	117	152	383	115	141	111	179	186	74	225	121	153	147	92	278	197	130	128	130	164	299	97	125	125	110	159	45	167	116	100	211	86	158	91	125	198	190	107	139	155	149	255	143	72	134	174	135	131	131	78	145	160	151	135	226	119	135	161	139	91	124	195	168	131	132	172	88	122	119	190	109	148	122	173	95	169	70	130	209	91	134	162	116	132	88	106	174	133	151	152	154	149	120	108	52	215	192	88	99	65	163	169	112	84	107	118	92	83	107	95	108	113	114	167	132	69	176	144	93	115	89	188	81	96	139	231	199	135	127	207	128	131	127	124	70	90	123	181	108	111	98	56	80	126	94	64	124	128	133	56	117	142	66	97	111	101	200	128	207	82	79	64	96	124	303	121	139	80	122	102	105	121	195	116	57	70	110	122	100	140	117	213	146	79	99	95	83	109	83	173	92	77	96	95	92	124	64	92	83	94	76	75	113	152	71	101	110	135	210	94	125	74	150	85	89	112	97	88	90	105	116	56	82	97	96	76	76	123	134	85	110	154	162	47	101	83	68	143	177	251	87	102	73	125	153	88	86	107	103	153	124	109	88	73	71	48	121	85	144	138	102	62	174	114	78	149	88	51	81	106	112	101	94	61	124	145	81	95	69	90	86	103	55	114	127	72	78	65	127	64	99	68	114	123	101	119	170	103	118	108	67	104	92	75	41	102	65	83	76	49	128	34	72	55	51	121	43	148	53	193	51	81	80	106	74	81	59	56	176	60	345	126	72	55	120	145	102	85	74	43	64	60	76	80	42	118	57	59	101	79	107	68	75	67	64	83	54	136	84	149	79	175	61	95	75	44	57	85	105	69	126	138	86	68	67	97	93	99	53	57	94	49	115	83	109	61	59	48	76	79	98	91	70	67	86	77	103	52	54	51	64	115	67	74	87	159	50	172	48	62	121	118	58	72	58	81	85	76	86	81	51	101	83	69	93	80	65	57	87	48	85	56	116	52	103	56	240	243	104	85	105	48	49	69	62	79	49	59	70	76	52	50	70	40	200	90	59	100	88	72	31	62	110	41	93	73	160	35	67	66	57	61	164	53	58	42	57	74	66	56	130	42	31	27	43	51	120	80	112	52	99	63	56	60	107	84	80	50	94	71	60	43	59	77	53	86	65	63	96	47	47	55	56	39	149	165	123	57	80	40	76	46	20	90	59	41	45	69	72	73	42	49	31	50	230	32	65	66	66	63	40	31	181	72	144	60	28	48	90	54	78	21	61	89	88	33	38	84	45	33	34	109	105	73	59	40	48	49	73	37	78	42	71	54	63	93	19	76	39	40	39	46	38	46	37	59	52	68	79	233	57	56	58	65	40	66	59	73	65	59	100	115	31	75	47	89	38	28	37	40	31	58	72	25	109	59	25	23	25	44	50	91	29	27	24	48	57	32	54	57	50	26	52	65	51	40	30	48	48	39	124	55	45	67	32	79	36	61	81	34	50	24	31	77	22	47	36	37	59	26	23	19	36	27	59	56	47	45	58	30	45	116	71	30	76	73	78	32	104	33	47	75	52	32	28	45	49	96	22	16	23	67	38	42	19	50	45	165	28	48	37	32	97	25	55	30	66	58	39	38	40	127	89	31	36	52	29	31	33	85	48	50	36	26	62	58	24	51	61	41	25	34	37	21	20	32	50	23	23	58	31	44	100	28	68	22	29	36	14	33	48	69	22	31	40	17	66	47	51	47	45	12	63	33	38	20	25	36	17	33	21	29	21	35	21	17	24	14	29	17	58	50	22	34	306	34	32	28	89	17	17	14	16	6	31	49	14	26	20	28	52	43	43	18	25	23	15	21	20	33	27	37	44	19	30	29	37	18	22	37	3	29	47	14	22	16	16	21	30	12	25	36	9	43	8	22	8	32	14	45	54	37	39	32	15	60	21	19	27	18	9	60	28	34	42	484	9	25	18	14	25	24	52	13	65	27	37	18	12	9	7	21	11	23	12	35	25	24	37	19	142	31	23	28	20	32	10	70	60	20	7	9	11	8	8	15	47	10	8	17	33	11	10	18	11	7	17	17	7	26	29	19	12	11	13	27	144	17	16	65	41	6	8	19	21	36	17	12	23	16	5	27	4	10	28	69	12	44	20	20	11	7	17	9	16	56	96	29	28	21	20	5	8	15	44	11	11	15	7	7	4	54	19	13	15	7	3	37	24	27	8	12	6	9	15	24	5	13	27	3	11	14	5	14	10	12	26	27	14	3	12	19	4	5	24	6	12	45	10	39	81	6	25	10	7	8	4	2	7	20	6	11	6	25	5	32	18	17	90	3	4	1	2	2	18	18	31	14	2	15	13	12	24	3	8	14	3	6	0	3	11	10	8	11	2	3	1	8	49	11	4	2	16	5	9	2	2	1	1	1	3	0	0	0	2	0	0	24	2	7	1	1	1	8	2	0	0
ne0269	4844	5597	3286	3477	2278	2331	2603	2092	2074	1804	1795	1553	1267	1439	1450	1550	1741	1808	1625	1459	1418	1641	1353	1698	1212	1327	871	1332	1781	897	1171	1293	1032	1111	1158	1098	1147	1014	1185	1177	1213	1281	2092	1053	1409	944	1071	975	940	1235	1035	1105	893	1202	1899	784	1149	1030	1115	884	1040	1771	1337	1380	978	1028	928	1334	1073	766	1203	783	1133	1045	989	714	914	858	916	1042	935	913	807	1075	842	717	1264	810	750	778	1008	745	869	827	876	1012	855	909	1141	947	719	1039	959	989	885	686	776	615	1028	1501	1049	778	551	701	612	711	679	520	2586	624	869	762	671	680	683	848	688	948	630	644	768	608	920	758	732	871	825	927	693	759	829	582	1230	650	545	505	545	1025	744	607	887	707	483	667	811	1058	610	772	567	597	606	664	658	442	786	639	574	680	1769	741	866	839	872	386	451	868	500	518	815	625	742	595	550	635	526	1414	661	583	564	674	961	520	895	570	471	580	1041	451	655	580	629	491	1026	670	1009	507	1138	564	596	499	457	445	612	402	599	468	525	587	481	619	458	754	566	559	477	436	605	494	689	752	776	481	654	943	513	507	755	506	548	648	421	382	550	568	685	393	354	550	715	630	293	501	674	728	515	398	489	477	564	746	592	386	732	445	467	673	582	517	522	448	445	444	552	355	461	738	588	498	402	527	641	563	363	832	607	1601	444	657	585	524	340	356	386	562	609	599	582	488	598	418	512	462	549	398	528	619	381	342	595	407	383	515	269	431	524	537	396	329	461	450	334	379	441	507	337	484	341	543	537	351	531	358	355	809	488	411	295	287	509	336	398	372	409	431	334	524	424	368	422	537	394	587	486	558	563	300	374	541	728	361	361	443	886	457	586	389	543	606	479	414	506	387	335	454	276	893	597	439	312	369	530	373	413	276	205	385	333	377	262	314	456	455	603	775	299	272	395	491	1419	323	353	266	285	415	258	404	549	304	279	262	333	395	370	346	430	433	293	363	233	492	420	855	453	355	343	230	372	373	472	301	490	360	498	257	251	371	237	434	370	268	288	389	342	460	504	300	351	463	220	501	296	434	409	282	267	208	438	326	551	425	365	719	602	386	406	373	283	314	262	415	378	326	255	421	389	294	332	468	399	949	260	365	291	612	430	625	421	458	271	188	367	432	336	226	264	224	257	557	164	187	220	341	307	955	235	262	353	341	345	311	338	326	324	284	217	167	282	240	379	195	207	302	203	275	390	327	539	447	263	369	406	144	252	244	309	240	292	315	191	269	373	589	313	362	573	467	300	285	197	381	655	256	406	373	238	171	263	309	215	215	243	317	276	370	303	390	268	283	655	217	209	423	265	254	283	219	605	208	336	233	194	228	243	288	313	328	342	227	216	167	283	308	283	251	250	241	266	294	231	328	246	314	268	342	187	177	190	195	405	341	246	97	210	327	215	167	291	168	189	182	609	175	222	143	337	365	550	276	156	301	272	626	282	181	163	255	187	215	396	204	339	437	146	238	219	226	135	244	168	265	208	446	189	213	203	276	349	259	137	423	278	352	160	163	243	423	227	281	260	309	204	285	198	213	170	379	197	149	456	172	195	179	373	203	185	197	232	207	130	181	231	301	137	173	677	152	298	125	184	258	184	153	235	236	238	289	135	230	322	150	222	227	153	189	260	162	258	183	150	203	198	247	298	139	151	140	147	135	151	195	173	167	294	220	157	264	147	415	202	165	189	212	108	246	284	322	426	118	217	270	216	142	221	331	197	191	132	195	503	236	190	182	196	230	139	382	352	139	130	194	464	231	151	221	177	147	365	164	337	138	84	232	123	282	124	216	304	240	159	180	221	227	185	175	132	152	244	184	225	179	111	155	213	143	242	260	162	209	288	270	112	165	318	242	248	132	192	122	167	115	197	172	222	107	237	129	290	98	149	276	169	137	160	183	170	90	138	211	204	195	188	175	163	138	121	83	266	203	115	141	118	189	212	116	169	127	168	136	135	139	92	181	121	153	205	141	101	198	204	127	181	106	206	129	194	260	231	226	187	155	228	151	142	133	93	107	67	96	565	158	144	112	99	96	136	151	116	274	196	170	105	166	182	75	128	128	157	223	157	254	90	126	80	111	184	121	111	164	115	100	109	116	284	284	267	110	135	74	123	124	205	142	213	184	105	232	176	137	184	87	460	145	123	215	125	81	211	175	119	73	117	156	112	124	260	47	211	114	163	384	119	125	96	150	89	161	154	101	156	78	112	107	70	104	114	73	81	143	108	113	181	268	178	237	165	148	133	116	181	168	252	195	198	172	188	307	124	148	189	68	263	184	172	131	131	83	79	160	156	161	205	153	100	205	156	111	117	97	94	97	81	122	164	96	100	178	202	107	136	112	143	126	124	64	156	153	109	73	57	142	129	120	69	152	215	199	171	181	176	152	477	107	127	96	55	132	133	74	101	102	60	208	68	117	54	62	142	113	192	106	300	67	139	112	120	70	81	105	109	139	75	168	159	186	114	177	463	211	76	101	59	143	105	81	95	83	214	127	44	102	96	203	115	89	85	72	104	88	143	135	120	89	384	59	133	115	71	69	57	139	73	124	161	69	73	71	87	155	131	57	104	111	74	247	127	147	121	83	53	85	61	59	130	184	101	114	108	142	112	67	92	55	139	132	102	91	164	91	87	73	147	184	77	92	74	78	91	63	164	115	174	84	129	110	76	154	68	88	123	126	113	91	82	480	78	220	106	118	79	186	99	104	60	83	89	70	107	71	49	89	83	75	69	160	99	428	114	73	434	88	134	55	108	119	67	97	102	524	66	114	69	76	87	194	124	95	72	60	66	71	66	96	45	72	63	47	61	115	100	162	60	156	108	73	132	154	79	109	93	444	85	99	41	74	131	53	88	85	69	64	117	107	66	116	71	109	145	112	57	78	63	76	61	41	112	146	59	51	35	62	317	53	112	27	37	175	65	110	59	86	108	60	60	82	80	128	126	34	79	131	58	59	68	60	81	135	47	59	114	68	36	53	77	109	66	98	47	94	48	91	57	100	76	122	63	67	60	37	25	32	70	65	62	51	97	47	66	151	224	52	133	144	106	25	80	65	134	79	90	80	49	75	246	41	62	225	85	88	36	59	62	46	62	408	33	66	99	48	49	38	56	58	55	51	130	79	47	62	58	49	37	92	28	91	104	44	89	53	34	38	54	78	70	60	47	46	407	61	59	124	71	41	45	30	93	46	82	69	52	34	38	36	71	55	42	59	45	48	50	120	47	77	109	53	41	56	41	43	27	66	74	78	131	77	37	42	62	36	219	68	76	28	125	120	55	64	61	45	60	66	30	34	55	64	31	49	41	66	94	96	353	45	149	141	28	83	75	31	73	55	59	36	61	38	25	31	174	29	86	50	63	20	36	67	42	24	53	71	38	32	74	44	38	307	80	36	80	71	25	30	32	46	73	54	26	42	18	51	63	82	38	28	17	29	61	44	21	45	27	48	78	50	22	33	51	20	36	41	12	51	35	17	74	76	62	162	63	28	55	37	32	27	44	25	23	43	52	33	37	48	48	40	63	53	53	33	49	20	49	42	28	130	52	56	32	29	13	45	19	38	18	17	60	38	48	23	25	25	32	40	29	37	37	20	58	25	39	14	34	7	55	50	57	29	33	47	31	40	27	25	51	14	126	52	89	54	71	12	75	14	14	29	30	64	21	72	23	48	95	28	9	23	23	25	27	34	127	46	41	46	156	373	15	45	29	41	63	28	18	102	14	10	10	29	12	23	28	46	10	12	21	73	39	60	16	13	14	12	11	2	25	32	31	11	20	13	25	92	10	32	61	27	16	18	27	18	65	22	42	51	32	6	11	14	48	21	102	18	8	20	23	18	14	33	27	142	16	129	123	83	13	22	2	17	16	24	9	16	6	10	9	11	64	14	141	19	16	5	12	29	30	7	11	5	11	10	21	13	8	24	3	8	44	10	3	7	24	28	23	24	5	22	38	37	10	24	16	50	15	132	11	35	8	10	11	15	6	8	3	8	18	9	9	54	110	11	29	23	25	44	9	8	12	6	2	6	5	31	5	1	13	2	11	19	2	12	13	7	13	2	9	13	47	40	85	3	0	0	4	1	9	1	15	1	1	28	22	1	22	1	3	5	3	0	5	3	0	6	7	1	45	4	24	1	0	0	1	0
ne0270	2829	3367	2126	2158	1262	1245	1418	1187	1171	1083	952	811	851	841	911	853	886	1114	867	808	836	940	754	692	838	689	616	791	1119	654	671	745	700	652	717	654	734	630	902	728	807	746	1524	711	822	540	565	615	553	655	506	616	479	639	1157	439	825	527	807	523	531	837	811	871	608	737	514	731	591	486	597	509	743	609	430	386	541	585	753	739	568	638	421	573	462	370	899	566	526	521	516	410	546	535	604	494	455	519	637	495	488	583	547	561	512	468	467	324	538	850	610	458	285	361	305	360	343	370	1025	291	466	470	387	435	398	497	505	612	331	351	470	285	580	380	468	515	874	562	391	584	520	408	679	470	300	343	355	615	524	341	560	381	299	383	466	691	333	469	285	261	420	408	440	330	483	364	388	461	673	375	484	614	517	276	248	533	274	290	456	345	395	331	303	361	341	518	416	357	403	419	531	304	547	389	349	303	567	235	439	343	305	391	689	388	621	310	721	372	315	347	269	438	634	178	252	414	335	351	320	346	307	543	322	336	374	333	312	281	379	485	405	304	538	557	336	309	435	338	294	370	280	169	378	492	478	243	231	364	530	278	211	431	444	463	225	206	280	462	388	540	346	252	440	276	260	354	413	295	344	254	255	255	279	253	267	358	328	278	296	277	359	394	194	508	289	871	358	480	332	320	234	342	191	372	408	333	273	288	403	253	301	269	303	233	337	275	336	311	361	259	195	254	171	319	269	318	270	321	315	252	220	240	311	385	269	186	196	296	346	211	405	187	240	438	313	270	229	178	251	227	240	246	209	227	165	329	239	293	269	317	235	359	227	278	377	181	307	453	466	226	282	234	280	279	362	231	325	298	291	278	230	171	255	279	181	441	320	296	260	210	237	245	219	180	334	230	233	209	186	265	325	253	321	485	194	158	219	342	752	207	212	224	161	253	156	247	374	171	160	169	216	184	285	220	434	268	173	242	185	305	208	424	217	239	203	180	243	206	315	253	227	194	283	212	179	252	172	267	234	168	158	173	246	334	275	197	188	309	152	272	267	254	252	205	181	133	256	231	233	175	234	511	267	163	195	171	215	148	159	271	173	173	137	361	235	144	226	178	168	520	145	239	137	320	229	321	216	242	91	164	241	280	148	115	228	132	211	391	159	74	119	218	171	391	69	186	201	210	180	187	198	172	232	158	124	106	210	261	243	137	140	205	124	116	235	312	316	235	183	156	251	130	164	186	337	155	181	179	108	236	206	414	125	242	269	413	324	131	125	253	381	241	240	293	161	124	170	205	195	123	186	198	192	246	162	217	129	238	398	172	171	264	114	188	200	82	388	142	161	161	124	122	121	171	221	197	180	173	99	83	167	196	132	144	122	127	138	183	87	178	139	162	132	220	103	97	241	72	215	298	141	68	155	199	178	112	131	100	97	105	282	90	127	103	374	233	331	183	111	236	164	274	187	136	106	151	93	141	160	179	281	170	116	153	119	121	54	208	114	204	121	305	144	117	109	197	224	110	123	226	118	198	92	86	155	240	154	151	206	214	103	161	135	52	113	206	188	110	256	115	93	162	194	106	122	151	121	164	95	87	165	172	119	94	326	94	173	88	114	131	117	102	190	98	170	181	190	289	175	89	100	170	109	98	147	127	127	126	95	117	103	98	179	77	146	78	107	102	91	110	123	59	121	73	142	91	68	265	150	177	120	196	87	129	154	205	312	84	103	134	97	83	115	319	93	139	85	95	289	97	225	97	133	115	91	139	336	55	67	120	372	177	52	129	53	108	161	74	194	108	74	132	57	215	92	65	259	122	79	146	102	100	179	105	67	105	171	170	158	84	93	130	224	86	112	198	107	131	109	191	89	102	127	120	50	105	145	86	84	85	198	119	146	46	171	67	144	47	108	133	57	127	122	99	71	65	93	156	197	92	161	123	50	99	61	39	167	136	96	59	43	114	92	64	111	82	204	90	60	92	63	156	75	94	121	78	81	179	111	63	117	113	78	77	75	77	145	151	83	142	132	100	141	96	73	67	101	58	296	111	109	69	53	75	107	77	73	96	96	103	53	71	108	44	75	121	90	168	84	176	34	72	104	116	114	63	60	83	74	57	53	97	155	222	97	70	84	58	81	61	86	116	153	77	60	107	156	82	94	80	202	100	65	140	27	49	94	46	52	55	81	63	22	112	154	36	80	190	78	210	58	56	72	86	101	83	108	77	79	46	102	57	83	55	75	61	54	66	71	206	132	137	116	146	58	100	112	49	176	122	150	105	112	126	92	154	63	97	79	46	175	138	82	44	76	88	36	102	62	133	136	79	61	99	72	75	66	57	61	65	51	77	88	98	65	84	107	60	94	92	52	63	104	60	71	123	82	51	30	96	74	98	71	39	96	81	97	141	105	111	384	58	66	35	42	57	86	60	49	76	43	110	41	38	19	34	75	79	170	79	163	40	111	49	73	57	63	67	23	115	47	41	138	102	55	120	365	126	69	78	62	93	61	61	62	48	105	53	43	31	76	107	67	74	56	63	79	87	93	84	125	53	240	51	94	69	71	39	17	78	49	110	110	63	59	43	58	68	145	18	70	66	45	138	70	60	68	40	40	60	57	55	38	105	52	54	93	53	56	19	72	64	78	48	41	59	110	44	132	47	81	76	64	45	47	66	70	31	36	65	67	41	53	49	75	121	42	49	55	61	63	73	60	200	27	88	53	62	41	128	43	49	47	55	59	49	98	60	37	57	63	49	52	32	17	258	62	35	304	66	55	31	56	63	52	82	38	252	19	61	69	24	56	113	40	47	31	38	38	59	41	94	19	25	43	26	55	43	79	77	72	94	61	66	102	101	43	55	78	209	48	44	45	44	64	74	61	55	46	64	60	33	42	137	35	44	90	85	34	41	64	69	44	17	65	67	39	40	17	52	187	33	86	29	29	58	36	41	31	56	52	21	20	47	81	55	52	16	49	74	37	31	27	40	54	66	24	27	37	36	20	18	55	82	43	50	28	58	37	46	22	71	21	58	44	43	16	48	10	21	61	33	47	38	96	34	79	77	68	98	69	155	69	14	45	33	64	34	44	27	34	35	141	55	51	45	37	46	23	13	28	18	39	186	32	64	40	21	19	32	39	40	28	31	53	54	27	31	71	25	36	29	28	25	63	38	61	22	38	41	17	108	29	90	22	22	206	47	23	56	41	42	15	24	26	15	46	35	40	34	33	22	27	19	22	38	50	52	45	97	24	41	38	74	30	63	44	25	13	32	47	35	40	67	34	32	45	13	55	47	50	11	80	100	30	43	21	34	43	7	13	22	64	28	8	21	25	70	95	46	203	17	71	77	24	53	28	32	48	42	56	30	33	24	32	155	52	7	47	46	32	6	16	20	23	15	45	19	13	24	23	30	23	272	21	38	29	29	15	7	28	7	29	29	6	32	10	40	23	58	158	23	18	25	43	34	45	26	25	34	33	31	20	27	73	10	17	18	18	24	16	21	38	63	25	24	43	14	16	61	18	12	33	12	18	16	20	29	12	10	56	28	45	41	25	29	76	3	24	20	25	27	25	44	22	10	22	25	13	26	17	16	28	26	14	13	15	11	20	27	21	27	13	5	45	3	16	6	56	2	38	34	18	16	17	9	25	23	6	34	11	22	61	93	24	2	21	16	28	9	26	8	22	26	12	28	9	27	53	13	6	28	10	14	25	31	53	24	50	43	184	109	20	15	10	19	21	7	7	19	14	10	6	11	7	2	18	26	8	7	7	34	14	24	23	14	6	3	4	3	13	7	32	2	12	9	13	130	17	6	9	24	5	10	13	6	34	28	11	14	23	9	10	8	17	8	17	12	7	19	10	5	1	16	7	83	3	34	14	37	17	16	5	11	22	18	8	14	1	2	2	6	7	11	32	7	8	2	15	29	19	7	12	4	8	16	11	24	12	5	4	3	9	7	4	0	15	7	13	14	3	8	13	28	3	20	4	44	7	45	12	4	2	1	9	8	4	4	1	2	8	8	4	14	9	5	18	9	12	6	11	5	1	1	0	1	8	7	2	3	20	2	6	16	1	8	16	4	11	0	3	12	19	3	6	1	1	0	6	4	15	0	10	3	1	28	8	0	2	0	1	1	2	1	0	3	1	7	1	0	5	2	1	0	2	0	0	0
ne0272	1743	1459	835	1014	632	843	861	709	827	725	620	634	711	544	721	538	556	467	511	497	681	517	419	505	473	550	522	461	505	586	455	403	360	411	418	353	396	452	380	613	303	369	390	377	317	437	335	379	402	364	393	337	267	341	337	415	401	335	292	290	376	282	303	388	263	364	359	311	356	308	308	322	262	458	347	496	346	367	288	282	346	278	297	254	360	283	281	316	232	274	245	263	289	418	220	251	274	259	251	287	364	282	230	279	270	233	216	337	242	240	210	247	289	316	263	189	298	286	217	260	287	265	253	207	248	295	176	232	262	253	262	251	207	200	295	286	217	197	249	192	301	269	243	177	221	389	295	262	251	242	240	158	342	183	214	203	237	222	248	268	230	232	223	345	207	202	188	310	198	196	243	195	230	359	232	224	224	216	241	165	234	232	186	264	161	168	147	207	205	228	198	228	160	187	184	218	164	235	304	284	134	152	171	198	137	203	147	147	207	197	224	226	173	174	162	249	158	244	219	236	298	168	187	192	276	164	233	187	160	151	247	153	191	146	228	129	159	251	227	146	214	169	192	211	223	145	277	145	135	147	137	128	158	159	153	190	89	183	156	188	161	131	203	183	151	190	121	207	168	138	122	149	170	143	197	131	162	211	156	171	118	159	141	129	148	147	193	173	110	158	200	162	208	181	148	115	197	207	152	149	186	199	133	144	143	128	185	182	200	185	273	130	237	157	122	220	140	200	127	169	156	139	130	165	226	181	131	140	153	183	123	176	147	105	157	132	181	222	173	129	128	166	146	179	151	117	129	199	144	130	128	139	174	138	111	251	156	130	129	88	115	107	138	150	140	99	141	98	144	118	101	133	103	151	133	90	182	165	151	103	95	123	120	149	167	156	112	172	110	136	131	145	136	155	108	93	130	86	83	128	115	203	130	116	157	135	95	105	221	201	148	113	113	121	109	150	97	156	132	147	147	105	119	162	121	318	136	135	119	111	103	113	74	137	116	118	93	74	110	127	138	182	116	56	129	88	135	189	104	107	129	92	97	92	145	115	100	121	99	120	112	95	90	96	90	110	157	111	128	85	88	117	121	87	130	89	101	133	96	76	139	148	100	110	91	97	128	83	112	111	92	98	116	121	144	86	99	96	85	114	67	102	122	114	98	121	82	86	108	92	91	99	113	68	67	113	73	147	73	90	75	118	146	57	97	63	93	121	105	106	125	161	139	76	87	83	64	111	92	108	100	90	147	101	93	105	70	146	102	105	66	143	107	65	105	120	117	111	65	71	106	113	107	62	111	89	70	86	93	90	74	146	121	90	66	120	58	92	85	79	145	64	64	117	102	121	74	84	127	81	94	87	72	132	92	78	116	52	92	95	89	92	82	111	67	90	71	68	93	57	86	94	126	91	90	75	105	55	89	119	75	126	75	134	77	75	96	61	120	77	99	62	75	67	80	125	107	65	82	103	74	58	82	109	77	106	71	66	124	92	67	67	76	72	57	85	74	87	84	80	112	86	89	65	66	84	77	54	59	81	88	113	123	94	67	132	65	71	81	109	61	102	68	57	118	103	112	66	193	77	90	78	88	88	61	99	87	62	87	63	99	93	58	56	78	55	60	77	53	111	66	104	68	45	83	76	78	81	59	50	70	69	85	107	87	59	60	71	38	86	101	87	43	81	76	102	61	61	65	78	94	81	39	85	93	62	33	81	65	38	102	47	73	63	95	49	92	60	53	85	48	96	48	82	71	65	92	91	55	65	50	83	81	84	61	69	75	95	61	66	84	61	66	60	57	67	29	74	69	55	66	61	87	56	64	68	79	67	61	67	86	67	63	64	66	55	52	54	38	43	79	99	49	38	46	59	51	36	58	75	53	71	95	55	46	64	51	38	51	30	102	81	55	83	61	59	56	55	55	42	63	50	77	26	58	110	63	34	69	47	54	35	52	70	46	60	51	65	93	47	64	38	62	55	49	51	53	53	60	47	76	54	65	66	91	54	47	49	33	56	39	68	43	73	59	89	54	105	41	53	49	55	54	44	75	38	76	56	69	55	45	36	41	27	52	65	65	56	33	49	57	55	61	41	43	31	44	71	67	45	49	56	32	65	32	47	44	54	54	43	63	49	46	39	47	55	68	44	41	47	37	65	74	57	46	43	63	56	63	36	55	39	61	34	50	64	57	41	38	48	71	67	45	71	39	49	57	41	42	26	50	54	49	61	44	38	33	38	35	48	49	32	42	42	54	49	57	59	34	48	20	62	54	50	59	63	38	48	49	41	55	53	43	78	48	51	62	52	67	36	44	65	55	61	59	51	40	39	59	57	45	38	36	40	32	36	30	38	37	37	34	38	72	40	38	45	39	58	66	45	44	38	46	25	43	42	50	66	55	41	39	26	49	54	25	45	47	33	35	41	48	40	49	80	70	38	25	45	34	36	29	54	41	76	50	42	38	35	45	42	47	77	38	53	28	45	33	47	45	46	50	53	40	49	43	39	67	48	30	26	47	40	61	57	44	53	32	40	45	28	32	49	44	45	31	41	32	60	41	22	37	26	43	51	58	40	48	38	29	33	49	45	28	35	26	34	29	41	43	23	47	15	39	33	39	16	29	30	40	32	38	32	35	29	41	49	34	50	37	52	26	29	17	43	38	34	52	30	38	38	48	38	22	33	40	31	38	60	54	24	42	42	41	22	46	32	74	40	31	30	31	28	39	52	36	43	45	41	42	39	67	39	31	37	24	15	29	34	32	35	25	37	30	21	39	21	28	34	53	47	49	28	39	39	85	32	55	28	43	42	26	43	21	35	31	40	66	19	32	21	41	33	19	25	34	20	32	28	33	21	27	41	41	33	28	28	33	30	33	24	22	21	22	21	32	46	50	20	36	19	24	37	46	24	37	52	32	33	22	49	34	25	19	54	24	40	39	20	21	50	27	18	40	26	24	20	28	22	36	21	17	33	31	31	21	22	15	33	25	25	71	26	18	21	33	19	31	28	42	28	26	36	19	22	18	28	26	28	27	29	36	21	26	20	25	27	17	16	19	31	27	18	27	32	20	29	24	31	30	11	16	28	20	22	17	20	24	43	49	13	27	36	24	17	39	32	21	15	25	55	37	33	31	18	15	36	23	10	18	18	20	17	25	36	9	25	27	12	21	29	18	28	32	18	31	15	17	24	21	25	24	33	39	18	26	19	10	22	20	22	25	30	26	19	23	25	22	27	19	18	33	23	22	17	12	10	9	19	23	7	29	21	26	15	15	35	18	22	17	35	30	29	22	17	12	19	39	22	15	14	27	17	16	21	26	20	26	16	13	27	23	17	13	8	18	14	12	26	33	19	32	24	21	16	14	11	10	25	14	14	25	10	18	20	5	12	9	10	28	24	18	17	21	18	19	19	20	17	23	18	11	16	23	23	14	12	28	10	24	21	14	14	23	13	16	22	17	19	28	14	21	21	26	19	20	4	15	19	13	10	28	29	9	15	34	18	17	18	24	17	20	32	14	16	15	21	14	14	4	31	16	12	18	16	12	13	17	16	11	17	28	16	13	13	14	9	17	22	13	26	10	30	10	14	6	19	10	13	11	12	6	14	13	26	21	12	24	15	16	23	15	10	7	31	13	13	16	14	12	11	16	9	11	8	18	14	13	21	15	7	9	15	20	11	11	15	10	18	15	17	5	12	20	12	13	7	6	24	9	14	15	11	7	11	7	9	19	19	5	6	13	12	4	15	10	18	12	11	9	18	13	3	13	6	11	11	8	12	13	9	11	7	13	16	16	1	1	0	11	4	4	8	19	8	10	1	13	11	13	12	13	11	7	3	7	5	3	13	7	15	3	10	13	2	7	5	4	7	6	4	8	12	13	9	4	9	4	8	6	15	6	11	8	3	19	3	7	14	12	5	3	11	4	2	2	7	9	8	4	3	6	3	11	11	5	0	5	5	6	6	3	1	3	10	2	1	7	3	3	9	6	7	8	2	4	1	5	3	4	9	0	8	9	5	4	4	8	4	4	2	4	2	6	3	5	3	8	2	1	2	2	2	3	4	7	2	3	6	1	2	1	1	4	4	3	3	1	4	4	1	3	2	1	1	3	0	5	1	2	2	1	1	1	2	6	1	2	1	1	2	0	0	3	6	0	2	1	0
ne0273	2275	1621	1114	865	580	1049	841	880	897	812	651	761	1033	729	1014	578	742	584	603	763	622	607	503	493	576	640	648	566	536	732	403	384	406	514	535	445	424	495	476	617	446	373	392	415	392	566	464	456	462	326	478	338	298	378	454	528	380	408	377	333	457	241	362	398	287	477	501	345	440	316	376	315	387	403	373	545	342	417	333	326	310	345	404	317	361	388	305	320	292	327	319	398	359	364	284	351	365	399	257	267	410	311	298	363	288	258	315	450	270	317	289	298	374	460	341	234	379	300	267	334	285	353	291	259	310	354	209	240	357	329	210	296	237	261	368	262	234	255	342	236	238	355	247	198	225	428	295	282	282	334	241	212	405	225	241	282	310	278	350	267	209	286	207	386	248	229	232	365	178	235	352	236	220	440	292	354	232	310	271	207	186	238	189	247	192	211	202	311	262	288	200	260	177	186	233	244	231	314	327	283	163	165	165	276	170	203	246	169	312	252	285	301	188	201	165	318	197	280	248	231	297	208	161	245	311	231	270	251	191	198	270	214	166	176	283	303	178	265	276	187	248	200	194	246	239	208	365	161	204	159	178	145	202	203	161	267	126	227	218	164	200	176	239	207	203	218	179	230	187	279	151	300	197	182	220	134	213	285	163	200	148	195	175	138	189	207	265	153	130	230	213	155	219	203	225	160	247	190	183	262	185	161	148	156	164	148	271	232	186	171	242	159	240	203	182	187	173	258	152	222	184	176	168	193	248	249	212	196	172	208	198	202	207	118	175	179	230	260	192	141	123	183	175	187	168	167	158	273	134	113	157	175	168	196	156	266	160	146	155	138	112	165	188	145	176	134	155	102	177	144	147	105	155	173	179	132	179	233	230	150	90	146	156	139	233	186	140	169	172	171	163	215	127	205	121	138	119	133	144	142	147	224	131	139	316	144	159	162	227	276	152	132	139	139	116	147	119	161	206	160	124	158	154	192	190	291	161	159	119	133	146	112	87	149	111	114	114	69	159	194	162	162	138	94	132	132	136	166	235	140	129	119	105	120	147	136	143	170	101	155	132	85	108	100	105	126	130	105	140	103	92	129	126	124	129	119	142	107	98	90	142	97	120	122	104	118	97	82	145	153	114	135	143	149	159	134	91	142	100	122	87	107	166	132	152	168	129	88	125	141	85	104	121	92	104	107	114	161	114	88	105	91	131	99	105	114	135	137	119	131	137	252	191	112	113	94	107	110	127	133	107	93	123	134	112	69	63	109	146	120	75	131	100	86	119	123	205	109	78	123	104	117	136	60	105	121	93	90	125	107	73	141	128	115	89	145	63	101	79	94	128	72	65	105	137	132	105	147	188	130	107	126	92	137	102	85	99	80	101	108	78	115	100	91	77	112	80	100	74	75	75	96	108	129	122	60	80	97	83	113	124	146	97	184	122	100	113	67	143	80	118	73	108	183	104	133	95	70	65	101	62	63	80	178	105	90	65	90	132	109	94	118	97	107	87	95	89	122	114	66	169	75	101	70	71	102	114	58	73	71	66	74	114	125	81	121	76	92	93	118	83	97	70	59	81	133	99	69	130	59	102	101	137	89	88	91	109	89	82	68	115	160	67	112	94	70	86	87	85	162	85	85	69	54	69	79	85	59	50	168	116	76	111	99	102	87	89	77	71	84	116	71	62	103	81	90	76	75	108	86	102	88	56	113	137	77	36	75	69	50	115	68	82	79	116	76	107	75	78	97	72	105	57	57	83	75	75	138	102	84	50	91	90	94	65	68	66	66	42	74	72	79	53	88	65	64	60	83	74	54	71	65	68	75	87	90	90	65	59	69	113	91	41	100	80	84	79	45	52	58	56	100	64	35	45	69	63	57	54	56	53	75	100	60	88	73	68	67	55	71	96	82	65	98	69	66	72	78	61	28	75	50	103	31	67	62	63	64	61	57	60	43	65	85	52	79	57	57	81	55	71	55	69	47	53	61	65	62	40	74	97	52	91	93	73	36	71	51	40	83	70	101	73	117	41	105	69	88	79	84	60	62	54	75	58	55	162	69	54	65	65	41	56	39	56	101	121	83	31	41	55	64	55	57	57	69	34	73	60	43	53	66	46	74	45	74	44	77	53	45	27	62	56	42	62	63	54	67	39	73	47	68	58	64	56	42	40	69	61	84	48	44	55	38	57	84	41	67	37	52	85	39	61	63	49	68	55	46	41	39	53	66	50	74	47	37	35	49	66	53	42	29	38	39	55	68	56	70	45	50	39	77	50	56	35	43	56	42	65	69	49	55	57	76	67	62	59	38	46	51	75	63	66	48	68	64	40	39	52	114	65	39	35	40	45	37	27	46	51	54	36	30	46	72	49	59	43	41	49	43	69	49	33	36	47	39	89	30	54	37	34	45	105	75	34	43	58	21	43	62	53	44	46	73	63	27	23	24	38	37	38	47	48	62	31	43	60	37	42	37	65	86	31	47	39	40	36	61	64	78	47	44	37	68	38	36	35	41	36	25	41	35	72	51	51	39	62	66	36	34	33	53	36	41	40	45	46	70	24	26	38	52	36	53	39	48	38	46	45	24	53	43	41	45	21	32	28	29	38	50	54	43	29	34	41	22	25	24	40	27	31	33	29	31	32	61	37	49	44	64	32	26	24	64	41	45	36	59	50	24	33	50	29	33	65	24	48	45	40	40	50	64	33	44	33	42	47	24	34	35	54	44	41	63	48	45	59	56	34	46	62	33	27	40	30	28	46	30	25	61	25	28	54	16	37	27	33	36	54	50	82	29	38	46	43	42	62	46	38	70	30	43	48	36	36	38	53	17	49	41	54	22	42	62	56	44	31	45	30	45	58	18	36	40	38	57	30	26	46	40	45	24	19	37	33	39	51	25	32	18	28	29	77	24	29	46	31	29	26	28	28	43	21	63	33	41	55	34	17	35	35	18	39	31	28	15	35	18	32	26	34	35	26	42	16	36	21	27	21	25	109	26	42	52	22	28	27	25	37	24	38	54	19	19	12	36	30	33	27	26	51	22	32	6	26	30	13	33	35	24	36	15	35	25	17	24	17	18	17	34	21	20	54	48	17	16	13	15	62	26	53	25	27	35	35	30	19	25	45	46	62	17	27	26	23	23	26	27	16	39	40	22	17	27	15	31	30	21	30	26	20	22	29	23	16	8	27	20	20	24	22	35	50	44	53	20	18	18	27	39	22	22	45	27	24	30	33	24	23	14	29	24	18	13	23	18	27	52	14	5	32	28	13	16	31	39	16	25	27	54	21	12	21	26	19	19	58	24	17	24	11	19	14	18	24	31	55	25	20	23	15	26	11	17	21	36	13	30	19	19	22	16	14	23	21	27	4	20	13	11	28	15	21	18	25	29	12	12	18	21	13	17	19	13	17	14	16	21	24	21	26	13	8	27	10	20	19	13	12	18	16	29	21	6	16	33	33	27	28	28	21	37	23	21	20	14	18	16	10	19	51	25	10	18	19	5	30	12	16	23	26	34	18	12	19	19	12	17	12	25	16	14	16	22	7	27	12	14	21	10	19	18	12	16	13	16	16	15	20	13	15	70	8	16	14	11	16	29	5	11	15	10	11	17	21	8	18	15	8	12	8	5	9	28	11	5	17	13	7	13	7	36	7	13	13	11	23	12	6	22	14	12	9	11	15	11	15	10	17	13	8	8	10	11	14	10	3	24	9	5	21	12	5	7	10	17	12	9	5	4	8	12	11	16	9	20	9	10	6	11	12	11	6	3	10	11	5	7	22	8	11	5	17	18	8	9	10	1	4	8	3	5	12	15	10	5	8	10	20	11	11	19	16	5	15	5	4	7	7	14	3	6	8	4	7	7	6	15	10	4	7	6	12	5	4	12	7	18	13	28	8	4	6	10	6	6	12	22	12	8	12	9	6	3	11	7	4	6	1	9	9	4	8	15	9	1	3	10	6	6	6	3	5	5	6	2	6	6	1	6	5	4	5	3	8	3	3	0	5	9	4	4	6	3	8	8	10	2	0	2	4	7	3	8	6	2	1	5	3	3	5	6	10	2	3	6	1	4	0	1	6	0	9	5	2	2	1	3	3	2	0	4	0	0	10	1	1	0	2	0	1	2	1	1	0	4	1	0	0	2	1	0	1	4	3	1	0	0
ne0274	4061	2702	1550	1242	1028	1873	1698	1468	1527	1586	1126	1430	1749	1543	1512	1119	1443	894	912	1245	952	1207	848	859	821	952	913	1268	944	1268	666	984	1006	1048	1043	919	1139	709	738	838	829	831	518	1050	769	1081	877	1017	1051	856	865	832	626	545	798	1240	411	563	866	616	781	626	324	433	725	846	918	646	693	600	537	436	725	528	457	385	738	716	842	486	853	667	700	438	379	692	416	643	536	793	581	533	692	461	510	390	688	473	721	615	848	477	444	698	531	658	465	800	635	634	633	692	724	742	696	452	718	751	348	596	518	684	364	684	642	567	546	390	702	638	544	602	405	340	554	300	505	352	603	467	561	889	363	438	291	751	576	282	627	562	656	369	831	460	444	371	619	340	640	425	571	421	547	751	512	319	436	499	218	410	593	468	577	747	574	387	437	560	396	305	341	438	373	339	271	270	303	482	386	491	320	630	288	545	404	311	419	565	507	600	398	341	248	467	262	544	319	594	642	568	574	571	396	517	354	479	353	263	586	322	229	322	239	606	513	429	387	356	371	374	233	555	345	295	575	431	231	267	378	336	599	336	392	373	245	543	673	370	395	267	421	338	369	238	544	522	318	415	252	303	241	324	265	476	230	444	508	298	294	381	395	424	512	358	483	284	315	473	406	254	227	245	281	162	178	194	363	251	202	454	350	530	217	361	470	257	335	317	415	359	289	160	324	336	476	259	340	314	410	260	154	285	202	349	265	186	480	211	323	371	373	282	356	241	404	283	355	234	310	244	298	542	424	241	363	428	392	228	382	334	257	530	388	268	503	265	414	332	213	204	395	204	231	274	246	533	265	205	148	162	285	230	215	205	288	261	220	274	448	427	241	147	296	336	279	217	262	289	345	329	186	298	257	420	337	264	211	190	350	270	249	246	333	234	220	297	191	228	218	310	338	200	390	401	474	174	173	166	448	278	210	226	236	405	233	230	264	271	303	262	221	60	228	375	365	234	346	278	147	305	142	237	143	230	260	239	210	197	174	238	304	155	194	158	227	247	176	216	241	244	236	188	178	227	195	155	233	210	155	309	345	161	132	177	139	220	207	208	229	163	128	383	178	183	315	141	350	152	114	169	182	109	327	167	202	118	246	289	157	242	108	155	137	156	112	279	187	140	261	359	156	321	272	170	175	269	148	136	360	309	185	194	232	172	256	175	214	218	272	282	170	136	145	166	200	178	159	229	241	138	245	336	310	206	162	222	132	234	116	144	128	143	143	228	76	94	127	96	206	249	184	164	277	245	260	232	226	143	291	208	233	224	174	255	202	209	157	180	117	159	179	182	95	124	171	120	176	221	293	249	139	239	224	118	251	225	130	222	184	197	184	198	190	76	166	128	390	118	278	234	231	167	147	169	165	190	120	192	135	89	107	167	124	72	149	113	143	201	194	118	149	103	109	203	202	257	153	161	217	126	134	126	127	205	123	129	143	140	121	139	121	134	153	131	141	164	133	223	97	143	131	131	212	205	164	139	225	130	125	149	249	202	122	211	127	171	171	185	177	174	45	44	169	130	212	167	120	164	190	191	126	172	145	110	72	212	224	58	116	78	102	176	206	171	77	178	182	114	273	75	155	222	91	116	254	144	211	124	151	168	94	168	138	173	129	199	170	76	100	162	185	65	164	70	92	95	153	197	143	107	178	105	113	135	155	57	83	138	146	54	122	90	125	166	150	122	65	131	129	134	119	136	116	139	77	154	252	136	67	81	103	112	189	118	135	54	89	333	61	103	45	129	213	101	107	122	124	67	167	140	228	143	126	89	155	109	97	166	109	111	105	128	125	115	65	182	137	182	118	80	179	102	56	83	157	109	127	157	119	127	50	117	175	59	90	234	74	142	114	67	192	171	116	89	158	129	161	67	96	87	67	107	171	149	166	131	131	89	54	69	115	87	93	90	161	77	63	78	176	43	119	69	127	156	68	69	91	91	65	38	106	123	155	106	130	59	71	80	40	56	81	113	80	240	73	80	184	90	64	96	95	168	66	139	102	66	216	53	80	103	85	101	89	101	97	148	175	80	95	133	127	96	139	88	71	51	218	110	27	90	78	117	152	103	73	91	53	147	174	100	103	190	72	119	90	93	146	163	133	41	63	74	85	76	102	87	68	132	62	132	56	152	84	150	163	116	75	120	45	158	112	118	25	105	60	94	55	82	62	46	161	85	117	132	48	58	124	91	40	58	81	94	127	77	127	81	159	83	122	157	85	92	45	139	50	104	106	90	79	65	94	190	34	64	38	113	80	108	59	113	76	165	27	85	103	101	73	63	50	82	105	134	68	49	124	93	54	69	86	145	164	127	122	30	69	91	105	79	94	101	58	64	97	96	59	72	120	26	88	107	104	58	106	88	20	23	115	29	100	111	60	96	118	90	141	42	59	63	123	65	81	88	77	86	36	99	61	60	31	85	42	107	88	61	40	89	117	67	84	108	80	128	61	127	36	88	24	74	136	63	69	61	52	81	143	67	23	37	130	64	90	80	113	103	69	80	119	38	54	91	45	99	29	98	106	43	53	85	35	86	35	58	50	135	49	104	90	57	47	86	79	54	100	69	85	45	83	48	71	103	39	25	22	81	54	38	44	46	67	37	62	62	34	24	78	107	42	102	52	116	108	29	27	38	32	40	24	34	45	72	35	65	27	149	30	60	71	65	39	42	146	53	55	44	142	14	30	67	71	63	123	55	59	100	98	130	101	80	38	103	115	83	39	63	23	37	60	22	31	44	41	76	24	66	59	69	31	25	67	59	119	25	105	64	45	67	47	91	34	85	44	55	40	67	48	32	56	27	29	22	65	58	62	42	32	43	20	43	43	20	88	34	84	78	15	16	46	42	52	36	97	30	32	34	10	61	57	49	74	37	57	56	109	32	57	87	74	57	24	43	23	24	35	53	62	24	80	26	49	53	57	42	93	19	55	26	67	48	43	50	51	63	46	83	24	13	71	46	55	28	83	14	14	13	33	22	35	18	71	32	31	79	48	44	21	37	39	22	52	47	39	93	80	46	15	56	29	26	19	63	22	29	46	32	41	30	31	27	31	24	29	48	90	42	39	52	20	37	45	63	146	26	71	22	37	33	45	78	25	22	101	57	72	20	82	27	62	73	40	69	39	16	32	44	25	20	38	29	59	88	45	46	26	24	41	15	17	42	35	25	38	117	58	16	58	53	12	23	41	110	35	25	25	43	48	25	44	63	51	46	100	24	23	28	66	34	8	56	50	13	23	57	33	30	13	36	43	7	34	46	29	37	56	20	42	26	97	15	18	13	25	33	41	60	21	16	72	16	6	39	26	29	48	21	20	45	37	28	12	24	33	74	61	20	30	39	19	43	10	20	35	21	40	15	10	16	11	15	51	41	25	24	29	25	16	26	17	32	20	20	29	17	46	17	19	40	15	18	14	35	29	36	34	23	10	22	34	19	21	39	29	53	40	34	20	26	15	28	22	16	26	59	35	15	11	12	24	33	26	24	54	27	18	30	36	14	9	26	59	57	8	10	16	49	14	35	27	12	19	22	11	34	39	19	14	12	15	24	18	11	9	83	9	17	27	45	11	9	53	20	31	21	13	12	9	25	7	61	11	125	7	12	14	65	14	31	30	11	12	32	16	17	11	12	8	16	28	13	3	11	18	20	16	29	28	5	11	19	6	14	23	16	19	12	21	12	3	12	14	13	9	13	3	16	14	32	24	15	25	4	9	32	10	5	17	16	4	7	42	51	16	8	13	11	24	30	3	23	13	15	10	6	33	10	8	11	8	10	54	5	9	8	9	11	19	16	7	9	14	6	6	8	12	10	3	24	2	6	3	8	11	42	7	7	13	12	7	5	5	10	7	11	27	13	15	3	15	34	8	15	9	3	4	17	9	18	4	28	6	39	4	9	11	5	2	12	6	15	5	3	7	2	15	16	7	5	7	8	2	1	9	4	7	10	3	1	11	3	9	4	3	1	9	7	19	2	9	4	5	9	10	2	8	6	2	2	3	12	6	10	5	2	2	2	7	2	2	6	10	5	8	35	6	2	3	2	5	3	3	2	3	8	2	5	5	2	6	1	2	2	1	0	2	3	5	3	2	0	0	0	2	2	0	1	0	2	1	1	2	1	2	0	0	1	2	1	1	0
ne0275	1574	1185	717	960	661	861	850	727	735	812	592	721	979	772	681	555	665	459	439	587	476	593	392	420	453	579	345	578	472	651	314	463	459	535	411	491	524	336	354	350	335	384	217	445	432	469	452	467	346	386	452	423	369	483	385	486	333	269	384	386	494	344	205	251	363	362	445	376	280	260	216	181	308	240	234	232	335	356	390	286	403	338	431	188	280	358	262	329	214	395	299	249	384	211	230	186	344	271	347	325	406	226	294	342	289	327	244	384	273	298	263	317	381	393	370	224	375	301	153	308	258	348	135	321	241	368	260	175	385	351	297	277	230	143	242	165	402	214	332	187	280	359	152	157	171	371	213	197	318	299	291	186	351	190	157	175	237	146	333	227	292	231	245	381	167	170	216	259	185	238	227	218	277	315	341	158	194	325	204	152	297	229	256	166	196	185	233	218	164	197	137	271	169	292	218	202	174	307	186	306	191	174	164	215	176	246	164	256	272	374	312	254	299	203	184	388	190	114	217	191	76	167	93	238	233	240	175	173	181	193	221	246	151	136	215	189	90	136	136	165	253	158	132	264	107	192	301	189	173	126	191	113	135	118	206	287	120	190	247	118	169	126	121	196	96	170	188	140	148	150	194	167	202	187	221	114	219	179	199	76	117	135	84	119	90	108	159	132	137	152	176	212	83	140	322	125	217	138	140	177	102	106	134	122	193	98	152	294	190	154	68	68	87	164	125	92	190	138	196	190	194	82	137	155	313	224	167	137	147	97	152	230	216	114	226	178	195	160	178	188	106	246	162	192	229	96	169	163	89	109	182	80	106	111	131	269	83	70	166	81	133	94	116	79	105	106	117	132	244	169	150	122	170	165	119	132	98	125	209	239	215	110	114	207	182	201	120	90	141	143	145	302	151	133	133	107	127	105	85	169	136	108	192	210	151	60	93	79	207	129	137	151	120	191	105	98	105	127	133	125	103	50	115	148	153	127	135	120	79	157	127	133	185	138	133	81	74	97	84	122	138	64	87	84	86	119	80	119	99	134	104	97	97	110	76	82	78	108	101	93	154	70	108	78	77	114	60	119	100	63	130	159	88	77	220	68	129	64	99	69	159	54	125	82	103	61	141	174	119	145	94	75	47	83	43	92	120	70	141	123	46	151	106	95	112	144	70	67	145	138	76	98	144	60	83	83	97	113	147	189	79	54	52	81	105	95	83	68	117	67	80	158	151	77	68	133	50	118	35	105	59	68	47	78	57	35	67	58	53	118	76	93	99	139	109	137	114	96	161	97	118	91	61	103	83	112	78	99	41	66	86	86	63	107	78	103	127	111	117	98	55	131	129	75	91	80	93	87	82	100	116	101	98	40	85	63	136	45	113	115	82	43	69	95	67	96	87	105	54	113	73	55	42	53	80	61	145	74	45	55	67	46	51	96	84	110	83	68	95	67	57	43	54	76	51	32	66	68	48	159	66	52	118	60	56	59	64	88	40	119	38	61	111	94	72	56	69	131	67	51	83	87	39	111	74	52	68	105	110	61	32	23	94	109	128	71	45	84	111	97	64	96	56	44	89	70	150	80	56	72	82	58	97	81	44	83	72	71	127	24	85	58	69	73	103	58	91	68	94	61	58	104	89	71	56	99	77	47	73	53	87	25	94	20	38	33	78	120	69	59	69	37	70	58	79	37	41	68	54	20	55	51	41	49	47	90	23	65	48	55	108	52	38	87	54	58	73	63	47	54	55	47	83	54	50	20	28	78	23	48	26	48	90	73	50	49	43	23	60	40	94	59	47	80	87	63	51	73	54	76	78	78	59	30	66	74	66	80	60	35	83	55	31	73	66	42	60	93	67	68	19	117	63	43	50	63	26	67	108	41	35	77	112	39	77	43	88	31	33	33	50	71	73	117	93	74	45	40	23	46	53	32	77	55	65	49	26	38	65	19	30	48	63	61	16	47	73	55	13	48	28	68	61	52	61	18	37	38	23	31	60	63	82	87	38	38	91	42	48	57	37	62	41	79	34	31	105	19	39	69	49	27	52	59	62	70	82	30	45	50	52	39	57	27	34	20	47	88	36	35	78	42	121	99	155	39	27	61	74	70	45	107	18	60	43	56	75	79	52	16	122	55	53	39	54	55	37	30	34	65	28	63	20	73	91	57	41	32	14	68	42	83	9	39	129	32	122	59	58	45	62	72	54	46	38	20	72	44	34	45	29	55	69	28	43	47	91	30	32	71	40	35	23	55	26	68	45	103	40	47	28	64	122	21	31	28	38	51	33	60	29	52	16	50	58	34	28	31	23	54	36	40	24	126	41	55	33	35	37	74	52	44	46	19	35	33	86	71	29	39	19	34	51	49	18	40	83	8	29	31	40	33	86	41	14	16	38	20	40	67	44	30	41	54	79	12	29	20	47	43	43	36	31	33	16	31	19	28	29	51	31	52	70	23	13	39	57	33	51	45	37	20	41	63	36	43	44	34	65	32	28	22	32	47	56	41	58	24	77	14	29	40	33	52	22	30	36	17	47	65	20	30	28	100	29	37	27	64	29	23	11	53	25	69	15	46	49	19	29	39	25	52	32	37	44	40	50	25	58	27	49	32	20	43	25	53	27	30	35	22	39	33	18	12	49	45	37	28	32	45	52	27	17	30	28	16	8	27	21	54	15	32	41	37	11	10	31	16	11	11	62	28	22	29	66	13	15	23	19	40	60	37	25	43	41	41	50	29	29	48	39	38	11	17	13	21	21	13	20	13	19	24	22	19	23	34	6	21	41	31	62	14	47	22	12	26	33	19	10	40	23	34	14	22	132	7	42	19	12	32	24	28	26	36	33	40	114	26	10	17	30	22	42	33	7	8	23	22	21	22	41	26	9	16	33	37	46	28	22	14	49	21	51	8	25	22	39	23	11	24	6	14	27	16	24	23	34	9	17	12	26	16	29	25	36	23	20	25	19	19	26	20	24	66	9	9	35	27	25	15	22	31	33	8	27	11	14	9	27	26	9	41	49	56	8	33	14	7	33	15	15	11	28	12	11	31	8	10	10	21	141	26	9	9	15	15	15	25	19	14	11	18	32	13	27	32	9	40	32	26	27	18	29	20	26	52	17	16	29	15	39	39	33	13	38	12	54	24	10	11	17	8	20	4	14	10	24	17	24	42	49	31	10	41	23	18	15	20	14	16	8	33	34	10	12	29	9	18	24	23	12	15	10	9	23	19	16	16	22	23	26	12	10	33	33	9	21	35	13	14	10	17	13	14	9	26	14	17	22	125	9	9	28	12	11	18	17	7	26	4	11	22	7	20	6	11	31	16	8	20	11	9	7	21	6	28	19	18	17	10	22	18	32	11	18	20	12	19	12	21	26	8	14	2	5	9	17	11	15	17	14	15	12	17	15	13	8	19	11	5	11	3	16	10	7	22	6	19	16	32	29	9	9	12	6	14	20	16	15	12	9	9	27	22	13	8	7	11	18	18	22	36	21	14	4	17	7	13	16	15	15	8	9	10	27	4	10	7	16	10	2	12	7	28	9	17	24	1	1	9	2	26	16	20	4	5	8	6	11	5	13	18	10	3	16	8	8	7	6	6	6	9	4	1	12	6	12	12	4	20	4	5	3	16	11	7	12	3	7	14	4	6	5	6	7	13	10	9	4	4	25	1	8	6	7	3	1	5	110	6	9	2	7	14	11	11	5	12	4	11	4	8	7	7	8	15	9	0	6	6	2	14	3	4	11	6	1	5	11	5	6	10	13	5	16	12	2	13	10	8	8	2	4	4	2	6	11	0	22	8	14	9	7	4	1	3	9	6	2	4	4	9	5	5	1	2	3	3	4	3	14	9	3	11	8	4	13	3	0	2	0	9	13	2	4	9	3	2	2	22	7	4	4	15	5	9	2	25	3	15	1	2	3	4	4	2	5	4	5	1	1	1	7	6	1	0	3	5	0	3	1	5	3	2	2	2	5	4	3	4	4	4	3	4	7	5	4	0	2	2	4	5	1	6	0	0	1	0	1	9	1	2	0	0	1	2	2	1	1	3	1	9	2	1	2	3	3	2	0	2	1	9	0	1	3	0	1	3	4	1	1	1	2	0	1	0	6	1	0	0	1	0	0	0	0	1	0	1	3	0	1	0	0	0	0	0	0	0
ne0276	2996	2235	1262	1598	877	1427	1526	1170	1246	1334	1029	1182	1395	1063	1171	911	1081	939	794	911	722	929	743	982	660	866	691	794	625	834	637	707	804	887	751	702	939	596	613	466	682	713	421	718	824	728	756	692	606	714	756	754	463	525	878	730	538	518	568	507	675	475	320	423	684	595	771	506	520	562	414	337	511	402	354	399	613	681	520	386	735	477	818	390	337	610	460	608	319	526	667	419	658	362	380	282	610	439	364	419	696	580	558	565	490	551	401	624	507	775	396	408	606	572	595	381	607	500	332	529	348	571	373	389	419	582	373	309	603	558	571	354	320	310	412	422	326	345	520	349	534	638	268	357	261	648	401	415	493	451	522	349	581	302	336	308	434	262	592	523	517	352	500	638	383	311	316	306	242	582	361	409	486	637	517	253	434	514	323	271	457	379	301	256	246	288	258	351	300	418	287	359	322	527	323	593	327	472	278	561	271	248	256	408	351	459	289	388	364	326	496	387	220	307	198	386	365	252	315	319	203	257	225	300	311	379	338	279	273	375	231	352	258	268	383	313	185	265	284	361	414	333	222	399	259	303	603	276	375	235	303	239	259	243	318	455	227	376	235	242	402	276	199	273	225	278	305	285	242	255	341	275	432	295	316	195	303	349	289	201	167	225	224	303	190	284	185	305	169	228	305	393	226	240	400	219	486	313	191	245	206	276	247	214	325	253	285	256	243	239	194	205	212	288	205	170	270	226	258	289	297	189	257	235	328	446	281	250	249	186	238	409	291	390	250	275	258	187	336	304	190	313	296	212	341	178	235	217	213	186	265	223	184	197	225	455	208	143	168	126	231	204	446	162	153	169	248	204	255	247	206	158	227	241	233	236	139	202	269	253	190	166	199	315	241	241	248	170	221	200	170	288	268	225	259	177	143	276	180	245	236	129	286	240	323	159	161	134	463	198	219	170	182	320	185	145	203	194	250	241	179	131	225	233	238	110	208	201	224	183	334	197	118	191	217	142	141	166	110	190	242	138	143	171	164	237	152	132	142	204	178	204	189	175	135	154	180	161	165	155	225	130	193	113	119	191	159	170	165	125	245	262	116	144	260	112	209	114	145	112	222	120	191	185	149	105	246	291	375	194	115	130	114	126	117	181	160	101	190	204	100	256	192	427	374	238	125	108	214	209	185	197	187	123	159	155	151	172	239	213	138	107	164	114	217	140	115	112	168	123	141	231	215	145	107	224	93	166	152	148	103	131	116	155	78	112	115	185	156	194	119	155	224	163	139	157	152	157	137	172	184	198	114	151	135	165	155	132	104	130	149	105	84	123	135	325	117	179	201	179	168	170	165	174	170	170	205	149	102	224	112	130	156	86	168	133	195	114	174	177	181	91	179	233	138	151	112	162	125	140	163	139	88	59	104	110	122	124	133	90	122	121	118	107	213	239	145	100	140	126	95	88	116	125	107	90	67	86	148	147	104	76	186	123	102	100	109	148	108	135	81	126	158	113	130	100	131	281	155	110	134	208	102	155	117	131	119	137	152	109	124	61	140	305	153	66	110	113	98	117	120	111	93	82	214	100	157	60	52	86	117	107	111	149	74	141	95	79	111	62	139	128	100	107	136	132	139	89	167	90	87	125	100	125	98	136	142	97	157	66	124	85	109	69	96	91	115	145	111	131	104	80	97	132	136	85	76	169	99	52	135	60	70	116	80	104	103	99	88	108	176	95	70	95	97	95	133	85	85	86	86	73	117	98	111	62	67	193	62	87	60	103	158	100	77	96	146	89	147	104	205	109	129	123	116	113	71	136	98	89	90	127	88	70	98	87	86	162	101	109	136	82	58	66	134	66	99	150	86	97	93	155	106	48	80	138	63	84	139	85	91	100	137	81	153	94	137	46	72	66	69	80	140	168	126	81	107	73	64	100	73	81	270	93	132	150	67	70	118	53	75	60	87	105	55	82	65	76	55	74	79	84	106	109	89	54	61	66	48	76	75	96	102	139	85	99	139	63	100	54	72	52	60	112	74	92	161	61	62	131	43	82	62	84	73	108	166	63	72	104	100	70	96	81	60	55	187	85	38	68	44	116	113	104	53	71	39	109	125	69	75	114	56	131	68	124	97	130	74	46	48	81	64	81	90	69	88	93	81	86	108	98	38	118	127	100	86	87	62	169	71	96	35	53	55	63	62	89	68	36	96	71	77	55	49	54	131	70	69	78	77	65	95	75	56	65	94	69	113	116	96	69	29	82	61	109	91	87	69	63	50	127	46	67	50	53	62	87	69	129	54	101	33	69	82	89	78	73	42	109	62	82	80	58	85	88	56	60	72	71	83	69	63	36	41	81	52	100	59	75	55	58	81	137	34	53	83	52	52	60	72	54	106	58	28	60	52	62	111	82	210	67	47	99	108	21	57	51	91	62	52	43	85	38	45	50	40	39	36	98	56	86	70	61	42	80	75	48	52	66	64	91	55	126	68	67	19	57	103	48	53	48	55	82	81	51	33	49	88	35	56	126	105	62	49	71	60	24	59	114	47	48	75	90	83	26	66	54	37	58	40	80	54	104	57	49	80	32	50	88	51	64	72	65	55	53	48	52	66	64	46	45	32	62	46	40	40	41	46	40	32	71	41	53	64	73	49	37	49	61	121	46	47	58	31	41	55	23	34	27	34	69	51	56	20	30	70	35	38	36	67	47	41	48	99	17	40	60	31	53	55	37	72	71	51	71	62	47	45	73	74	66	69	52	32	26	51	35	56	40	34	80	39	39	33	63	35	37	107	54	61	27	74	68	16	45	53	30	31	46	32	48	28	72	37	28	39	46	20	68	41	43	49	40	37	61	20	44	40	35	52	31	60	66	15	10	45	25	51	35	64	50	28	39	35	126	51	31	47	46	71	28	69	28	61	38	48	52	59	21	25	18	29	39	56	42	75	23	24	30	64	55	36	43	44	49	33	50	46	37	40	59	34	68	29	32	44	37	40	33	33	37	43	19	32	17	33	22	41	47	18	58	44	20	19	74	24	32	48	42	49	39	34	25	29	43	19	30	45	45	41	39	35	20	39	21	59	40	48	13	24	36	46	18	34	50	65	14	39	34	29	31	42	30	35	24	41	40	53	69	77	42	39	35	54	26	67	35	29	50	28	25	50	25	25	18	23	31	42	69	54	30	21	27	31	25	32	39	31	25	27	54	47	16	66	62	24	24	40	65	35	24	46	27	44	35	35	60	55	68	42	19	45	27	32	26	31	63	26	20	24	30	22	19	10	45	28	10	26	42	31	23	28	45	20	18	51	12	82	16	9	43	13	44	14	20	46	38	26	31	23	18	18	28	16	29	33	26	31	31	24	31	31	17	44	30	19	28	28	28	24	18	23	9	13	10	14	11	33	15	30	15	24	20	25	24	15	41	23	19	24	14	15	33	10	20	9	16	28	52	32	28	26	23	20	22	25	13	24	37	11	27	23	23	10	12	11	15	39	7	23	34	32	17	20	26	29	11	33	21	23	13	19	12	16	16	15	20	23	17	24	32	10	35	16	19	27	20	12	26	12	22	19	16	15	23	7	14	9	10	5	38	9	7	15	18	10	7	26	21	10	20	10	9	19	19	11	30	37	30	10	15	20	28	17	5	32	4	8	22	11	15	12	5	11	19	20	20	18	9	21	14	7	13	22	18	6	10	9	10	14	11	7	15	19	9	19	16	19	18	10	13	8	19	12	15	19	20	20	8	15	18	8	12	13	27	6	13	21	21	8	22	3	5	24	24	4	23	14	15	27	4	10	17	9	12	12	3	32	4	14	11	15	4	16	14	14	11	11	5	7	7	17	5	11	9	9	6	4	1	11	6	8	4	6	7	15	9	1	4	7	11	20	13	3	3	5	6	8	20	16	7	13	7	5	7	9	20	5	20	6	7	11	1	12	11	4	6	5	9	8	2	9	13	9	5	17	8	2	6	9	11	14	6	11	2	8	9	20	10	9	9	5	7	7	10	5	5	4	7	1	6	4	20	2	5	16	2	4	4	7	3	0	0	6	7	0	10	10	5	6	10	5	2	0	6	7	5	0	2	2	3	5	3	5	0	2	2	5	2	3	0	0	3	15	3	1	1	0	2	1	1	0	2	4	1	1	1	1	1	1	0	2	0	0	0	0	37
ne0277	3608	3277	1949	1803	1467	2237	2215	1818	1282	1621	1353	1651	1664	1567	1260	1608	1584	988	1510	1316	1049	1339	983	1402	880	869	877	1047	1130	904	759	1180	934	1325	909	776	1124	775	967	746	1024	904	811	900	1095	1240	1247	1102	1092	758	1116	837	609	672	1122	974	569	566	757	675	1018	789	418	614	669	865	1131	819	758	543	683	653	747	517	547	528	682	739	745	633	906	619	1056	669	416	857	692	640	614	726	843	587	955	447	546	647	825	636	754	907	634	753	686	903	789	626	589	865	743	979	683	806	899	951	829	639	814	807	472	797	649	885	394	658	628	653	602	473	812	791	519	596	374	394	555	334	529	466	775	611	602	781	707	531	348	723	562	344	703	559	679	473	707	510	495	422	686	368	832	681	578	500	542	486	634	406	502	370	317	715	539	431	618	619	715	397	518	752	435	365	389	624	443	524	395	254	444	514	414	493	455	503	488	526	344	769	565	732	457	512	474	310	348	524	296	619	413	462	526	469	690	429	406	506	534	348	378	289	490	410	297	402	283	530	366	439	449	353	395	371	411	473	441	379	552	349	279	330	418	411	392	344	510	396	266	419	528	402	392	457	387	296	494	309	467	637	323	412	348	409	500	340	296	375	307	426	466	298	353	330	428	349	510	377	406	341	390	481	303	321	280	307	337	231	258	189	366	438	325	429	349	582	253	349	434	268	521	383	373	362	371	330	318	380	419	279	369	225	360	279	371	305	253	437	284	223	409	266	431	335	341	262	306	196	311	527	337	331	335	226	576	505	403	337	358	424	410	221	430	288	442	438	389	299	410	338	358	318	246	217	372	284	338	295	277	447	345	339	237	299	261	245	535	267	305	354	363	420	421	382	320	174	306	344	290	205	283	275	318	353	273	257	252	410	217	360	294	237	291	258	185	257	366	235	299	334	307	274	190	344	310	227	442	389	307	203	210	340	366	312	184	237	260	425	338	311	225	280	255	567	331	111	353	373	337	173	326	326	213	270	392	179	204	272	299	246	202	206	189	271	284	147	184	284	277	307	175	215	210	340	179	252	372	284	208	157	313	210	317	297	383	223	154	335	194	259	191	185	206	235	262	322	240	264	338	186	323	169	226	225	177	197	224	183	319	197	430	347	385	190	176	177	111	182	227	227	216	218	289	310	205	258	235	444	429	250	146	168	381	298	257	206	278	230	203	141	241	200	225	279	208	191	205	296	254	225	184	195	195	295	243	269	241	180	177	194	222	260	128	187	161	189	180	205	152	213	191	260	120	416	260	207	310	200	146	154	221	168	338	207	213	216	276	189	213	271	181	295	168	158	230	199	112	131	189	351	278	308	257	206	215	184	236	217	227	179	272	198	182	384	143	196	186	118	169	212	260	152	254	218	213	175	151	241	165	149	113	142	126	155	120	138	153	76	135	113	156	201	260	179	121	120	148	210	240	219	189	173	118	136	189	116	176	163	123	151	211	214	123	157	221	194	122	141	100	135	97	170	125	157	108	162	150	177	170	127	229	312	146	226	246	261	157	192	162	204	181	257	157	174	173	102	218	415	164	246	119	108	250	183	168	154	156	122	105	128	165	66	98	64	146	161	135	195	68	121	211	79	269	91	124	177	175	154	188	156	160	174	267	150	130	134	178	137	145	90	211	117	212	134	131	102	205	117	101	111	118	194	147	136	197	108	198	117	144	79	86	217	127	124	155	114	216	136	161	125	117	143	156	135	106	135	116	205	135	163	174	147	96	139	167	192	141	182	119	54	149	167	103	130	92	134	177	126	138	150	164	116	174	142	149	189	160	129	109	139	284	175	144	175	118	182	130	96	69	119	167	139	169	107	140	157	105	111	173	150	116	140	175	170	67	106	189	109	129	248	119	156	140	97	265	115	114	138	268	100	175	119	85	107	89	77	82	153	158	106	125	79	67	115	113	96	351	140	94	109	74	111	101	87	89	84	149	111	61	109	98	106	103	72	102	90	149	97	140	86	70	84	83	80	90	79	114	168	144	112	156	64	109	173	122	144	108	199	121	92	158	85	79	161	99	81	73	79	80	156	137	104	128	167	123	106	98	97	136	71	169	127	42	113	93	131	98	96	99	142	55	142	151	47	104	110	77	236	130	96	108	128	110	68	86	159	125	120	107	131	58	145	85	91	48	153	88	191	95	150	148	137	62	128	88	79	58	139	65	85	86	96	80	69	86	68	87	269	63	49	154	131	80	58	81	110	112	158	95	56	128	114	116	130	92	50	136	150	81	126	118	99	76	83	122	119	45	58	68	72	76	102	117	129	106	109	35	90	79	87	110	65	85	194	137	128	96	94	248	93	41	55	74	115	64	107	129	47	84	127	155	90	84	89	118	55	95	127	96	90	108	39	56	98	85	95	62	63	44	30	135	81	207	100	144	89	116	105	106	48	77	79	72	66	105	101	98	88	75	76	77	70	98	151	69	64	50	50	60	94	76	55	50	141	72	99	70	217	64	113	238	111	152	94	39	82	71	86	118	38	38	60	98	62	63	149	83	94	44	66	84	54	73	166	68	185	46	62	126	108	76	75	61	79	48	117	60	115	38	221	93	71	47	94	93	59	59	104	148	76	101	57	72	65	78	37	42	75	48	75	119	84	44	57	87	50	52	59	132	73	71	144	75	147	146	72	38	57	52	38	38	54	59	92	79	56	78	83	57	99	79	47	36	69	107	70	43	41	74	26	34	47	98	65	148	86	51	96	57	71	77	98	51	102	87	57	35	80	37	60	57	31	43	97	51	91	44	105	55	55	59	50	32	66	78	58	89	53	72	43	49	64	32	54	45	53	36	75	87	32	47	95	51	56	64	65	127	51	61	46	28	72	46	26	113	42	77	104	20	45	44	94	39	59	83	57	22	112	34	52	134	80	40	67	58	66	63	53	65	98	36	47	29	40	44	39	56	46	68	26	103	36	50	51	57	43	31	71	41	108	68	36	48	48	42	49	65	69	64	18	76	62	81	54	54	28	56	17	47	54	16	22	41	40	42	86	77	60	20	63	31	33	77	28	60	55	48	45	35	30	84	37	31	36	49	90	67	30	71	36	29	20	51	26	29	48	89	48	51	71	31	13	56	126	64	37	51	24	35	57	73	54	19	44	62	38	149	41	61	28	59	60	36	30	46	23	50	29	28	38	27	82	25	73	49	58	76	23	138	41	13	70	29	50	39	45	46	49	61	67	18	53	32	79	53	26	38	25	41	38	42	46	54	120	46	35	47	59	23	42	17	48	31	37	29	48	49	32	30	21	32	21	42	31	23	44	41	11	49	25	44	17	52	23	25	34	22	51	21	33	53	37	15	29	20	47	114	28	23	145	38	31	33	34	38	33	62	20	36	32	16	32	31	32	29	22	29	11	20	29	18	30	26	24	25	38	4	40	14	49	22	28	19	16	30	11	29	14	12	25	26	49	23	29	31	43	15	22	59	19	11	21	33	44	36	42	28	20	26	68	25	13	28	15	47	32	31	45	13	45	21	27	47	33	51	28	17	35	100	21	21	95	38	16	16	52	43	27	12	47	29	23	16	33	15	101	31	16	9	18	15	14	15	11	20	31	21	24	30	18	22	27	26	41	20	19	11	17	21	27	9	35	19	27	16	25	11	31	21	27	32	18	23	36	21	18	30	13	78	14	36	19	7	10	22	16	47	10	40	23	11	27	17	13	21	17	11	23	21	8	17	31	20	24	11	25	12	13	26	18	30	17	28	36	17	8	9	24	24	17	6	21	20	23	6	24	26	7	25	27	15	32	9	9	26	10	11	14	5	14	10	29	41	19	6	29	15	14	16	13	19	10	10	17	5	12	11	14	7	10	20	5	6	6	28	20	19	9	3	12	13	11	7	9	10	14	29	7	7	17	18	16	13	13	9	6	13	24	34	12	18	16	14	10	13	16	12	8	9	5	10	10	22	3	5	7	15	16	7	6	20	7	6	6	12	3	12	9	2	5	70	2	7	1	10	3	4	15	7	5	7	5	8	27	22	5	9	4	1	16	9	16	2	8	10	7	1	8	4	4	4	4	23	4	27	35	11	2	2	1	4	15	3	6	1	15	25	6	1	2	4	1	4	7	7	3	155	1	2	1	1	1	0	0	11	1	0	1	6	14	0	6	6	1	0	0	4	4	0	0	1	0
ne0278	4091	3581	2356	2228	1647	2268	2113	1801	1721	1878	1470	1748	2028	1675	1308	1485	1643	1459	1296	1408	1231	1441	1158	1454	1053	1166	1096	1051	1334	1193	950	1245	1077	1403	1016	893	1239	911	1177	785	1160	1030	1406	918	1185	1198	1246	1060	1069	901	1082	855	804	955	1159	1049	968	671	939	948	994	826	583	688	795	886	1111	788	923	795	740	569	823	730	651	529	910	843	863	791	1009	786	1008	853	553	971	852	736	665	756	884	575	930	632	642	584	904	704	736	812	792	695	801	947	783	738	630	907	788	833	732	695	965	985	920	574	842	648	758	860	718	983	500	737	611	692	755	650	829	884	656	652	592	547	679	360	1096	620	855	685	775	761	680	560	375	831	528	526	769	618	781	596	741	579	567	611	770	578	853	771	754	508	694	608	586	418	584	451	574	728	589	595	682	646	770	498	545	806	474	483	804	577	523	498	512	453	506	537	561	508	461	534	708	641	544	696	695	771	527	638	418	685	486	614	409	635	617	496	506	626	763	520	714	496	397	502	528	276	478	449	273	534	342	523	406	506	455	427	592	533	446	524	495	476	599	441	308	321	368	486	406	449	542	448	338	439	677	442	644	378	445	368	470	419	478	679	353	502	402	473	496	373	416	431	361	438	514	352	396	359	468	409	519	409	364	447	309	612	485	415	369	331	385	349	314	346	381	469	299	552	452	542	250	429	449	391	504	473	395	443	230	407	329	398	443	342	426	345	356	370	480	378	277	404	298	285	433	319	434	448	372	339	384	358	344	406	402	436	390	361	605	482	462	426	356	423	439	257	397	356	382	433	398	318	414	428	343	343	278	283	321	329	301	405	360	528	381	435	332	351	260	312	452	237	315	331	389	435	403	377	354	213	277	426	357	316	311	272	383	346	369	234	307	432	483	376	442	218	307	336	320	365	327	334	462	347	374	425	281	357	320	340	462	380	356	342	269	291	429	384	316	275	342	403	415	284	223	311	252	477	308	249	338	342	294	290	335	353	302	298	303	202	278	330	270	284	352	351	253	301	407	187	311	409	273	335	328	246	271	325	314	315	295	307	217	167	257	265	449	336	390	411	229	237	229	242	206	228	247	411	219	315	318	287	326	236	344	254	181	250	229	252	191	281	291	316	365	345	340	280	213	275	241	287	195	269	274	283	376	308	242	301	272	323	327	276	215	283	278	340	284	202	294	211	250	204	272	219	347	318	258	180	220	232	318	257	291	215	227	230	265	302	280	269	181	157	279	259	167	295	203	220	185	286	237	459	179	279	186	377	230	262	314	318	196	183	267	224	333	256	228	274	342	309	267	303	270	280	255	232	313	194	240	207	236	314	200	305	266	220	285	234	255	238	253	234	279	250	210	332	252	187	260	122	265	181	245	214	258	239	261	204	167	363	204	190	147	118	138	134	147	153	158	162	195	166	173	249	218	155	188	133	229	188	230	318	177	145	164	209	251	98	207	183	160	146	155	267	292	229	218	134	200	198	179	192	174	166	124	211	165	248	154	164	237	138	236	240	198	190	216	243	201	258	188	249	175	241	184	264	156	124	230	335	161	276	197	142	183	161	137	219	168	155	116	138	238	161	118	89	215	168	165	185	165	150	192	118	215	78	238	304	180	173	202	166	196	205	262	156	131	206	257	126	102	168	141	122	169	109	146	160	205	86	144	118	203	219	180	165	208	146	195	193	166	158	92	227	173	274	145	225	209	111	219	182	221	181	159	176	142	164	136	218	157	155	179	157	132	194	154	192	150	149	163	88	385	212	182	165	167	134	197	189	154	145	184	169	179	165	157	156	175	164	116	159	189	139	154	152	187	173	180	114	116	171	196	195	171	140	159	142	177	167	145	180	162	179	139	168	93	151	148	130	117	180	112	168	165	136	163	147	181	192	242	131	151	96	109	114	219	111	91	211	125	120	176	108	86	234	217	189	278	172	150	184	195	156	157	68	129	145	123	90	70	124	188	100	76	81	112	169	118	108	176	78	89	103	69	98	126	133	118	170	174	144	136	135	148	194	123	154	141	176	117	93	185	56	154	180	136	139	79	95	124	173	144	98	134	182	132	115	142	103	79	131	221	142	142	149	103	158	118	128	174	109	91	114	142	94	94	137	165	221	102	95	122	165	113	98	97	203	118	78	150	105	83	107	105	135	146	185	117	161	100	154	141	82	117	115	99	123	65	133	90	104	134	137	96	99	120	68	120	246	66	102	150	112	93	70	106	102	127	135	108	144	149	136	105	238	155	94	101	143	96	111	240	67	88	76	98	101	120	113	83	82	89	86	162	135	131	152	79	67	91	111	144	71	143	178	189	147	94	115	210	110	59	107	97	129	86	76	98	79	116	106	99	97	82	109	126	71	135	100	119	95	107	59	54	103	68	108	123	69	67	41	109	93	187	151	182	69	86	113	137	104	124	108	124	72	107	137	130	100	89	73	73	77	100	188	86	72	73	89	63	107	77	50	35	169	169	81	156	141	93	125	206	146	119	81	64	77	95	128	93	60	83	99	135	81	93	126	98	94	80	72	78	91	86	175	125	124	54	85	115	138	85	117	65	90	53	116	141	97	58	175	100	90	131	96	126	84	89	103	99	56	100	66	98	62	148	49	128	52	78	102	123	108	48	51	81	51	77	70	86	94	69	157	116	122	122	60	42	94	63	85	44	105	92	51	68	91	60	60	84	88	96	54	39	79	81	68	57	80	70	95	58	56	96	58	148	50	73	94	69	54	54	127	46	112	86	53	82	97	43	75	73	48	53	108	68	101	183	88	76	65	59	76	61	60	74	62	98	122	118	92	49	58	46	80	70	58	41	65	97	42	78	75	77	37	91	86	110	46	117	52	41	101	103	68	83	83	76	104	54	62	72	86	35	39	61	50	31	99	31	63	171	92	53	58	87	74	65	58	67	65	46	47	30	49	69	103	56	72	77	25	69	68	64	57	82	39	38	36	55	40	63	57	60	63	57	68	79	77	73	63	61	61	63	58	49	26	59	68	70	55	22	55	42	41	55	71	60	54	89	51	31	39	64	59	63	56	40	67	39	33	111	29	58	47	29	59	70	43	67	50	39	30	66	47	70	55	98	69	42	52	71	40	67	110	76	53	81	55	29	44	81	66	37	24	72	73	133	41	61	46	65	50	68	54	32	22	54	36	24	58	74	50	52	57	45	82	87	51	56	45	55	70	37	58	33	53	43	94	68	63	23	44	46	70	62	29	78	64	45	44	54	58	40	123	30	55	71	67	62	42	18	23	38	43	21	56	39	84	88	34	36	42	32	24	36	32	63	27	50	62	29	28	40	24	96	42	69	64	29	31	60	42	19	38	38	38	76	52	17	115	30	116	21	37	36	28	41	28	42	55	87	36	39	52	30	60	31	20	53	80	88	28	40	26	43	42	24	115	62	59	22	78	23	34	32	32	28	22	50	26	24	85	42	64	53	49	18	17	41	30	41	30	59	41	33	33	41	17	13	46	25	36	39	15	47	29	51	38	9	18	66	40	58	51	63	34	32	32	73	60	29	73	21	36	24	32	44	28	38	42	46	13	33	42	25	64	46	26	19	20	22	19	14	13	23	49	25	30	34	14	14	70	20	23	25	27	39	16	29	18	30	40	33	28	19	50	32	32	34	22	28	43	20	24	12	27	39	19	57	16	27	29	36	15	23	8	37	7	132	18	37	24	48	9	25	27	22	35	15	21	41	20	44	34	12	29	11	21	31	37	10	20	23	20	27	17	14	31	20	23	24	26	14	26	15	20	21	43	32	43	31	35	17	19	25	27	11	27	13	13	13	23	31	31	5	47	15	15	10	21	34	10	20	21	21	14	31	10	23	17	17	3	38	9	20	9	15	19	10	16	9	8	6	10	7	10	28	17	6	6	24	27	13	16	13	10	19	15	10	9	11	28	7	17	8	10	15	3	16	17	12	13	13	18	7	10	23	13	13	6	8	13	4	3	5	7	9	5	19	8	86	6	13	9	11	10	6	9	9	10	18	7	14	33	13	5	13	8	1	14	16	14	1	2	1	14	5	4	7	3	13	9	5	7	21	17	3	4	9	1	7	21	10	3	4	21	1	9	4	3	6	5	7	3	16	4	137	2	0	3	0	1	0	1	5	1	0	1	6	18	0	5	2	4	0	0	2	4	0	1	0	0
ne0279	3117	2806	1609	1416	892	1660	1542	1291	1086	1196	901	1095	1462	1203	1281	1239	1290	737	1248	926	812	1158	827	908	724	833	846	860	994	1126	616	912	733	905	876	734	860	583	768	641	998	706	586	782	816	898	1020	906	1026	664	655	585	449	628	782	922	445	318	724	495	658	611	323	318	493	672	745	600	612	414	526	473	635	487	389	286	567	588	628	463	705	517	578	509	317	557	534	486	631	649	591	463	600	408	450	589	535	490	595	486	622	543	474	672	639	464	481	594	583	637	565	702	579	610	491	540	472	594	321	482	450	650	217	588	528	509	520	295	448	462	383	523	303	371	421	277	430	386	533	445	485	693	411	384	276	576	492	285	607	503	608	379	663	472	410	307	573	308	473	507	430	333	459	515	485	272	414	364	268	485	599	365	515	610	405	366	355	432	304	272	383	433	333	321	284	239	333	409	336	375	323	451	325	380	303	467	462	424	407	413	366	262	233	421	206	446	401	386	495	434	402	462	400	411	588	481	280	239	396	272	200	258	206	478	482	464	269	431	359	295	340	428	360	258	448	437	254	261	256	301	383	240	478	414	161	294	536	292	402	337	266	205	343	243	388	362	234	413	346	329	316	298	279	368	172	373	418	298	257	315	379	318	414	292	272	260	204	397	326	250	204	235	202	210	220	176	379	331	257	371	252	423	165	260	384	235	376	294	372	314	248	284	244	254	379	259	288	383	260	208	204	203	179	285	225	145	342	350	312	389	259	264	246	231	333	346	320	267	314	182	293	417	378	336	293	329	352	226	304	225	249	382	391	266	342	261	327	262	115	195	297	287	250	282	255	410	306	223	211	165	211	189	398	150	321	260	282	289	376	351	235	84	219	270	232	240	176	207	270	265	248	241	228	316	275	278	212	219	252	208	238	282	264	286	229	236	212	237	164	196	261	230	324	304	285	147	192	292	346	206	163	223	228	316	258	200	215	237	192	437	298	107	290	342	303	181	354	254	166	176	195	170	171	221	212	228	169	144	182	228	175	201	184	237	145	248	172	109	252	237	203	164	318	207	129	106	234	148	161	242	261	195	157	278	101	140	141	145	169	163	212	279	222	221	334	163	230	119	72	189	133	138	252	171	205	166	256	293	222	217	136	169	100	125	124	182	148	253	179	263	92	204	209	233	237	213	107	177	308	227	165	196	208	102	167	234	201	174	217	172	172	119	155	250	153	179	204	153	164	304	189	285	240	135	158	116	86	216	70	170	139	110	154	192	91	148	133	150	128	288	153	181	240	130	194	183	209	124	220	182	129	219	213	119	193	263	150	211	116	136	150	106	80	127	162	167	138	170	203	138	153	150	150	181	246	130	153	185	178	182	148	134	146	95	92	178	238	116	216	171	177	106	110	250	127	112	83	85	63	108	102	128	101	62	140	62	128	196	197	122	122	75	119	141	225	197	108	136	123	125	171	92	135	214	79	119	65	176	127	119	144	156	177	150	95	75	134	149	93	140	96	125	116	116	133	127	180	149	204	141	199	199	103	133	145	177	138	168	142	138	72	55	180	193	122	137	92	98	161	156	121	134	128	84	115	187	192	84	93	43	126	126	136	118	97	78	217	137	221	40	122	187	112	123	158	161	173	153	234	103	66	168	132	119	101	98	116	118	162	162	95	89	159	62	52	77	102	199	125	72	183	103	135	122	140	54	71	172	153	77	123	75	96	164	169	114	61	95	125	93	79	112	72	150	75	128	161	102	166	88	109	162	113	153	98	43	161	203	84	113	82	73	157	109	131	116	135	113	139	94	159	151	119	113	65	64	149	103	81	97	113	118	83	78	87	116	153	165	136	79	127	88	75	135	90	144	110	156	127	144	85	72	129	53	45	200	83	150	116	72	199	98	84	105	178	102	126	68	76	106	37	59	99	162	144	86	100	86	58	104	99	101	132	100	104	119	109	98	99	44	84	65	99	102	58	76	101	76	49	58	75	85	114	87	134	53	53	73	57	53	64	100	104	180	107	115	160	73	75	113	129	142	116	160	74	81	129	46	132	98	93	75	39	65	79	102	121	78	86	104	122	103	120	60	84	45	242	118	44	97	69	110	87	87	76	120	66	126	107	35	109	131	49	185	86	59	53	140	77	35	67	130	84	79	69	80	69	110	86	136	52	143	50	138	112	106	133	110	44	81	68	73	30	95	61	79	63	78	61	49	137	74	78	113	45	39	138	94	35	76	77	77	92	123	70	27	80	88	142	106	115	55	62	117	43	123	97	50	76	70	69	137	42	45	24	70	77	63	81	88	80	108	27	90	69	86	85	36	56	129	130	117	48	59	223	58	36	63	68	92	87	56	107	56	62	76	61	85	71	52	59	54	118	81	79	71	53	52	68	91	51	60	97	83	27	36	108	68	118	97	107	50	100	73	67	31	82	68	63	49	76	67	60	83	33	38	70	50	114	117	58	55	49	38	34	88	58	31	37	102	69	113	51	159	26	123	69	101	102	65	30	64	59	66	75	27	23	46	64	62	66	91	88	60	50	48	64	49	57	132	24	83	46	58	113	82	56	73	18	54	34	84	66	95	43	106	51	61	74	95	87	64	64	76	49	63	94	35	49	39	57	30	38	54	58	74	51	71	34	19	52	26	23	27	118	89	80	77	59	111	89	54	56	39	15	29	37	90	50	48	49	68	35	71	35	34	52	30	27	75	68	58	24	74	64	23	68	67	80	68	102	61	56	69	69	76	63	74	53	120	74	50	41	68	25	60	78	24	26	51	43	51	30	68	27	54	72	76	72	58	78	26	70	41	46	45	21	37	19	60	35	56	28	44	59	33	51	58	24	34	37	42	70	46	52	43	68	59	35	65	82	32	56	67	12	66	44	64	26	57	36	30	28	78	47	50	97	63	47	58	60	47	64	17	70	61	25	38	23	36	37	33	19	33	55	33	65	31	37	28	58	19	46	34	46	36	33	58	34	37	44	44	63	57	34	7	54	37	53	42	49	41	35	4	48	56	18	21	33	54	32	74	55	52	27	36	17	33	50	39	46	41	75	35	29	19	56	25	33	51	36	72	46	17	33	30	33	21	46	14	17	68	87	32	32	43	41	12	37	64	63	20	57	46	39	25	34	35	17	22	115	49	72	33	33	31	44	54	43	40	45	22	51	44	17	22	33	56	22	50	50	27	29	15	124	27	38	45	40	33	43	43	47	31	77	44	5	20	19	85	38	21	34	21	49	24	32	53	43	89	26	28	29	29	39	40	18	34	31	20	11	65	34	28	25	13	21	20	62	35	15	19	28	17	36	21	41	14	26	15	36	25	25	56	12	17	45	47	11	21	16	38	26	49	18	44	36	22	9	21	24	21	35	20	47	15	9	23	16	10	14	21	28	7	11	22	13	24	25	17	47	26	26	9	53	38	17	19	27	18	22	18	25	18	16	23	16	40	48	41	14	49	7	17	18	15	28	26	31	41	20	46	33	22	27	39	31	24	37	11	24	59	23	23	10	18	30	33	32	18	47	21	12	18	25	16	18	19	19	16	10	36	42	26	12	24	17	6	16	8	14	30	45	23	3	15	12	29	18	14	7	30	10	28	16	12	18	12	16	21	20	18	8	33	14	11	16	38	10	19	15	12	14	33	7	8	19	15	15	13	15	10	17	14	35	29	22	10	5	17	28	10	17	6	37	2	4	22	12	5	16	13	7	26	15	8	11	10	18	12	4	29	11	6	20	21	36	12	18	22	16	30	8	25	19	18	9	4	18	29	6	6	9	9	18	26	8	19	6	5	24	11	11	6	9	15	12	19	16	10	6	24	4	6	15	17	18	10	9	6	6	25	30	8	11	14	15	11	13	8	16	19	9	3	8	13	6	14	4	8	5	12	17	4	9	15	10	27	9	8	12	6	16	12	7	12	2	28	11	8	4	10	12	6	4	7	11	10	21	0	5	4	6	12	6	0	16	11	3	15	8	4	4	1	14	1	25	2	9	3	18	8	7	4	6	6	10	5	3	11	5	2	3	2	0	4	9	3	1	8	5	6	1	0	2	0	2	2	1	2	12	19	10	8	0	3	3	3	4	2	8	9	8	9	5	0	3	2	15	5	4	4	30	2	1	0	11	1	3	0	1	1	0	1	4	5	1	3	7	1	3	0	5	0	2	1	0	0
ne0280	2834	3118	1712	1959	1187	1652	1674	1265	1210	1344	1232	1323	1295	1144	1012	996	1189	969	1192	1013	1072	1262	806	1145	676	899	819	774	1094	874	694	936	695	872	921	760	764	658	710	669	962	706	841	623	941	890	801	650	892	692	844	650	562	805	907	813	557	454	708	603	643	620	496	582	527	680	766	643	595	510	631	473	674	581	535	465	654	626	542	581	643	514	700	731	406	595	535	520	530	547	771	505	607	435	568	469	621	523	567	617	557	593	612	683	591	455	497	616	552	861	552	497	634	666	572	459	582	572	401	544	645	627	383	519	537	699	491	482	575	561	464	462	405	407	438	458	513	451	525	456	537	589	643	364	352	544	489	401	567	375	510	470	472	430	458	399	568	375	563	545	530	428	459	369	517	342	402	407	349	597	544	388	481	476	478	378	376	505	340	312	672	485	370	412	405	303	394	511	332	413	434	372	602	445	334	561	564	488	396	378	315	271	447	490	357	397	455	342	413	399	485	409	466	350	396	369	326	264	356	351	289	329	235	371	396	424	362	376	391	378	308	373	325	367	434	352	306	259	295	384	422	296	386	354	306	273	415	336	382	379	341	303	378	327	462	423	350	385	395	308	443	335	333	279	222	319	374	355	272	312	361	303	378	273	329	365	296	459	289	259	270	266	316	236	388	194	316	391	286	404	274	343	237	272	376	266	428	357	311	303	218	267	249	267	353	261	260	299	308	239	259	305	222	283	282	270	304	271	277	328	279	234	270	317	251	393	284	288	273	230	407	335	263	276	274	333	340	340	355	277	292	316	369	367	263	289	272	234	262	273	215	253	229	361	257	314	268	311	237	217	197	240	667	218	309	285	295	324	319	274	292	148	255	331	255	247	256	228	301	225	349	201	231	293	246	359	258	176	219	307	308	292	256	238	316	264	232	272	191	231	243	315	267	285	281	193	184	191	242	245	210	223	266	256	342	263	219	293	181	380	229	141	388	332	259	332	281	296	247	216	319	192	238	227	262	226	202	269	163	197	247	174	235	221	177	188	196	228	206	287	200	223	230	185	152	139	242	213	184	256	257	216	176	199	156	182	149	250	173	292	215	227	213	271	325	161	221	210	155	387	240	272	179	203	231	168	334	284	289	180	193	157	131	167	159	139	174	243	212	266	185	218	215	418	316	223	133	171	198	257	167	175	222	210	143	197	178	186	217	260	162	137	151	268	208	203	220	153	183	115	158	238	216	144	211	139	201	204	151	155	160	128	166	181	117	274	152	163	137	325	244	174	208	160	127	166	221	158	424	160	216	215	268	216	186	229	137	220	144	153	154	178	138	147	150	294	175	192	238	187	172	149	222	165	243	170	265	159	176	226	134	155	253	92	172	170	202	149	214	165	185	166	132	286	129	126	111	132	120	150	200	117	111	84	127	92	132	162	238	124	140	123	144	113	243	233	104	128	202	179	210	122	164	159	99	107	135	184	127	160	181	198	171	169	109	143	125	147	110	184	79	145	132	153	122	135	153	229	190	106	234	215	166	197	166	224	180	231	167	158	129	76	176	262	149	174	120	102	116	124	109	165	106	153	176	158	175	139	85	76	130	128	144	174	129	134	145	105	237	77	144	189	112	150	131	128	156	224	159	137	113	150	142	101	101	114	155	120	135	119	132	121	160	78	95	100	133	214	110	127	162	121	155	155	144	116	124	190	110	123	126	110	152	141	203	121	125	138	125	159	180	103	97	151	100	104	156	110	126	156	155	139	115	148	137	75	198	191	84	104	147	136	148	139	83	139	144	141	118	123	141	109	129	108	70	113	220	143	99	123	131	156	121	85	138	118	141	133	91	103	137	100	99	92	132	112	122	157	118	142	67	185	124	122	67	196	86	126	159	81	177	146	177	167	186	104	111	85	74	120	91	85	86	149	106	113	109	93	68	174	96	82	220	117	111	97	103	118	76	89	83	76	82	127	70	81	98	67	61	128	91	124	89	81	129	76	58	72	61	85	93	77	123	155	131	152	103	72	103	109	107	106	111	148	83	126	150	50	96	117	65	83	53	80	76	147	132	115	71	131	107	92	88	65	76	70	178	128	74	84	123	137	89	87	85	134	53	91	115	86	91	124	127	131	70	73	95	96	79	100	88	99	115	66	93	102	58	87	79	111	54	139	90	154	93	139	120	98	75	84	101	76	49	92	64	67	89	88	77	69	102	89	75	158	53	50	98	98	87	111	98	106	83	111	96	51	90	105	137	117	67	66	81	74	62	91	102	46	67	78	88	85	45	95	75	73	71	74	155	128	77	120	39	79	64	85	102	108	73	88	102	105	76	182	167	79	47	83	77	98	66	82	82	52	78	84	123	107	80	70	96	63	89	77	74	70	100	28	81	81	60	60	91	107	45	51	102	66	129	100	81	45	66	82	81	63	90	78	59	51	65	90	96	98	58	46	47	84	129	122	61	60	55	49	50	85	72	31	44	113	78	79	73	206	54	76	73	120	109	52	42	51	67	75	55	46	37	59	76	48	72	144	117	73	49	71	47	62	66	103	51	92	45	73	87	66	59	106	30	59	53	78	76	97	39	93	87	67	52	77	66	62	74	90	82	33	80	63	71	39	75	35	56	68	46	66	69	78	49	53	64	33	49	38	31	98	64	86	111	100	126	62	50	43	46	51	22	153	56	44	42	53	35	67	49	47	61	52	32	43	68	61	26	77	63	45	70	59	94	30	96	67	45	98	48	113	61	74	54	77	43	55	37	106	41	65	87	53	98	74	73	62	46	62	42	44	53	80	46	68	67	38	71	72	67	45	58	31	41	68	46	49	31	57	105	36	75	38	55	58	59	42	56	51	59	39	42	75	62	59	93	72	61	60	26	55	37	91	31	44	52	43	37	94	95	42	75	71	71	70	54	53	81	33	66	46	36	23	38	40	29	41	48	48	72	48	52	30	52	31	87	71	43	68	28	68	49	52	47	56	53	36	81	70	32	21	62	54	55	49	42	97	50	19	45	27	15	24	36	53	30	63	54	51	37	48	29	49	47	40	49	30	52	36	32	18	67	34	31	43	63	73	60	47	67	34	24	35	55	36	26	44	83	37	26	37	47	11	33	55	65	36	60	54	47	45	49	33	31	27	75	37	81	41	63	51	41	47	30	28	37	25	49	35	19	29	24	35	24	79	38	33	60	37	35	27	45	47	21	27	42	43	34	43	93	47	15	38	35	86	48	38	39	50	41	50	52	32	35	81	32	36	33	52	31	33	21	35	35	30	16	55	47	30	47	25	39	22	43	45	40	32	34	66	45	16	34	25	33	21	66	42	18	67	21	32	41	23	28	31	22	33	171	53	17	72	38	42	23	27	23	31	33	18	47	31	21	33	29	29	32	9	47	30	14	32	12	20	42	31	38	37	13	77	47	69	16	24	34	36	28	16	18	18	27	16	19	70	48	40	35	56	29	18	39	13	21	19	43	37	34	32	36	28	21	33	17	50	41	6	16	26	20	26	16	15	34	39	49	27	43	13	31	11	40	25	23	42	32	31	26	22	43	14	13	14	28	15	34	22	27	52	30	23	14	27	13	26	8	11	14	48	16	21	30	22	15	23	22	25	39	19	15	21	21	25	10	37	12	18	14	26	17	30	12	14	21	24	18	14	23	24	28	20	34	16	34	16	18	44	19	18	23	9	34	12	8	19	18	4	16	21	11	26	27	11	16	17	17	31	6	39	21	13	27	13	20	25	37	29	11	21	11	8	38	24	6	12	13	34	116	23	10	14	21	15	10	21	22	20	17	7	22	11	10	12	12	71	25	11	19	44	12	8	16	10	18	4	15	13	11	7	18	11	15	28	28	10	12	9	17	17	9	6	6	15	15	26	5	13	11	7	15	11	7	12	10	25	8	12	20	11	16	20	20	13	5	13	14	9	8	14	20	7	12	5	10	10	31	3	12	8	13	8	12	4	5	11	7	8	15	53	8	4	16	5	36	2	9	5	15	13	7	12	7	12	5	8	8	15	12	8	8	9	6	15	10	13	2	17	8	9	4	4	1	2	5	6	6	6	47	12	11	4	4	5	1	9	7	5	0	17	9	14	4	1	4	2	2	0	5	5	51	1	6	3	9	0	0	1	4	0	3	1	0	2	2	6	2	3	4	0	0	6	0	2	0	0
ne0281	3538	3227	1883	2137	1241	2317	2152	1748	1274	1402	1287	1679	1464	1527	1176	1380	1621	1001	1476	1341	1232	1351	935	1168	752	936	850	972	1142	952	779	1114	894	1173	955	880	1015	726	865	794	998	953	856	717	1030	1042	1073	924	1116	876	1121	801	616	992	1113	994	608	587	773	650	871	635	447	571	732	815	969	641	762	606	589	621	722	614	595	475	625	677	706	618	862	672	964	759	412	793	630	640	601	711	732	645	910	526	540	652	823	540	636	675	545	649	631	958	658	630	535	830	661	999	588	681	873	864	794	540	809	704	441	776	608	879	436	636	650	673	618	523	770	729	553	583	444	406	563	451	522	467	722	544	598	768	676	485	391	575	549	407	700	502	696	520	572	475	528	412	656	439	766	522	569	439	598	419	603	388	496	410	398	599	527	474	590	449	648	362	452	698	431	350	650	551	418	523	399	331	384	541	370	457	441	545	585	537	390	646	556	694	457	390	444	315	416	472	371	529	434	450	505	480	670	452	428	479	504	393	411	270	482	368	311	352	309	511	353	442	469	423	473	398	312	500	405	339	466	406	320	276	381	412	413	339	524	444	322	362	446	382	435	409	351	323	442	353	537	593	306	461	309	377	424	348	306	399	272	404	468	381	347	312	383	343	497	294	429	379	459	527	287	306	245	333	316	282	339	265	310	408	343	490	323	419	257	329	528	285	476	321	422	268	300	196	339	364	437	362	306	284	347	260	253	288	261	352	309	261	403	199	385	344	322	302	317	348	283	444	343	341	340	235	473	458	349	392	275	416	372	327	488	279	354	439	448	331	347	295	381	216	257	258	299	297	284	380	261	399	290	343	262	282	294	237	568	244	323	235	325	345	371	393	242	131	261	305	274	246	311	239	294	306	468	304	226	336	241	342	279	205	278	270	336	336	390	247	284	286	291	302	210	239	318	290	379	302	357	233	250	341	306	254	216	261	235	319	264	305	278	346	283	423	278	164	411	332	308	336	257	324	250	252	332	188	165	227	282	271	207	226	193	227	301	187	233	239	236	234	204	213	192	326	200	249	381	231	166	186	264	193	195	317	312	263	200	329	178	256	173	167	208	280	347	321	264	230	344	214	297	208	141	293	244	204	265	225	264	172	351	317	332	164	234	158	174	159	169	181	210	280	222	322	186	272	240	389	345	274	175	188	308	301	232	210	187	244	191	149	191	158	244	257	182	156	180	247	230	211	195	188	171	265	229	253	257	161	234	162	225	226	145	218	207	141	139	226	132	356	240	184	181	351	191	186	266	189	189	155	277	145	395	191	223	223	291	193	215	249	174	203	210	158	203	191	148	160	161	289	215	211	249	179	185	181	193	174	233	177	247	206	161	299	161	225	166	105	147	185	207	166	220	192	187	194	152	184	136	132	159	124	108	233	196	202	138	95	150	104	159	194	279	143	170	134	151	127	250	257	190	167	170	127	218	149	164	201	123	139	128	171	189	168	177	203	121	204	136	153	150	177	124	157	140	172	139	141	136	157	221	242	175	152	260	252	191	218	171	211	141	184	178	209	108	104	187	307	156	178	119	109	183	113	141	148	173	139	212	146	211	139	193	67	127	156	163	166	107	119	203	133	229	66	151	187	142	152	176	141	196	142	231	138	129	144	131	167	129	138	233	124	160	138	189	102	162	92	95	125	148	202	125	136	175	109	157	155	143	118	106	204	124	123	145	137	180	169	224	131	138	118	163	123	156	112	111	166	79	138	175	154	100	139	155	171	144	150	126	99	185	227	95	129	120	119	179	125	113	145	163	162	154	123	204	189	177	147	109	117	223	201	124	132	109	143	147	89	165	143	147	173	118	113	163	116	94	113	195	163	112	133	155	163	68	158	170	54	66	162	108	139	147	88	167	133	140	146	186	113	147	82	116	90	81	78	109	194	119	103	118	110	70	124	122	94	269	145	126	85	127	73	94	76	81	73	160	139	81	103	95	97	66	139	100	120	142	114	170	80	87	63	80	90	89	82	170	191	151	93	171	79	83	123	85	148	103	159	136	100	190	52	111	170	112	105	61	75	92	158	174	127	110	169	147	89	108	96	84	90	163	133	65	108	69	166	132	132	96	137	57	111	124	54	129	147	169	189	74	83	91	119	94	66	86	133	98	104	81	108	78	133	120	112	51	129	82	144	104	143	149	106	80	142	102	88	47	115	52	86	66	130	81	64	121	79	93	213	68	88	143	102	88	135	99	119	117	177	90	50	121	125	126	148	96	67	77	125	76	97	119	67	103	74	97	134	67	98	61	90	96	73	124	140	94	133	58	91	71	94	119	68	61	118	133	149	101	172	128	86	63	69	94	111	77	76	104	57	97	133	108	93	83	85	87	61	92	129	94	80	88	47	92	115	69	59	88	98	42	71	128	79	146	104	104	75	87	112	96	50	89	56	76	60	102	101	119	82	108	74	103	78	121	125	60	81	106	60	74	106	86	43	49	136	91	122	83	210	75	105	156	104	125	69	52	75	71	109	91	51	36	73	88	72	71	159	97	91	55	64	82	75	72	133	71	140	53	70	109	81	87	75	34	62	54	92	132	118	44	160	96	80	73	131	105	54	97	92	76	49	87	66	57	53	64	48	40	97	66	63	99	82	33	57	66	68	65	50	47	72	64	141	62	108	139	55	62	47	59	35	47	66	50	61	63	61	35	99	57	48	79	56	45	82	60	72	39	58	67	51	51	54	94	53	149	64	63	106	59	66	62	93	40	81	88	55	35	97	35	70	74	55	52	80	56	79	40	77	55	80	83	45	34	72	76	30	82	63	48	58	35	80	40	69	43	45	39	72	82	37	57	44	64	86	73	58	79	56	46	52	28	87	42	49	108	47	85	80	31	47	36	66	28	53	52	33	49	93	94	56	107	89	72	67	66	75	62	45	72	78	32	45	25	43	35	38	49	46	75	71	77	45	56	43	68	68	43	77	44	63	59	62	41	60	64	60	68	65	44	25	67	55	75	46	35	94	79	30	45	31	24	66	30	47	45	73	57	32	42	56	32	32	52	75	92	54	66	44	33	24	65	30	44	30	63	97	71	34	62	51	42	41	60	33	16	55	86	54	48	44	84	43	33	100	73	37	53	42	33	60	78	52	31	33	68	40	110	45	71	61	82	55	34	46	41	23	24	38	27	44	19	51	36	86	43	43	55	47	49	35	33	48	26	34	49	55	63	30	65	41	17	54	43	61	49	28	75	30	52	41	43	40	37	113	55	46	54	56	37	33	35	57	38	19	36	50	34	64	32	13	57	30	64	54	45	40	50	32	58	26	49	24	73	16	39	27	37	35	22	32	64	29	17	49	26	31	89	35	28	93	36	60	17	35	39	45	46	31	31	64	16	38	21	44	39	20	59	13	13	37	12	24	37	30	29	33	16	88	51	29	18	26	15	22	36	31	24	28	25	35	18	51	42	29	58	47	18	33	48	10	18	20	38	57	28	43	26	36	30	54	16	17	14	15	20	45	36	27	14	54	40	52	45	27	54	17	35	20	76	27	28	62	28	17	14	20	30	25	22	39	31	19	60	27	31	73	39	28	15	18	18	37	13	14	11	41	16	32	26	31	14	24	40	38	48	20	11	17	18	12	19	45	17	39	20	18	41	58	18	19	30	8	30	31	22	19	31	19	65	18	47	8	17	21	21	38	37	18	48	26	9	29	16	12	20	16	18	17	36	7	17	27	22	15	14	49	26	18	27	22	21	14	21	28	20	13	5	17	27	24	10	27	26	24	17	12	22	7	20	36	7	27	18	10	31	6	24	21	9	17	11	42	50	17	13	29	10	9	15	12	16	8	8	10	7	16	14	22	19	16	16	7	24	14	24	16	5	11	12	13	13	35	9	11	14	12	25	14	6	25	5	22	12	10	10	16	5	19	13	15	11	23	15	11	8	8	16	8	11	15	7	17	18	7	18	11	10	10	20	4	10	26	9	10	6	3	8	3	9	5	56	4	13	7	33	28	10	7	1	10	8	10	8	30	22	2	18	8	7	10	8	6	4	15	8	7	6	3	20	0	6	16	5	1	38	19	7	4	3	3	9	19	1	3	6	12	4	4	3	1	3	0	7	6	1	1	122	3	8	2	3	3	0	1	6	1	1	0	1	6	2	5	4	1	0	0	0	2	5	1	1	0
ne0282	3145	3378	1864	1750	1409	1912	1988	1545	1363	1309	1323	1655	1572	1458	1263	1264	1433	1061	1344	1245	1197	1271	853	1152	832	913	956	928	1085	994	809	1049	856	1107	1011	787	969	715	884	863	894	792	899	736	1073	1122	1001	794	1037	817	1007	767	608	939	987	982	646	591	752	722	835	688	477	653	571	798	938	810	657	590	611	649	723	634	584	605	712	713	662	638	757	585	894	702	448	784	657	622	514	632	838	608	811	549	552	552	765	731	710	805	589	703	594	816	622	590	555	777	554	859	604	668	780	858	774	494	748	665	419	716	691	776	390	585	598	690	586	584	741	702	511	595	464	430	518	396	506	474	677	457	621	681	701	395	384	681	533	404	590	494	566	496	636	481	440	420	562	386	724	565	511	471	540	467	587	341	476	514	326	723	657	475	536	593	644	389	393	669	365	368	398	592	459	520	428	320	457	489	427	426	480	427	538	509	470	685	481	690	510	477	357	350	432	513	452	510	415	357	516	401	656	480	413	451	360	426	383	271	492	411	338	428	256	454	403	461	386	445	403	374	320	437	403	455	508	422	364	264	378	401	509	333	426	372	297	372	531	371	406	390	378	301	427	330	512	579	317	388	338	383	454	396	336	322	322	420	403	340	366	369	495	314	432	293	415	306	352	519	343	319	280	313	345	291	372	203	394	431	274	441	275	449	243	313	363	290	496	376	389	289	287	253	280	314	382	309	284	320	316	265	279	247	258	353	323	270	353	285	514	367	340	324	310	273	277	408	298	341	288	334	487	422	338	370	344	401	326	272	410	322	393	427	459	254	354	308	322	289	319	269	277	228	240	354	263	387	332	331	240	347	244	235	433	245	292	375	283	382	303	314	308	203	269	321	261	278	274	261	325	254	236	250	236	354	300	363	330	222	244	273	280	259	339	253	319	281	306	284	193	316	273	297	327	284	350	200	226	281	283	279	223	271	247	317	331	305	242	337	246	430	289	152	361	378	308	244	370	318	220	249	446	267	263	250	262	271	233	252	242	200	263	182	253	255	254	256	297	273	224	289	275	268	259	209	193	180	273	232	197	309	330	261	151	243	161	229	190	179	206	253	117	226	255	254	312	192	276	220	153	257	203	229	213	217	272	172	308	317	348	204	204	203	168	161	148	182	179	257	255	288	236	294	227	292	373	256	208	201	295	266	198	189	221	258	189	175	183	184	235	268	177	187	178	260	239	183	230	155	178	161	217	231	230	168	198	145	260	238	124	199	187	188	179	226	128	279	173	204	175	379	237	181	248	190	151	140	260	162	408	185	226	318	280	220	223	269	150	221	157	182	254	216	139	174	182	324	312	324	274	208	181	169	231	229	213	317	214	192	230	359	159	184	236	111	242	179	189	164	213	175	201	164	178	172	144	169	119	119	131	116	166	186	134	109	142	128	162	176	271	138	133	140	177	163	209	255	175	122	137	173	199	120	180	201	105	95	126	162	156	182	232	200	187	170	119	161	183	199	96	187	110	144	133	128	210	152	181	258	177	141	281	217	161	245	178	237	177	228	214	176	163	111	234	337	174	200	120	111	247	138	156	147	137	162	132	132	156	105	147	105	152	132	171	198	112	118	169	119	260	76	200	164	154	146	168	156	217	171	204	174	157	109	136	125	132	151	188	129	146	123	136	83	165	84	112	102	160	217	129	125	194	113	154	243	155	106	175	171	134	93	153	129	240	148	166	140	136	165	170	158	106	109	142	171	140	153	148	143	87	159	136	132	154	113	142	107	279	256	105	130	83	141	177	185	85	137	129	158	147	139	178	135	157	145	119	124	192	166	166	165	97	133	116	94	121	120	135	154	101	137	148	141	107	107	148	123	140	166	132	144	77	115	152	115	83	235	102	160	203	90	227	144	109	152	226	132	148	76	116	105	159	90	104	137	108	106	119	81	78	92	89	104	273	131	108	106	90	111	83	83	128	73	99	177	104	120	120	76	61	118	83	111	105	101	134	109	55	93	99	100	56	122	112	169	175	130	114	98	114	134	101	134	115	176	102	103	151	63	77	132	86	99	65	80	75	127	120	152	78	122	132	91	118	87	78	86	226	108	76	147	114	137	139	85	105	108	93	100	128	78	122	164	163	151	76	75	94	136	133	59	56	127	106	104	114	116	65	112	69	109	59	153	105	131	95	142	95	111	82	113	137	59	50	106	79	62	65	107	46	72	107	82	85	243	52	54	136	92	83	100	108	100	87	121	90	72	106	114	155	118	87	93	95	96	69	106	90	70	113	68	91	104	74	100	71	90	87	71	148	135	91	112	65	118	78	87	101	76	77	105	102	140	100	107	119	86	90	78	88	91	90	89	88	91	79	115	191	125	99	112	86	55	105	121	108	69	103	49	102	90	111	62	79	107	54	45	114	68	161	102	83	72	104	120	89	77	86	101	132	65	85	124	84	81	56	59	55	89	148	116	127	89	155	75	82	88	78	52	51	121	77	85	98	146	57	97	197	111	106	67	66	79	82	86	79	63	67	71	91	56	79	105	134	99	66	69	68	74	66	145	61	132	32	100	97	112	71	90	76	77	42	104	81	120	49	199	93	59	68	99	90	67	89	71	102	57	116	64	77	55	67	65	82	103	41	100	123	124	54	59	93	44	55	53	55	76	57	143	82	135	113	53	47	70	52	49	46	72	55	66	56	54	54	79	60	58	96	38	51	81	104	84	52	51	65	48	38	47	70	51	149	49	61	105	62	82	64	91	40	86	76	53	61	96	27	47	84	46	50	75	47	82	51	61	76	61	50	53	50	64	66	21	97	153	61	62	36	60	46	65	55	43	44	63	109	40	47	52	63	43	68	50	103	65	48	54	42	83	61	45	119	71	84	112	37	50	55	69	33	64	54	50	42	94	79	74	134	85	78	71	65	58	68	36	79	57	47	36	29	47	43	36	39	53	74	32	54	40	41	37	80	74	43	53	36	56	70	54	57	35	92	55	68	72	40	42	83	68	61	69	60	66	54	42	43	28	27	54	36	57	51	66	67	68	37	82	29	41	54	73	63	47	57	35	44	32	121	36	50	41	49	61	48	53	60	37	46	27	66	25	42	40	72	53	42	44	41	30	27	117	67	58	53	33	46	58	70	46	25	39	100	31	136	39	60	49	33	64	49	43	23	27	34	44	25	36	33	49	47	74	57	70	76	37	46	70	28	67	35	44	39	57	64	34	51	37	17	49	44	106	42	35	63	43	45	38	59	45	47	72	60	40	28	50	39	35	32	80	35	62	40	38	46	56	38	17	49	19	44	42	44	29	43	27	73	34	52	14	29	13	40	25	35	53	18	23	39	31	21	36	23	42	159	66	22	100	44	54	25	34	44	46	42	26	40	36	22	54	18	26	35	18	44	24	25	24	26	23	44	25	45	20	13	42	40	50	9	90	25	27	58	19	30	28	34	33	21	60	38	45	25	56	36	19	71	13	24	25	29	35	20	27	28	42	33	56	23	18	33	23	23	34	39	20	22	23	24	33	35	32	60	30	34	16	81	33	23	69	36	36	12	38	32	24	28	49	19	28	32	14	19	69	27	25	15	20	18	27	26	27	24	49	12	19	24	28	6	20	29	45	32	20	13	15	20	24	18	39	22	36	15	33	34	43	24	11	18	19	19	28	19	14	35	40	54	17	28	23	14	9	31	24	44	18	34	7	4	25	19	9	13	16	11	29	31	14	19	27	21	20	15	12	18	12	19	22	13	31	35	19	23	20	9	12	20	23	11	6	19	35	12	18	24	7	19	32	9	47	23	21	22	6	21	12	12	14	18	44	35	18	10	48	8	26	22	13	14	11	9	4	11	9	22	12	17	14	10	15	13	11	29	15	11	8	9	12	11	19	9	9	15	12	24	24	5	14	18	31	7	13	14	8	11	16	16	13	6	11	16	11	6	8	8	8	17	17	7	16	20	7	12	4	5	9	15	3	8	6	7	3	13	7	10	7	11	5	54	9	14	9	14	6	10	6	6	5	7	12	5	25	24	4	7	4	0	7	9	5	5	10	8	6	3	4	6	3	4	5	4	5	34	21	13	6	3	7	8	16	6	8	5	1	2	8	1	5	4	2	4	1	1	0	124	3	2	2	4	1	0	0	11	3	3	6	0	14	1	4	2	1	1	1	2	5	0	1	0	0
ne0283	2588	2852	1800	1652	1531	1512	1419	1181	1183	974	1070	1251	1239	987	938	901	1001	1079	1106	913	957	1070	961	830	767	827	935	733	1149	955	732	1013	701	816	827	653	790	713	991	671	888	672	1084	630	821	797	770	595	753	687	636	669	550	611	814	703	631	564	656	572	613	627	586	567	512	668	675	707	701	572	531	483	600	529	632	471	566	563	561	697	641	618	582	604	406	582	635	546	490	569	554	457	633	468	522	486	560	562	595	536	434	458	601	643	520	475	500	580	606	627	510	516	537	539	539	395	495	475	1117	507	489	586	385	554	465	671	499	368	461	510	457	407	489	446	503	403	760	515	493	525	537	492	489	455	352	480	419	476	544	378	537	449	414	356	379	591	409	408	498	359	429	414	468	321	440	357	411	414	1120	350	514	438	457	444	442	393	309	478	442	408	456	460	383	411	355	637	362	344	491	478	357	326	526	431	426	390	431	425	400	382	310	402	472	453	466	373	468	325	410	401	457	440	535	282	364	422	437	286	379	330	275	345	254	365	356	503	299	372	454	379	348	366	414	499	425	405	260	283	248	409	409	263	332	394	411	261	427	293	465	356	274	323	352	299	337	372	242	339	372	425	297	296	319	263	325	315	341	356	388	322	361	309	302	245	358	273	290	384	315	366	303	264	308	340	276	614	329	351	292	410	242	395	216	286	383	299	293	296	252	299	266	213	255	238	302	249	350	333	294	291	270	253	235	310	298	236	315	346	290	339	269	235	279	302	270	262	266	358	261	285	421	310	249	204	274	311	334	253	359	231	287	329	368	368	249	326	291	269	221	259	273	253	276	308	236	276	279	335	364	330	234	298	275	242	258	299	307	298	285	282	206	262	223	245	296	478	248	177	348	231	252	193	228	264	360	369	332	195	199	286	262	267	337	348	196	249	262	288	516	165	319	220	252	271	283	241	226	242	211	227	259	295	219	231	344	270	190	285	210	317	223	402	242	280	237	191	231	292	200	207	199	181	241	232	218	221	297	254	231	225	165	245	217	274	201	216	225	236	213	215	253	151	241	209	156	159	184	231	300	227	256	285	186	231	173	264	189	154	176	230	222	207	184	257	345	155	217	176	210	377	269	144	145	326	292	320	244	237	191	228	222	193	253	205	146	166	197	202	195	197	185	221	180	181	193	217	238	210	206	205	188	211	194	179	154	197	210	200	220	171	190	155	175	185	187	190	234	176	191	173	189	272	228	199	146	120	198	210	130	241	191	186	171	199	231	252	174	141	123	339	161	198	207	183	118	155	232	176	231	179	199	197	216	166	190	222	171	221	334	204	136	181	128	180	159	167	256	156	162	175	153	150	165	236	173	207	200	210	201	235	176	143	145	152	178	209	182	193	158	147	156	173	164	187	132	190	133	92	124	172	154	129	142	202	173	134	166	172	167	111	271	113	150	135	207	185	207	141	147	150	208	92	180	206	135	104	118	165	337	224	151	275	175	173	158	158	155	168	102	155	107	220	105	143	167	113	192	158	156	196	192	202	186	168	185	184	132	164	140	164	131	91	165	189	120	190	147	119	168	198	101	163	117	111	126	151	178	196	81	144	159	101	154	188	254	105	130	96	204	80	189	116	160	149	141	94	198	106	228	151	87	114	192	78	107	140	108	126	98	111	102	138	151	81	131	78	113	216	114	165	165	122	132	158	154	103	118	157	154	174	103	188	113	155	180	127	132	132	101	117	198	115	125	214	124	142	156	97	227	274	132	154	99	108	98	141	217	143	178	121	166	102	121	100	78	127	123	125	112	118	125	125	94	141	80	130	198	96	130	135	115	137	132	104	110	106	132	144	131	170	141	110	195	113	88	113	135	143	150	122	94	181	155	100	37	176	97	111	148	89	189	130	193	151	154	128	144	75	78	94	117	92	69	169	81	100	109	75	70	114	99	144	124	99	131	91	90	100	96	76	134	97	101	103	97	108	114	106	86	88	118	124	84	131	122	98	95	83	98	110	105	101	107	123	119	105	106	78	115	161	97	96	121	140	85	92	144	56	180	117	69	104	70	54	77	133	126	89	104	125	92	91	142	66	88	94	138	101	116	128	135	119	119	108	134	94	72	99	121	65	100	117	107	144	69	103	71	145	104	78	119	169	113	87	94	90	42	83	110	120	288	105	79	122	66	110	102	82	78	84	95	120	82	69	77	112	178	131	54	79	78	80	95	152	57	72	113	94	63	82	108	86	117	105	75	63	66	83	94	116	90	71	61	156	114	83	84	49	55	51	72	80	81	139	91	61	56	68	131	89	124	129	155	91	91	94	105	75	151	100	104	108	93	79	106	77	92	96	70	106	65	79	70	82	104	105	87	100	77	87	96	114	79	86	89	75	69	32	65	82	67	62	79	70	162	38	83	44	131	75	149	61	60	57	59	71	76	63	85	56	61	105	86	50	56	66	47	94	92	101	64	65	85	109	59	79	70	52	40	118	102	81	145	134	78	82	163	109	86	55	42	72	99	84	64	59	95	81	91	71	69	104	84	89	38	70	58	89	56	107	66	102	82	81	96	92	64	67	43	55	39	92	121	79	45	84	87	69	83	91	83	77	81	92	108	41	128	52	63	40	91	28	83	70	48	109	73	108	62	48	83	33	50	53	76	69	69	109	71	123	87	40	51	60	59	42	44	45	84	79	66	70	64	56	51	55	59	47	49	88	59	42	33	154	29	142	46	52	44	82	121	74	45	100	44	54	77	73	45	71	70	58	48	113	43	72	81	42	84	63	38	65	83	39	66	56	45	169	45	62	69	39	63	106	60	50	36	43	46	74	56	47	28	63	100	55	44	58	57	68	80	87	52	62	145	64	35	80	99	147	38	67	74	65	85	64	61	67	31	63	49	72	30	58	45	71	91	86	52	54	48	61	58	51	53	41	37	44	37	63	63	74	52	48	60	67	53	67	39	41	69	31	31	33	34	40	41	57	54	50	60	56	56	43	52	93	43	37	49	53	46	36	73	107	63	40	23	44	29	37	53	47	55	46	32	56	40	36	46	56	64	39	36	29	30	21	84	52	182	55	42	55	71	30	56	42	23	30	60	46	60	50	69	51	35	74	91	41	36	62	59	43	67	140	29	48	52	38	50	33	80	32	97	41	36	66	51	39	37	38	27	30	51	43	19	47	32	40	28	52	35	81	54	57	43	28	124	40	24	97	29	35	34	67	59	37	22	39	29	30	50	28	48	31	29	35	41	33	43	104	43	52	47	55	35	29	37	37	45	42	26	46	32	52	78	41	37	13	54	34	35	27	72	39	61	44	30	36	28	40	28	24	25	29	20	24	62	37	26	50	48	30	76	57	24	89	23	25	19	32	31	35	35	24	44	34	141	29	33	48	25	19	45	47	22	47	40	14	29	23	41	43	17	91	44	31	31	52	36	12	37	22	34	41	45	29	10	43	28	56	38	25	29	46	50	30	27	18	64	37	31	35	34	20	38	32	17	53	36	29	20	33	26	26	18	26	63	24	48	55	44	47	36	20	70	53	22	56	19	21	10	24	46	14	38	29	25	15	33	26	24	69	31	24	16	11	12	15	26	16	11	33	26	18	24	18	18	38	17	27	10	28	24	12	14	12	18	22	34	13	12	15	26	37	40	9	19	26	24	17	21	28	47	43	51	11	19	39	5	10	25	10	43	10	33	16	23	22	116	12	18	15	9	19	32	29	57	21	55	24	26	12	22	19	40	16	21	17	26	11	20	25	8	27	28	16	30	16	17	20	8	30	11	18	32	29	14	36	12	11	19	17	19	22	8	17	12	122	22	18	16	26	10	20	10	21	37	11	20	21	12	20	17	9	19	13	22	8	39	6	18	8	13	13	8	10	10	17	12	45	6	16	27	10	7	9	11	22	11	10	12	7	9	14	21	5	3	8	9	17	17	7	10	32	9	14	10	15	22	13	15	13	20	13	18	12	5	8	8	10	7	10	13	7	34	18	27	21	9	5	13	13	8	2	8	18	11	7	7	19	15	14	5	13	2	7	9	12	10	13	4	3	5	3	5	2	8	29	3	1	29	7	4	5	2	8	10	12	11	1	0	9	1	18	2	4	6	5	2	4	3	0	95	1	3	8	6	0	20	2	6	4	0	0	1	9	2	2	2	1	1	1	2	0	0	1	1	0
ne0284	2583	3161	1994	1835	1390	1754	1774	1437	1191	1000	1161	1428	1280	1217	1070	1210	1244	1030	1405	1122	942	1174	949	1286	810	922	840	749	1028	896	764	919	784	963	801	648	904	678	762	671	953	820	917	623	931	936	935	686	952	677	895	709	624	725	927	813	608	579	593	696	699	634	441	507	600	645	756	651	690	522	628	644	671	476	547	486	556	639	548	590	702	513	769	729	405	670	629	593	631	516	699	597	721	400	488	607	667	617	640	663	452	581	612	770	618	508	536	607	574	983	514	572	648	663	655	555	609	551	490	552	481	733	428	556	518	540	558	625	596	552	462	475	429	439	400	340	517	478	564	504	494	592	774	453	357	487	508	374	540	412	571	495	467	477	431	428	528	383	573	513	472	403	503	369	576	360	478	338	393	603	502	469	525	505	509	414	352	573	366	378	402	493	422	387	441	321	417	468	372	381	391	353	565	485	340	598	595	537	336	364	316	275	488	426	401	481	406	372	401	356	525	298	465	323	459	307	356	252	402	349	272	502	291	355	336	354	355	383	386	387	277	384	355	354	396	414	305	238	349	418	366	360	498	361	245	328	399	332	438	346	375	327	440	321	433	452	352	364	326	340	356	297	338	265	295	353	405	299	313	300	355	329	360	315	368	450	419	471	303	321	263	285	320	256	307	222	283	396	263	401	265	434	216	242	387	281	411	222	342	288	219	191	199	255	327	480	234	207	256	268	274	293	213	322	243	244	263	229	349	275	280	268	296	283	235	365	303	299	267	300	386	341	251	516	265	267	293	253	412	269	301	291	415	257	264	268	246	281	255	214	276	284	279	244	241	289	294	352	242	304	242	210	551	209	287	342	329	240	276	258	274	203	198	286	252	237	234	266	285	295	298	197	242	273	282	254	309	188	231	239	284	327	328	225	268	312	208	288	208	296	290	239	281	259	296	240	218	295	225	247	194	246	204	274	377	208	193	248	211	378	270	176	288	278	287	227	305	263	172	190	300	187	186	219	240	215	233	244	202	255	229	173	182	257	205	250	223	171	204	257	204	265	362	228	154	166	248	192	240	236	302	218	182	292	164	245	179	206	192	227	332	214	236	266	351	189	215	201	123	337	153	178	185	172	247	161	300	218	304	197	172	233	166	176	143	196	177	239	182	241	192	232	244	451	293	206	167	185	234	219	200	178	173	217	193	141	219	121	226	218	193	146	161	246	217	226	204	144	206	254	191	247	193	142	186	132	259	210	178	200	207	147	128	210	149	313	179	150	154	352	156	150	198	180	126	146	192	168	428	201	194	273	254	177	222	209	165	199	222	126	252	132	150	158	204	252	203	262	161	169	164	149	167	216	191	196	235	186	177	240	133	161	197	92	158	204	175	173	162	156	144	172	149	144	169	141	113	121	122	185	140	192	118	88	149	97	219	193	240	130	117	142	126	177	240	218	143	120	139	174	222	226	163	222	101	96	93	203	149	165	179	300	122	170	158	144	158	138	104	177	102	150	104	127	161	138	167	230	166	211	249	223	163	178	179	167	181	165	141	140	153	100	158	273	107	167	88	115	164	128	167	155	131	132	124	149	134	74	133	94	136	108	143	173	108	116	159	79	248	60	132	181	153	161	129	126	124	159	205	136	104	136	181	96	97	122	206	122	124	156	146	84	136	72	135	104	95	187	146	122	136	99	146	148	136	83	112	194	123	119	180	145	180	164	154	134	152	133	137	117	82	142	128	195	128	137	110	115	120	143	147	143	94	132	143	71	226	175	122	153	84	114	111	111	102	134	142	139	116	119	129	150	154	138	93	100	197	169	144	121	100	182	117	95	90	90	116	123	107	120	110	132	97	106	152	147	107	107	163	128	94	79	174	123	83	202	91	142	110	95	258	114	92	165	146	128	144	83	104	111	98	86	99	141	97	89	106	89	73	81	92	110	204	134	105	61	93	89	74	89	98	74	120	135	103	87	112	104	68	76	108	101	88	108	104	88	70	99	70	80	76	107	127	108	154	109	120	100	122	113	95	96	100	133	91	111	150	60	108	152	117	63	65	60	86	113	114	102	93	107	129	84	112	89	92	78	164	103	98	104	103	142	120	99	88	159	65	104	131	53	126	92	115	159	76	66	77	120	67	73	80	117	87	93	121	106	84	118	124	94	102	113	95	155	69	134	93	122	78	92	104	83	65	87	85	62	79	114	42	90	85	89	96	175	95	77	99	74	66	78	55	77	107	148	86	63	95	100	123	122	93	77	54	115	76	85	98	55	93	81	78	92	65	105	74	69	90	88	130	103	107	75	65	97	71	55	84	86	98	114	103	102	89	97	138	78	69	59	81	84	99	73	106	59	78	97	114	62	52	72	64	75	102	92	96	78	63	47	104	73	72	57	72	81	38	38	100	60	133	96	103	58	75	98	92	51	84	77	66	49	68	103	79	75	66	60	59	100	110	115	72	57	66	64	57	72	63	49	39	96	76	97	75	165	70	76	147	84	92	59	63	61	67	68	70	72	66	77	88	65	65	147	102	71	86	60	53	74	69	122	50	120	53	83	88	104	59	71	45	80	47	89	97	73	64	104	79	55	60	101	83	86	68	80	92	64	76	62	57	66	90	53	79	80	54	86	79	78	47	58	59	70	50	49	66	81	49	113	89	112	130	38	44	58	49	49	64	62	60	61	54	53	66	60	69	60	68	34	52	82	76	59	39	86	58	42	89	67	86	55	130	87	56	97	58	60	43	71	42	76	75	48	48	95	54	55	50	56	45	77	44	61	57	91	45	69	56	48	37	50	58	42	61	56	79	69	28	40	28	51	37	58	45	74	99	45	53	94	58	81	73	78	66	57	70	53	52	66	55	68	53	53	49	86	24	53	63	63	28	70	48	47	37	65	33	49	92	102	38	65	51	62	63	47	58	68	41	39	27	52	58	53	48	41	107	60	52	51	61	30	65	64	38	60	36	56	53	63	52	61	57	46	82	54	56	34	57	50	53	45	50	36	49	42	66	37	24	39	42	79	37	58	57	47	32	66	37	38	46	76	66	38	56	53	36	29	102	39	49	35	78	48	58	38	49	38	34	29	58	32	34	58	75	60	36	44	96	33	30	83	51	39	79	46	31	61	46	33	27	37	57	43	84	53	45	57	55	53	34	35	29	20	28	48	28	37	28	53	42	47	54	66	73	35	53	48	38	47	25	56	42	52	52	45	69	43	23	40	43	67	50	45	51	50	50	32	53	47	54	91	36	52	77	49	35	50	20	28	47	32	23	42	57	31	41	25	46	31	39	24	87	39	38	32	52	35	43	39	75	26	42	28	29	55	19	32	59	29	33	32	19	30	136	29	30	84	41	51	23	44	31	59	38	39	27	45	17	49	33	18	34	24	51	18	16	32	19	32	23	28	61	20	15	49	58	54	37	29	24	27	33	24	17	17	37	43	17	45	45	49	41	52	14	29	52	17	21	24	40	41	25	28	19	20	37	40	40	19	22	27	21	22	47	30	24	52	47	21	92	42	36	14	40	19	76	14	29	65	39	18	18	38	47	31	20	33	20	27	44	20	24	67	20	35	12	21	19	27	42	8	14	44	13	69	23	45	13	19	21	27	24	16	12	12	21	13	17	29	22	18	18	52	22	44	18	14	24	31	28	35	26	17	40	18	60	13	34	31	13	23	25	21	31	11	21	7	22	20	16	9	17	19	8	25	23	14	28	26	15	22	16	137	17	10	24	27	14	35	16	22	19	18	15	30	22	15	15	4	22	31	31	19	21	11	25	19	10	48	13	23	21	15	22	18	6	13	12	49	13	14	17	29	16	10	11	22	21	7	12	10	8	15	20	9	24	28	15	14	8	8	12	13	5	12	14	8	14	21	13	18	12	12	14	7	9	13	8	21	11	11	16	14	8	12	16	18	8	17	14	17	10	6	19	11	7	18	6	11	23	8	14	11	16	8	19	9	6	7	12	10	9	8	8	22	11	8	41	4	21	9	21	9	19	13	2	16	10	6	17	21	16	5	8	4	6	7	9	14	4	16	6	11	3	7	5	2	1	7	11	7	52	4	12	18	5	4	3	17	4	2	30	9	3	13	3	3	1	1	7	5	4	7	97	8	10	2	4	3	2	1	14	1	0	3	3	8	1	4	5	4	1	0	0	1	0	0	1	0
ne0285	2311	2703	1758	1379	1307	1611	1591	1314	1035	958	1027	1278	1182	1023	889	1036	1067	1038	1193	998	890	1074	851	944	747	705	780	674	958	814	754	893	748	816	784	639	853	633	699	533	797	782	858	565	811	756	830	617	683	712	726	635	558	555	819	723	607	551	593	574	613	511	344	475	567	580	647	526	610	591	584	552	605	491	530	443	491	528	578	668	661	535	743	647	305	591	610	561	530	530	620	507	645	425	542	526	572	539	523	562	395	570	568	636	620	483	488	547	486	880	503	479	585	566	556	536	520	437	480	522	537	610	407	509	460	423	465	580	525	526	442	381	438	356	382	272	516	493	524	482	495	539	630	407	340	387	416	329	513	295	573	424	392	400	331	434	452	364	475	438	477	394	483	322	518	349	373	303	495	481	388	444	489	428	458	340	274	483	357	372	269	490	354	392	349	392	327	419	401	392	365	258	546	440	369	557	392	471	306	326	290	348	465	440	467	435	432	302	335	315	452	253	395	273	321	289	384	219	379	287	225	350	290	289	263	263	334	373	438	392	267	338	289	335	394	302	243	204	281	393	271	337	410	319	268	236	371	340	449	325	421	289	368	305	347	395	306	338	235	293	430	243	334	210	255	261	350	304	308	260	299	251	373	290	278	234	437	386	281	349	298	223	356	264	258	259	263	322	245	326	175	386	225	237	283	270	378	240	265	241	188	185	222	208	267	278	244	208	228	260	232	288	237	340	310	240	254	211	231	236	321	282	273	255	257	389	225	354	285	254	418	283	289	219	209	263	304	194	329	220	260	269	351	155	278	308	244	235	322	272	240	272	263	270	212	262	231	288	224	385	192	238	351	189	217	284	259	253	218	243	260	156	160	300	220	224	233	218	230	254	228	166	232	266	262	205	325	162	208	250	195	243	288	209	188	266	232	289	249	213	200	210	297	214	218	217	180	234	228	199	185	209	204	258	304	209	175	177	163	353	238	142	249	252	240	152	219	204	173	209	285	179	206	214	279	211	186	227	188	187	193	167	213	246	150	212	193	179	188	222	194	157	283	196	139	165	215	199	195	187	277	242	145	211	159	241	152	165	168	189	177	146	228	237	263	190	176	181	170	332	112	155	132	210	200	194	256	209	283	206	224	203	168	152	99	175	182	219	210	190	220	199	204	269	298	177	238	181	191	191	195	173	171	282	147	121	181	135	229	273	194	126	124	203	192	184	222	145	169	192	148	216	141	155	161	110	281	237	161	192	204	129	117	188	118	261	183	153	138	241	173	181	198	229	131	144	188	131	299	168	159	207	236	175	174	205	138	144	202	146	168	138	157	123	176	253	136	149	159	149	123	169	206	193	159	157	179	158	155	188	150	154	162	80	137	163	138	172	147	164	123	154	118	118	144	161	115	135	112	156	155	165	100	105	131	123	182	154	134	107	154	126	133	119	192	210	134	126	97	160	214	85	153	151	107	75	109	170	175	168	152	283	86	137	122	146	144	156	76	156	90	173	95	131	143	125	133	215	126	156	165	171	194	207	125	141	178	167	122	165	158	78	167	257	136	136	129	125	129	149	145	119	109	134	154	92	128	119	122	89	134	107	98	194	128	111	152	81	208	86	111	153	115	170	137	95	112	127	205	130	81	104	136	77	95	115	164	116	147	92	129	81	111	58	124	110	90	128	123	142	157	79	173	117	132	90	72	156	97	134	136	108	216	108	150	105	148	119	125	130	52	113	112	129	91	102	97	121	101	157	161	103	108	114	132	75	170	137	145	173	47	102	94	108	97	135	146	117	116	109	99	134	144	146	79	98	227	138	116	92	108	143	96	85	124	102	130	96	102	114	77	109	87	118	126	145	79	79	129	104	73	51	158	137	64	158	98	129	118	102	180	90	86	161	182	104	104	97	91	90	85	96	76	153	117	90	95	74	69	73	96	96	212	123	106	74	82	78	78	70	104	122	98	73	101	90	115	96	51	105	108	107	93	91	119	77	82	100	63	89	63	106	85	77	100	98	119	99	106	113	100	75	82	97	105	108	134	29	141	127	80	84	60	72	90	102	89	82	73	104	118	109	99	80	75	66	111	91	88	81	91	103	87	82	101	100	98	93	141	75	86	68	105	158	78	76	93	99	78	68	85	142	79	69	108	105	45	94	73	85	86	77	83	110	60	121	106	95	78	69	91	55	39	78	82	52	96	115	43	70	67	71	113	154	68	82	130	75	52	76	72	83	77	106	89	76	108	77	108	96	81	63	42	82	61	81	64	67	88	73	74	57	59	89	59	68	82	60	125	56	84	66	65	49	71	66	83	48	91	123	97	55	69	61	68	84	54	65	63	71	80	61	75	53	69	87	90	66	57	62	100	103	83	55	92	69	79	48	87	49	57	50	73	61	47	45	73	44	101	91	117	63	68	60	108	34	71	63	78	62	52	103	70	42	62	60	52	98	93	149	54	62	51	50	45	83	45	43	49	96	63	53	73	123	62	91	97	86	72	45	38	71	81	82	44	48	38	60	100	65	53	102	64	61	60	68	62	65	75	137	60	88	44	60	89	98	47	68	46	87	47	90	109	74	46	86	72	65	70	85	90	58	60	60	74	46	58	36	57	58	80	38	65	68	55	89	81	74	43	41	61	66	56	32	45	52	56	85	52	64	113	30	36	50	65	64	53	33	66	61	41	70	70	55	49	47	59	37	37	59	59	50	37	68	59	62	101	59	71	66	90	46	51	95	60	62	58	48	56	77	82	62	40	59	26	57	52	48	45	55	32	56	45	120	52	80	57	68	43	56	62	29	40	56	76	50	35	34	44	41	52	40	22	46	102	35	22	80	41	61	54	54	63	66	79	58	21	49	53	78	50	43	49	63	35	30	42	62	30	46	22	24	44	89	62	35	47	70	53	55	37	47	41	38	54	57	48	39	23	58	39	45	59	39	80	75	67	48	40	36	88	81	36	45	34	63	37	54	39	51	52	46	92	55	51	43	53	36	32	37	19	61	52	56	50	33	30	29	35	60	46	54	56	32	35	49	26	34	51	62	35	21	42	26	25	39	54	61	50	32	28	54	46	32	43	29	46	38	46	32	51	55	81	44	35	42	83	24	27	55	39	38	45	51	29	44	45	36	38	33	47	32	50	51	42	36	33	36	46	46	30	35	22	34	28	35	36	29	27	49	62	41	83	24	21	23	43	24	28	44	36	36	31	32	60	54	24	47	29	38	64	24	43	34	38	28	34	51	42	78	24	41	95	44	38	45	18	31	31	56	24	31	11	40	36	22	41	21	30	18	77	30	41	23	50	21	15	22	39	15	16	24	28	28	10	26	34	32	15	43	23	23	105	34	23	46	32	40	14	36	20	48	30	22	21	61	36	30	20	27	29	11	41	22	13	32	29	18	28	19	46	21	10	36	54	29	20	28	29	16	30	18	37	30	26	31	16	56	35	32	33	38	14	22	26	10	23	18	46	34	8	19	19	8	24	31	24	26	19	30	17	20	37	33	16	33	23	24	116	51	24	17	21	14	38	37	23	45	33	25	10	18	31	20	14	40	25	16	16	23	15	32	21	20	18	11	11	24	23	15	45	28	11	31	32	36	13	20	17	17	22	29	18	8	14	8	10	31	19	11	8	38	22	20	30	15	22	17	23	25	10	8	40	17	38	10	30	21	4	18	19	20	23	8	22	9	11	16	26	12	17	14	18	21	22	22	34	16	13	19	8	7	8	13	27	11	17	21	15	7	18	12	5	22	25	21	15	11	16	20	30	14	10	16	22	20	8	68	13	12	21	6	21	9	8	13	7	15	26	8	10	32	12	4	10	25	14	3	7	5	12	7	18	11	13	11	4	12	23	8	11	4	6	24	6	18	8	12	8	19	9	10	19	10	10	10	17	20	6	11	3	4	11	15	18	10	43	19	11	8	11	16	13	7	4	9	9	17	25	7	3	11	7	11	5	6	14	7	8	9	7	12	5	6	6	9	19	5	7	4	14	15	52	27	4	7	6	7	7	11	13	3	9	8	6	38	9	5	4	6	5	5	2	7	5	2	2	18	5	7	54	6	6	8	4	6	4	10	1	2	15	9	1	3	0	5	4	1	8	0	10	1	46	2	5	3	0	3	2	0	8	0	2	0	6	6	2	4	2	1	0	1	9	0	0	2	0	0
ne0286	2128	2961	1778	1467	1125	1489	1624	1223	941	1046	1018	1137	1028	967	850	1078	1067	839	1149	909	763	1032	861	903	707	783	705	666	989	690	575	791	641	836	791	534	769	558	631	494	821	691	754	603	860	780	771	619	830	634	715	606	457	621	684	726	508	482	521	468	619	525	376	406	498	542	622	542	638	446	616	578	567	397	509	365	411	486	477	566	597	430	633	679	324	548	536	490	642	484	583	503	626	384	488	509	500	502	558	589	403	576	482	629	541	399	557	506	484	691	479	501	523	519	499	527	465	578	408	490	395	591	337	454	433	510	452	395	452	442	355	408	371	395	330	274	494	364	471	394	373	584	566	356	328	384	397	256	397	312	501	395	355	392	335	322	408	320	478	354	388	342	441	279	537	323	384	283	306	493	456	352	435	408	397	415	253	452	299	322	391	493	299	319	309	282	323	384	291	343	354	228	466	364	303	526	433	424	256	279	297	228	402	409	340	392	332	313	355	285	393	226	376	315	399	248	316	229	309	273	222	306	300	272	247	328	242	394	346	327	288	299	313	330	325	393	280	203	259	343	269	313	494	267	198	233	318	271	355	378	329	266	400	229	356	362	367	287	282	309	316	255	330	210	221	322	366	303	246	250	329	275	319	286	235	299	303	355	268	298	242	235	270	215	252	145	270	339	262	362	197	394	194	205	306	263	350	188	297	288	192	201	176	244	254	314	180	205	197	183	220	287	206	320	248	187	214	178	273	226	223	273	256	246	169	280	272	260	232	216	336	338	228	287	230	255	256	197	336	209	286	230	381	218	274	284	215	178	219	258	272	248	269	228	246	247	226	296	195	226	189	215	430	213	194	303	256	236	230	197	227	161	164	237	192	207	188	159	219	241	284	188	205	268	185	226	230	195	202	170	224	232	292	167	211	244	195	258	150	209	247	208	294	202	263	168	146	248	202	229	146	182	253	256	336	182	177	184	146	331	276	101	277	257	270	162	274	163	148	180	324	170	174	179	223	267	142	208	204	185	144	163	206	257	149	202	168	157	200	223	158	173	288	187	160	118	245	173	207	240	253	241	150	227	154	208	121	142	135	197	191	158	203	266	308	166	181	190	153	263	136	174	141	118	233	131	256	203	256	166	193	159	98	99	137	152	129	214	161	178	158	190	199	294	281	148	137	176	156	214	158	140	172	208	153	135	159	102	182	202	154	159	174	258	196	194	145	140	152	189	144	198	107	122	161	107	218	193	125	138	225	142	142	164	99	282	190	118	125	225	222	144	171	161	113	119	171	127	355	183	151	188	200	142	158	193	144	177	117	106	136	96	127	102	171	197	186	179	128	184	148	142	155	177	177	130	201	122	118	187	109	136	157	95	123	206	139	167	139	153	149	134	109	123	132	117	117	151	107	156	162	138	124	89	126	92	146	164	215	125	92	76	137	86	175	163	122	116	98	153	186	110	117	199	91	116	121	195	106	110	152	232	115	140	91	116	148	176	99	125	78	114	117	86	130	105	167	190	160	155	200	164	106	153	142	130	113	169	133	152	91	90	129	187	101	128	74	100	154	110	92	103	110	121	157	123	98	116	121	62	99	113	83	142	113	79	142	82	166	62	95	147	110	130	123	138	98	134	197	97	114	93	114	80	97	90	131	96	138	144	116	82	129	72	107	94	102	123	121	97	130	94	164	94	103	65	87	134	85	104	127	88	142	125	135	95	151	115	129	102	84	115	92	176	66	99	76	120	80	93	156	110	112	147	96	57	176	134	93	142	74	103	110	87	76	79	113	119	108	78	96	118	159	128	84	98	189	111	80	89	70	124	63	66	117	71	112	98	123	104	67	106	63	113	108	135	73	110	164	108	56	92	158	128	89	182	75	91	116	64	219	124	86	98	157	130	120	103	68	132	66	71	45	119	104	77	91	88	53	84	74	70	149	108	112	55	65	118	77	86	75	83	107	69	76	73	107	70	68	112	68	96	79	105	86	103	63	89	93	91	63	75	122	83	152	88	119	80	98	98	110	78	91	118	93	60	103	63	90	93	90	66	66	65	67	86	103	117	64	79	120	69	134	70	60	50	143	83	55	125	83	96	54	74	74	139	51	75	107	64	100	80	107	131	84	52	70	85	71	52	68	102	70	88	79	76	39	81	79	62	54	96	76	103	60	96	103	122	46	65	74	72	43	69	68	54	65	91	49	48	44	63	89	127	71	94	75	66	78	109	44	85	52	108	65	51	108	89	95	109	76	62	85	93	51	74	58	39	76	79	103	63	39	62	48	59	53	79	67	78	63	82	46	82	70	49	69	45	52	87	91	81	47	74	103	75	41	53	56	67	53	63	92	38	63	85	124	77	59	55	74	65	91	78	113	46	60	23	78	63	62	44	60	69	39	41	79	64	85	85	65	46	74	70	89	43	62	57	60	57	63	68	70	63	63	47	47	60	115	78	84	44	79	43	77	55	34	44	36	95	58	74	50	123	50	79	84	60	73	41	61	81	45	77	34	35	33	59	75	82	58	97	93	52	45	39	53	52	65	92	35	84	44	56	101	66	60	39	41	93	33	66	105	78	32	81	57	77	56	112	67	79	49	60	69	66	57	45	37	59	48	30	55	49	33	84	60	70	50	31	47	47	51	32	50	54	51	95	73	70	93	40	35	21	47	38	36	60	60	55	73	49	66	68	55	26	46	34	35	64	61	49	37	56	42	37	82	55	104	66	86	52	50	62	50	51	75	66	37	64	65	49	35	62	43	37	43	41	42	76	30	41	29	79	59	72	56	40	36	72	55	19	42	62	71	34	38	46	26	34	31	52	42	44	57	36	43	64	45	53	51	53	54	53	50	48	28	56	52	39	45	36	40	65	19	39	66	52	26	44	42	37	28	77	73	29	66	74	36	54	35	51	39	32	60	59	31	28	23	46	54	17	46	38	55	39	47	26	58	30	53	87	41	63	32	71	56	62	33	32	52	41	57	42	41	24	39	33	61	19	15	71	37	23	61	32	25	22	31	64	23	40	46	42	31	45	29	36	51	59	37	28	68	47	32	31	79	23	25	28	66	76	51	21	60	31	27	46	43	31	40	56	66	46	22	33	46	20	24	55	51	17	48	23	29	30	41	43	22	17	46	31	47	28	41	18	32	39	18	38	30	15	35	41	32	28	15	36	23	34	52	27	41	26	39	37	17	39	27	50	38	41	43	24	73	38	16	31	37	54	44	11	52	31	37	20	28	26	56	54	40	46	71	70	30	43	18	33	40	49	11	25	31	29	22	21	38	22	39	24	70	23	31	19	40	31	38	22	39	25	29	30	17	23	15	33	34	29	22	25	29	26	133	51	22	63	37	32	21	38	22	55	30	32	31	34	23	23	29	13	30	10	42	6	12	17	16	25	13	13	53	20	7	52	29	36	21	25	14	10	31	18	29	15	19	46	27	51	39	30	38	40	8	19	32	6	13	14	31	44	18	22	23	17	17	29	31	14	19	14	14	28	20	21	25	34	21	41	76	26	43	18	16	18	45	13	30	40	30	20	16	26	31	20	24	37	29	12	24	22	12	45	18	35	12	13	14	33	35	6	17	23	9	40	14	38	8	15	11	24	18	14	13	18	18	10	25	31	8	22	23	42	14	20	24	10	20	15	24	16	10	16	17	13	36	11	46	15	8	15	18	30	23	20	22	6	15	22	18	11	9	18	11	18	18	8	34	20	21	22	9	47	14	9	46	16	13	24	25	18	20	13	9	20	9	14	7	7	27	30	16	17	14	10	33	16	16	34	14	9	21	8	16	9	4	4	3	57	13	8	4	32	9	6	14	15	15	5	15	5	7	12	6	9	18	11	11	10	9	10	10	15	6	10	9	5	4	21	12	8	5	10	16	9	8	19	9	22	14	12	5	6	14	18	16	12	10	14	20	6	6	19	14	8	2	7	8	7	32	3	9	16	4	5	14	5	15	5	8	3	7	1	2	8	0	2	16	1	10	6	25	4	11	13	2	16	6	7	1	18	17	3	11	9	7	6	21	7	3	11	6	7	4	2	6	2	2	2	8	4	20	5	3	8	4	2	4	15	4	1	19	11	3	7	0	5	2	1	14	3	2	9	38	2	11	5	1	1	1	0	3	2	1	3	0	2	0	4	0	3	0	1	1	2	0	0	5	0
ne0287	1161	1058	518	745	368	522	583	446	336	305	305	315	353	359	306	285	384	176	515	271	283	502	211	392	239	289	177	227	442	285	114	324	188	210	270	195	205	170	211	243	218	166	297	280	490	210	184	252	293	132	148	113	249	251	545	169	95	90	253	187	178	166	106	180	95	325	202	219	186	94	165	127	228	139	158	100	167	142	196	187	160	170	276	243	85	137	214	79	169	187	320	142	151	168	132	165	132	178	233	195	201	287	256	166	194	67	167	169	107	516	173	185	137	153	128	255	110	148	90	152	150	137	84	234	198	157	129	136	102	126	60	130	83	95	108	91	205	97	121	111	90	182	294	104	118	137	130	128	179	145	96	72	109	160	182	112	162	135	135	221	97	128	66	98	139	81	120	111	66	265	188	87	86	124	95	126	103	102	90	71	130	93	68	131	114	77	118	145	116	140	120	81	275	63	85	291	173	117	145	130	94	87	145	111	102	98	113	107	116	151	105	136	193	74	157	108	72	93	95	56	37	132	55	114	96	108	80	95	115	72	90	135	150	101	197	70	54	38	36	79	109	46	132	133	77	48	101	57	100	142	55	103	104	66	90	89	118	55	102	138	213	74	102	77	66	111	147	89	78	100	115	74	107	66	118	97	207	119	74	94	77	78	70	66	68	52	69	112	59	152	64	85	37	75	227	60	254	91	86	86	81	49	55	70	125	75	96	37	95	72	36	53	49	41	115	61	104	79	82	115	58	57	78	71	151	247	116	85	91	66	159	117	78	93	99	114	99	83	59	52	103	98	79	129	83	79	124	80	47	74	74	87	66	112	56	110	55	125	116	36	51	63	236	44	57	92	96	96	122	143	54	33	46	92	60	75	72	49	62	100	155	70	82	89	69	84	33	79	75	72	66	149	96	100	39	49	64	59	57	57	78	96	113	71	155	44	53	62	73	56	60	54	91	90	119	72	54	76	56	198	87	36	113	95	98	106	99	80	67	88	190	67	69	75	58	106	51	98	83	61	25	39	47	101	37	48	76	71	63	102	70	39	74	62	38	33	53	69	51	69	80	130	57	75	33	71	63	16	48	95	134	46	51	60	124	53	76	38	22	161	52	35	45	43	69	88	63	102	188	42	51	79	24	43	32	50	59	76	57	53	25	53	82	297	177	55	36	60	72	77	47	35	123	41	41	30	47	62	51	45	43	51	25	80	52	45	64	57	45	52	52	49	62	47	48	29	67	70	25	69	67	30	34	44	37	114	48	23	38	65	65	86	84	37	41	42	70	29	277	50	48	52	118	40	97	114	32	52	32	48	26	48	36	30	45	165	83	37	56	35	32	17	44	34	111	81	61	54	67	48	85	30	52	18	48	93	74	38	48	75	89	34	34	39	35	30	22	33	32	91	29	47	13	37	35	44	77	34	65	24	30	14	34	34	96	39	40	52	56	62	49	56	56	42	15	16	29	72	57	37	51	82	35	48	17	25	22	79	21	39	15	61	24	50	39	46	71	180	55	37	52	42	20	28	27	40	74	53	41	70	26	13	56	158	62	57	22	29	82	28	25	65	42	39	47	86	75	27	27	24	37	32	55	49	34	39	52	17	76	26	43	49	47	48	68	63	31	39	54	48	26	41	36	24	31	41	55	16	67	38	65	27	86	13	16	37	49	32	28	25	34	38	40	33	43	20	39	49	45	51	67	24	29	35	39	34	44	21	29	40	38	27	44	100	25	34	82	41	37	24	78	57	27	42	9	20	55	64	33	38	21	84	24	37	15	26	70	14	51	36	37	60	35	48	41	13	96	39	41	24	35	69	58	20	29	53	71	48	62	23	25	31	27	29	3	62	42	39	30	34	5	38	58	39	11	30	26	43	51	13	30	39	34	33	84	34	36	35	32	29	29	24	31	57	32	28	30	61	30	22	38	47	169	31	28	9	20	30	23	18	19	55	70	36	33	20	26	10	13	26	15	21	27	15	69	17	15	32	28	20	30	17	44	46	24	32	36	27	16	71	28	13	51	24	61	9	20	22	28	41	19	35	10	13	21	32	32	41	27	31	32	68	23	21	17	25	56	62	27	34	17	21	22	28	25	50	6	20	11	17	25	44	61	62	17	10	32	35	41	22	24	48	40	25	37	19	26	12	24	32	12	43	24	26	25	29	45	20	22	30	12	32	11	29	23	20	17	29	31	39	47	9	24	32	8	8	53	32	26	9	25	50	19	20	25	13	12	34	36	41	29	27	27	25	20	21	22	37	11	34	27	21	18	9	17	5	27	26	33	27	12	28	9	27	13	19	19	21	18	38	39	21	17	14	22	20	12	42	5	30	26	34	44	19	26	26	97	38	27	37	20	5	35	16	40	27	28	6	25	42	53	16	15	65	16	11	33	28	46	32	27	11	49	53	8	12	22	14	21	5	15	22	9	16	18	12	21	8	36	13	26	17	28	13	20	27	29	10	25	39	11	27	9	8	3	36	24	14	38	19	10	24	14	13	43	7	13	17	8	12	18	25	30	12	8	18	29	20	21	32	4	13	26	15	30	43	35	21	7	17	12	38	55	44	7	38	22	19	10	18	12	12	18	26	36	9	16	8	17	18	22	13	10	16	10	29	9	10	9	9	28	12	20	8	11	43	34	34	64	56	18	11	15	9	28	7	5	40	19	10	19	25	9	16	18	12	19	28	9	16	31	30	12	37	22	14	9	23	31	17	27	69	23	10	9	30	9	15	4	42	26	9	9	17	10	19	34	11	12	39	7	5	14	71	7	9	10	25	7	20	9	7	18	26	20	5	10	23	9	16	5	24	9	4	5	6	15	5	18	8	22	11	39	5	16	6	9	16	13	15	42	11	14	12	9	17	5	18	13	39	8	11	16	32	10	9	34	4	11	12	21	13	20	1	45	11	8	7	6	8	4	9	20	13	8	12	24	34	21	12	29	35	15	27	20	62	39	2	4	8	27	10	7	17	15	5	7	12	26	6	17	7	26	9	9	5	3	7	4	10	5	24	3	56	10	12	2	7	1	7	11	5	18	6	11	7	9	4	6	18	48	16	13	23	22	6	8	3	21	6	12	15	8	20	2	2	45	2	14	24	39	10	26	13	8	28	12	5	4	9	42	12	15	7	14	3	15	16	7	12	14	7	1	18	11	7	5	3	19	47	6	13	7	15	7	6	10	18	14	16	13	15	7	4	35	4	6	4	5	24	7	7	3	8	9	13	19	11	12	50	15	12	11	7	15	48	3	52	3	22	5	21	6	8	8	2	6	5	30	26	2	3	16	3	10	5	7	7	12	6	5	1	9	31	6	9	7	26	15	5	3	32	51	9	6	13	39	8	4	10	28	6	14	8	13	8	4	14	10	6	23	3	6	2	2	7	6	10	6	7	4	5	3	18	6	50	10	12	3	1	13	4	7	5	1	5	4	29	3	27	6	11	12	11	11	2	12	6	5	4	6	12	12	12	21	3	0	10	0	3	10	14	7	6	1	5	5	3	9	17	9	14	2	2	9	4	8	9	39	18	4	16	6	4	4	17	4	1	11	2	5	11	13	9	3	4	7	7	3	2	5	6	0	3	4	7	5	12	36	5	17	5	5	1	16	0	6	14	4	17	8	7	14	14	7	8	11	17	4	0	1	4	2	11	14	4	18	2	4	4	4	6	4	7	2	2	3	11	2	4	1	3	6	8	2	6	4	4	6	6	1	34	5	1	9	7	0	3	1	5	4	5	0	0	5	4	5	3	6	5	20	2	1	4	8	1	6	0	1	2	4	3	6	1	1	5	4	1	24	2	2	21	12	1	7	7	3	3	2	3	5	2	12	7	1	8	6	0	11	4	12	6	2	1	1	2	2	9	1	15	0	3	1	11	0	8	4	17	9	1	5	1	4	12	2	1	2	2	1	8	1	3	1	0	8	1	0	3	4	1	2	5	0	2	2	1	4	4	4	1	1	3	5	3	1	0	2	3	4	5	13	2	0	18	2	3	1	1	0	0	2	1	1	0	0	0	3	1	0	13	3	0	1	0	0	0	1	27	3	0	14	4	0	1	0	3	1	1	0	0	2	2	0	0	0	0	0	1	1	0	0	1	0	2	1	0	0	0	1	0	0	0	1	0	0	3	0	1	2	1	0	0	0	0	0	0	0	0
ne0288	630	416	241	448	207	246	252	191	206	244	149	157	181	170	149	140	181	160	138	127	165	264	99	162	113	132	118	151	186	135	101	169	165	153	117	102	123	124	134	125	126	103	169	174	170	137	134	142	71	82	98	105	105	146	189	126	74	72	93	104	100	65	65	97	107	124	127	106	87	81	65	81	108	105	79	97	117	69	101	84	106	82	135	101	59	93	112	69	62	73	102	41	118	83	68	74	91	99	78	83	109	75	103	93	91	81	98	93	75	109	83	86	91	91	85	53	81	83	66	83	78	93	44	75	71	78	54	86	76	84	77	69	74	47	57	44	79	50	79	75	75	82	125	61	49	83	75	77	65	81	55	35	59	72	56	46	70	64	86	100	62	54	64	59	52	57	40	68	64	79	62	52	53	61	83	50	109	82	69	52	92	57	54	68	58	57	50	26	67	55	64	77	88	63	55	87	60	77	71	67	49	68	76	64	55	73	63	84	54	57	74	80	54	38	49	58	53	55	36	57	31	60	41	48	55	69	42	39	54	61	39	45	57	43	63	38	48	39	39	51	81	25	26	83	47	57	45	33	51	40	35	87	42	35	22	70	45	39	42	54	49	37	52	55	59	57	110	60	47	41	62	48	67	44	78	33	33	56	47	39	43	28	48	37	65	35	40	52	30	55	58	69	48	37	99	43	67	66	33	39	37	37	39	41	60	42	66	35	61	57	35	25	40	45	40	42	41	98	47	55	27	21	43	55	77	76	41	34	35	45	68	73	35	48	49	43	40	49	48	61	44	53	33	51	61	45	41	47	29	36	32	29	38	60	39	45	41	26	56	31	44	29	61	42	23	34	41	30	56	46	24	43	37	37	38	29	49	34	34	22	82	44	31	49	41	45	26	28	29	32	41	78	70	68	41	28	41	44	19	35	41	44	80	42	67	37	36	31	47	23	33	33	26	58	42	51	31	44	31	75	39	32	55	26	34	48	41	44	28	26	48	26	16	28	28	35	31	52	36	28	18	25	27	46	28	26	25	39	23	75	27	31	21	26	22	26	25	29	21	22	31	72	34	34	21	32	41	40	28	28	112	39	26	28	50	29	40	25	19	27	26	18	27	27	29	36	50	53	47	23	49	43	15	22	22	21	33	27	29	23	29	17	27	80	50	27	21	29	43	23	44	31	47	26	20	17	30	54	25	29	20	39	29	17	20	18	19	33	12	29	23	27	40	37	26	37	26	12	15	29	19	14	22	20	24	40	23	20	19	18	17	33	44	17	15	16	27	13	45	14	29	19	33	20	41	32	18	28	27	31	21	32	19	21	26	40	27	25	29	23	19	14	14	27	33	38	37	31	15	23	27	16	28	18	47	32	37	29	14	19	31	30	30	33	16	17	26	18	13	46	42	24	10	24	23	35	31	19	22	15	12	27	13	17	43	12	27	18	26	35	29	15	26	20	32	16	40	18	23	19	24	17	29	21	19	20	5	23	23	12	16	29	32	27	22	31	26	35	16	14	22	36	23	19	15	25	15	23	24	17	16	16	18	34	57	37	16	9	31	15	18	23	27	23	38	49	28	30	24	27	10	18	37	16	12	15	24	15	10	19	19	18	29	25	14	31	24	18	21	8	23	34	15	20	20	16	6	9	12	16	15	15	33	14	8	34	24	8	14	24	22	19	13	17	17	15	17	40	24	21	10	13	17	21	24	9	14	15	7	14	28	11	24	25	32	20	33	13	53	14	17	26	12	9	17	13	19	36	26	7	15	32	22	12	7	25	42	23	39	25	30	15	19	34	26	9	52	6	26	16	15	20	15	11	36	27	26	15	20	8	35	8	8	13	4	13	22	20	19	19	15	14	17	17	13	21	11	12	23	11	16	16	18	15	22	14	22	11	10	13	18	17	31	26	7	10	18	20	15	22	16	14	31	11	13	14	28	14	17	12	13	9	21	30	10	14	24	12	15	35	4	20	28	10	30	11	12	21	14	7	24	7	11	24	20	10	17	19	12	20	11	10	26	15	10	4	26	9	11	14	4	14	13	18	18	12	16	20	12	12	14	10	16	9	12	13	22	8	8	13	10	21	33	14	10	14	13	25	10	10	14	25	42	14	23	18	14	8	9	9	17	16	12	6	16	11	15	14	21	11	9	9	10	21	8	4	23	8	10	19	14	21	8	31	19	7	13	15	12	10	43	4	12	18	24	5	11	17	15	29	14	7	9	7	10	12	9	18	18	31	6	14	7	8	25	18	17	14	10	9	8	26	12	5	9	5	7	9	18	5	6	16	9	29	6	15	9	10	14	14	12	12	19	9	27	11	9	18	8	18	16	15	21	14	18	6	12	17	5	11	6	14	12	11	8	13	9	6	9	8	14	12	22	24	11	8	17	12	12	10	15	9	11	36	9	11	12	4	15	16	10	12	7	14	7	6	4	13	4	7	13	12	16	23	10	15	21	9	21	11	21	11	3	9	2	13	9	12	9	7	5	14	7	14	20	14	6	13	7	8	6	15	30	8	10	11	5	13	6	6	8	9	13	6	13	5	13	8	12	4	9	5	31	10	6	11	9	3	3	15	17	7	17	12	8	6	11	9	9	7	6	12	7	12	11	11	5	8	8	11	8	12	6	4	19	12	17	18	12	29	7	9	11	6	13	8	4	10	4	7	6	6	4	6	11	5	13	12	8	11	12	9	1	9	5	15	9	5	11	12	10	19	8	5	2	10	5	15	15	23	16	1	9	24	7	8	12	8	4	14	5	12	4	12	3	11	3	7	5	4	4	9	7	11	9	7	6	11	8	12	3	8	6	9	5	10	12	9	10	5	14	4	7	5	15	6	27	8	10	4	11	1	16	6	7	31	5	9	3	15	10	8	8	15	25	1	4	4	4	7	11	8	9	6	11	12	5	4	6	4	6	7	4	6	5	7	6	5	5	11	6	8	7	20	14	8	27	2	9	8	5	12	8	6	6	7	1	7	8	8	6	25	11	4	7	3	2	14	4	1	4	3	4	17	5	13	6	6	8	0	4	7	8	3	8	7	4	2	3	6	26	6	10	3	8	1	14	9	9	1	5	7	4	10	3	5	21	7	5	7	4	3	7	7	8	3	10	6	7	5	8	12	3	7	7	10	8	1	1	15	4	2	5	1	2	0	4	4	7	4	6	9	5	6	18	4	7	13	4	11	5	14	5	6	12	9	3	2	7	9	7	6	10	4	2	1	6	4	6	16	6	9	3	5	8	8	10	54	7	4	3	4	3	2	9	2	2	5	10	26	7	7	4	4	1	1	3	4	55	4	16	6	2	3	3	8	4	16	5	0	2	11	4	6	1	9	19	14	4	3	4	1	2	3	5	7	0	16	4	1	3	4	4	3	7	6	7	5	0	5	1	3	1	2	4	6	1	6	16	2	2	5	3	3	4	1	3	4	0	4	6	7	18	4	9	2	3	1	3	6	2	2	7	6	15	4	2	2	3	2	3	3	3	6	0	2	7	0	1	5	7	0	4	2	1	2	5	0	2	8	0	4	5	1	1	5	6	3	3	1	7	3	4	3	2	2	5	4	9	1	1	3	4	2	2	1	3	4	4	7	6	1	4	5	7	4	4	4	4	5	5	0	6	8	3	2	6	6	0	1	5	2	5	6	1	2	3	2	2	4	4	3	1	1	2	1	6	4	3	1	1	6	4	2	2	2	2	17	3	1	0	10	4	3	2	2	2	4	0	6	0	2	0	3	3	0	0	1	2	1	2	2	1	7	1	1	1	2	1	1	2	3	1	1	1	1	3	0	1	2	0	1	2	6	4	1	0	0	0	4	3	13	1	2	3	2	2	2	1	3	2	0	3	0	0	3	0	4	0	7	3	3	1	4	1	11	1	1	1	1	4	3	5	1	2	1	1	4	2	8	0	0	1	4	1	1	0	2	0	2	3	2	2	1	3	0	4	1	4	5	1	0	1	0	2	0	1	0	1	0	3	2	2	2	1	2	1	0	0	2	0	0	0	1	0	1	1	1	1	6	5	4	1	0	0	0	0	0	1	1	0	0	1	0	0	2	0	1	0	0	2	0	0	3	0	0	0	0	0	0	0	1	1	0	5	0	0	0	0	0	0	1	1	0	0	1	0	0	0	0	0	0	0	0	0	0	0	0
ne0289	1837	1280	867	1023	706	774	657	641	532	667	453	430	445	497	459	441	572	470	507	368	418	583	364	522	407	476	333	411	526	386	259	505	348	345	306	321	386	278	444	259	457	292	630	426	429	327	315	497	356	262	277	279	269	388	543	282	254	245	267	248	245	248	200	316	253	343	376	309	345	227	323	226	313	223	204	218	271	226	220	209	268	198	297	330	223	221	330	207	226	214	336	172	264	201	224	280	213	261	306	223	196	272	275	253	329	179	249	198	246	373	218	240	184	240	210	353	202	194	476	209	202	224	181	216	182	260	190	177	194	203	168	215	271	210	151	114	263	239	183	285	167	281	406	265	180	188	149	193	162	193	176	161	165	296	264	254	206	205	193	242	154	171	131	135	218	207	201	152	570	235	188	166	156	171	157	173	195	161	160	159	278	190	143	185	162	360	155	145	175	169	152	161	220	146	164	271	223	164	182	174	175	137	177	206	151	216	246	186	166	134	158	175	145	155	176	185	187	105	167	103	93	174	99	145	147	168	126	173	212	184	141	161	208	137	216	136	107	135	121	198	142	122	116	147	109	144	131	106	182	153	126	176	167	134	108	138	176	150	144	193	156	152	162	128	133	161	188	204	125	99	118	157	202	138	175	141	150	185	90	122	116	162	142	121	189	133	119	149	122	182	116	164	75	107	195	136	177	128	127	139	95	162	115	132	146	133	115	105	133	117	99	145	78	108	110	80	97	120	128	183	106	99	148	197	159	176	161	117	146	125	209	156	193	131	170	109	90	161	150	141	114	106	144	178	181	145	96	124	88	94	141	101	110	148	162	127	134	148	197	92	143	131	176	94	143	108	126	128	130	98	87	93	86	129	107	101	105	108	100	129	205	106	109	149	92	137	99	91	135	101	162	191	152	166	68	105	102	137	139	83	91	149	144	100	132	119	71	130	100	62	119	136	132	140	110	96	93	113	77	209	123	86	205	124	107	74	148	121	77	103	133	60	114	91	82	132	74	162	105	78	87	61	94	147	68	99	88	89	81	162	94	65	131	114	52	79	127	88	102	90	102	264	90	101	85	104	101	92	66	113	89	104	94	119	151	99	113	85	76	119	101	91	91	94	92	132	124	133	147	49	146	115	74	65	65	84	81	103	58	55	81	78	94	165	150	66	72	73	117	117	108	99	128	103	92	62	78	89	105	87	80	79	48	102	74	92	56	161	46	100	76	98	80	94	51	98	113	79	47	52	72	69	52	93	67	85	67	63	45	99	84	102	116	52	56	33	93	79	112	73	67	74	115	57	110	106	81	81	137	90	60	63	103	83	88	115	85	68	76	89	63	49	50	65	129	94	142	75	123	95	81	95	60	56	93	84	125	114	82	72	149	107	69	71	72	68	51	46	43	89	143	88	48	57	33	45	102	67	41	44	75	46	51	42	120	68	72	72	51	69	98	59	52	70	31	31	49	86	140	62	62	112	47	70	52	57	64	77	42	74	36	111	54	143	87	79	82	117	62	68	76	99	52	30	45	84	53	66	54	53	60	61	64	101	75	93	54	46	82	35	44	66	58	74	151	81	57	158	34	50	68	55	74	61	76	51	81	40	67	35	63	66	75	86	96	89	70	48	104	55	45	53	40	64	40	50	64	45	95	48	72	48	80	27	27	63	55	68	61	57	40	51	73	56	44	31	37	101	87	78	44	50	57	53	78	68	58	63	39	60	67	58	50	71	62	74	41	68	72	137	82	59	51	59	42	44	102	66	52	39	24	80	40	39	47	56	137	51	90	72	71	74	85	79	47	41	99	55	44	42	35	51	45	62	118	85	82	62	61	41	48	36	69	48	46	87	73	46	66	72	31	72	84	68	48	58	42	39	51	25	68	40	71	43	95	63	64	39	40	69	74	48	57	47	46	42	38	62	42	33	51	45	96	46	59	73	55	73	33	22	33	49	74	58	35	33	34	28	71	103	33	46	55	23	64	33	34	47	33	26	64	22	46	65	79	48	85	38	37	38	59	53	60	65	41	24	49	17	67	51	28	30	19	32	20	38	72	39	44	64	54	57	34	42	26	54	61	57	65	31	35	57	39	31	63	62	34	41	28	25	41	50	54	46	47	29	30	25	52	18	42	40	93	49	51	27	19	31	50	39	88	48	91	59	28	43	44	60	23	42	20	67	13	41	43	23	115	38	36	48	39	21	24	61	22	31	41	34	35	110	26	56	17	40	31	15	15	43	63	38	36	44	36	42	59	28	42	32	32	33	48	30	29	64	25	19	46	50	37	33	45	60	27	28	29	36	55	42	92	57	38	24	34	19	56	25	22	31	30	26	58	42	51	26	63	30	54	23	35	38	19	36	29	31	48	34	33	11	19	28	39	49	15	86	43	12	53	47	48	34	85	24	41	30	20	30	41	32	58	17	23	44	41	48	33	24	34	47	34	27	30	7	32	25	10	36	43	21	38	38	34	28	38	38	23	50	24	44	50	14	33	36	13	15	52	21	19	30	17	27	17	40	37	25	23	20	15	39	35	53	18	26	21	24	35	42	43	26	32	23	15	38	53	40	16	53	21	23	11	39	38	10	18	42	27	30	48	36	35	22	23	14	28	36	27	56	23	17	17	36	26	16	14	19	43	49	43	44	64	44	30	19	19	34	69	25	13	31	17	13	36	27	24	29	36	17	22	39	9	34	49	14	15	46	18	36	6	28	18	32	40	37	41	19	12	20	10	33	14	41	49	14	12	13	10	39	41	12	26	51	13	22	16	42	20	34	37	61	33	30	12	20	28	39	16	21	21	25	5	15	2	31	16	40	20	36	23	21	39	17	37	24	39	13	73	16	27	40	29	47	23	15	25	22	22	35	9	29	13	23	24	19	12	18	97	32	28	11	12	29	21	21	22	9	23	16	19	12	13	19	12	22	38	8	11	18	22	36	31	9	17	70	39	16	20	34	41	20	18	22	20	12	16	20	18	25	11	13	29	21	16	87	19	56	10	13	17	35	16	9	7	18	10	56	19	17	11	26	7	11	16	16	16	31	10	11	10	20	28	21	26	28	25	10	38	14	35	11	17	14	18	20	23	30	7	38	49	13	8	17	24	10	20	41	16	15	8	19	19	4	38	8	24	8	19	14	16	33	10	24	59	6	21	13	14	10	13	18	13	26	13	16	10	17	44	38	37	32	23	34	32	23	15	19	36	15	13	10	12	22	7	15	26	20	7	21	31	13	14	34	20	28	16	6	19	15	10	22	19	36	12	18	17	6	21	17	15	3	26	27	20	9	25	14	12	15	8	8	11	6	15	22	7	13	7	9	10	21	4	15	25	18	43	27	17	26	56	13	6	6	16	12	12	13	20	20	70	9	12	13	17	8	8	1	22	19	16	16	6	7	14	12	4	17	13	25	5	28	8	20	12	4	24	6	9	7	12	12	6	11	22	17	19	12	10	13	8	9	6	20	13	5	6	14	11	17	10	5	18	9	9	20	12	13	4	4	36	12	10	6	16	13	19	7	31	10	14	11	24	24	4	10	14	12	8	14	3	8	12	4	14	34	8	3	3	3	4	11	9	5	7	13	10	9	3	11	0	15	18	4	24	1	4	2	20	3	1	22	12	12	6	4	11	16	34	11	13	19	8	2	8	4	7	9	9	7	8	20	2	7	8	6	5	3	6	3	12	13	74	5	1	3	5	2	3	2	17	6	14	8	2	21	3	7	13	8	4	6	3	9	5	13	9	3	12	11	8	5	12	8	8	5	1	4	5	3	13	5	5	14	1	12	6	1	2	2	2	32	11	5	6	6	4	2	5	12	12	3	1	19	2	9	1	7	11	2	8	2	9	6	8	4	7	6	2	7	7	5	1	15	3	5	2	6	11	11	0	7	8	3	8	2	4	1	2	5	1	4	4	9	9	4	3	4	0	0	1	10	4	1	2	6	11	4	2	19	16	4	8	1	6	1	11	8	2	3	4	6	2	1	6	7	1	1	2	3	3	5	2	7	1	3	4	3	0	0	2	1	1	4	2	4	2	1	1	0	2	12	3	0	3	8	0	7	5	0	1	2	1	2	5	3	0	0	0	1	2	2	3	2	3	0	0	0	2	5	13	3	10	0	0	0	0	3	1	0	0	0	0	5	0	0	1	1	1	0	0	0
ne0290	569	311	255	359	201	274	286	271	265	209	147	187	232	209	119	204	260	202	157	156	120	258	72	240	159	179	107	88	169	97	82	157	120	172	96	92	137	124	143	91	121	112	117	279	161	180	178	117	57	73	146	83	103	94	170	77	113	72	90	157	136	100	48	114	80	128	152	204	137	68	70	69	97	97	78	36	165	91	76	78	129	73	177	117	33	132	136	56	51	87	91	50	142	58	96	68	126	76	129	221	86	81	74	122	158	61	93	118	73	122	75	101	123	123	122	68	125	70	70	120	83	124	37	64	49	67	53	142	116	118	54	39	85	47	49	53	66	73	115	88	72	104	98	81	42	65	56	97	77	66	85	62	64	62	77	53	70	66	118	91	70	52	50	70	30	52	43	63	54	136	40	66	59	66	103	27	56	101	53	50	76	60	96	69	111	41	109	49	64	49	44	60	93	50	57	102	73	106	54	113	57	50	113	74	84	72	63	53	47	51	108	60	52	35	33	53	81	20	39	38	21	109	15	43	27	67	55	43	97	70	17	52	58	45	92	24	29	45	31	74	47	19	36	70	85	40	72	38	66	34	59	70	24	67	16	99	45	58	23	55	65	30	31	36	57	48	65	43	40	37	73	46	74	55	56	35	53	60	31	36	33	26	59	66	48	25	33	46	19	32	31	68	31	34	57	49	125	73	35	52	34	34	32	26	42	35	60	24	53	37	14	40	41	58	20	56	39	62	121	54	47	23	34	29	80	82	45	32	54	56	73	72	58	90	93	34	31	33	51	34	42	42	45	25	66	41	28	25	36	28	82	49	25	10	46	56	65	54	35	41	27	16	59	42	18	46	50	28	78	40	28	32	13	67	42	41	64	24	45	41	33	30	36	55	18	23	56	13	33	40	37	46	57	39	81	41	37	56	16	93	37	26	55	51	58	42	29	30	66	19	38	24	33	49	29	52	34	39	41	95	33	25	35	17	17	40	32	41	23	35	63	23	19	40	37	17	25	39	24	35	28	28	23	41	28	34	30	40	20	71	21	73	38	37	14	38	20	16	19	16	25	40	12	31	27	41	66	38	9	37	25	31	38	24	46	33	35	18	28	55	16	20	24	22	23	26	58	75	55	18	53	25	24	25	23	34	39	26	28	27	31	21	22	69	64	28	22	16	31	48	37	28	57	31	25	7	35	23	31	67	21	26	4	21	32	29	9	15	11	41	17	10	43	34	9	21	37	21	6	26	26	10	12	18	16	64	14	9	37	42	14	28	54	26	22	11	25	15	36	25	66	23	40	49	82	47	26	34	29	34	70	28	17	31	19	53	49	72	23	11	10	16	20	40	27	47	30	29	32	25	28	23	35	9	26	27	78	38	28	24	32	23	28	20	21	23	19	17	12	20	16	10	3	15	18	28	28	27	15	28	17	18	17	10	18	23	15	14	23	16	49	11	20	19	22	7	76	16	24	17	7	18	18	13	11	18	15	9	7	26	28	17	20	34	27	38	34	58	10	49	19	29	20	23	23	11	20	11	30	25	21	9	38	51	54	106	16	13	66	7	14	23	24	17	32	45	23	12	14	15	15	15	37	23	15	10	19	12	13	9	21	15	26	33	16	31	35	14	33	8	20	14	6	14	11	16	17	14	22	17	18	8	40	6	13	18	21	11	21	28	10	19	13	13	15	8	24	32	26	17	21	11	23	15	10	18	15	34	10	14	10	18	26	36	12	22	24	14	38	24	24	23	9	21	19	16	6	36	19	11	10	24	11	18	22	36	29	24	27	16	23	17	13	31	12	8	36	17	26	39	16	23	10	36	14	12	24	13	32	16	30	14	5	12	18	16	28	27	16	11	18	11	12	24	16	20	14	10	32	22	25	15	13	16	47	11	12	3	11	9	8	9	22	20	15	12	19	21	13	15	24	7	48	23	7	8	31	10	10	2	20	16	28	26	9	20	10	5	10	14	12	23	26	10	34	12	14	6	9	5	19	5	11	29	7	5	23	4	7	26	7	11	17	15	9	4	17	0	8	18	18	10	15	14	6	12	20	18	18	12	5	12	13	17	8	16	10	21	11	17	3	12	24	24	11	15	8	18	6	9	19	21	16	22	18	10	5	4	20	7	6	25	18	12	8	8	7	8	12	11	11	24	22	37	14	10	28	9	12	13	9	8	6	21	5	5	12	14	13	8	31	7	4	7	15	15	24	27	4	20	7	12	2	10	12	13	9	18	9	26	7	10	6	25	22	10	10	3	11	4	7	31	8	4	12	7	6	11	10	14	14	14	9	10	7	9	4	5	5	24	11	15	10	34	23	42	6	20	5	13	9	21	27	17	22	16	47	20	7	6	6	4	3	14	10	21	5	14	2	9	13	17	3	22	9	2	8	10	3	8	28	6	8	13	9	7	6	7	10	11	10	30	8	13	9	1	3	12	4	22	10	5	14	13	6	21	18	14	7	4	7	5	10	12	38	24	7	11	5	7	13	10	2	7	38	14	16	21	11	5	2	11	17	4	9	9	3	15	26	30	9	7	15	2	34	3	17	4	4	6	0	19	8	12	16	12	23	10	7	23	22	9	12	7	32	4	8	6	8	11	2	7	5	20	3	17	4	11	6	8	3	18	9	0	11	9	18	4	8	32	9	5	14	3	33	8	14	8	5	9	3	6	10	6	7	5	5	14	11	11	55	9	2	2	9	9	15	1	8	9	11	14	0	3	6	3	5	4	2	9	34	4	10	27	4	1	8	43	9	10	2	12	1	22	4	8	0	18	5	7	4	6	10	6	26	8	4	1	0	9	6	5	9	5	11	13	11	21	11	7	8	12	6	5	9	5	22	7	6	5	8	11	15	6	6	15	5	12	9	19	4	6	6	21	12	12	2	1	6	2	8	15	42	6	5	3	5	4	6	5	4	6	12	3	1	10	8	10	10	7	5	40	6	6	6	6	45	3	1	9	7	4	11	2	6	6	1	7	4	12	9	9	23	6	6	3	2	5	1	5	5	3	5	8	6	8	11	1	2	2	2	6	10	7	9	8	6	4	1	7	7	7	7	5	1	1	11	4	2	2	9	5	4	6	1	3	37	1	8	4	3	2	1	3	2	8	6	7	1	2	6	5	8	9	9	11	8	6	3	6	2	1	1	4	1	7	2	5	5	6	4	4	3	3	9	9	5	3	5	2	3	1	3	2	17	3	1	3	6	3	5	2	7	3	5	6	5	4	1	20	5	7	6	2	3	4	2	28	1	3	1	8	2	2	2	4	2	3	8	6	14	2	4	9	4	3	4	5	15	2	27	2	2	1	1	12	7	4	2	4	5	18	9	6	2	9	15	5	2	0	3	1	3	2	2	1	0	3	6	7	2	3	0	2	7	4	4	10	3	2	5	4	1	4	6	6	2	3	4	2	4	18	3	0	4	4	6	1	3	1	6	8	8	1	6	0	3	6	6	4	1	2	7	2	11	1	7	3	2	6	6	2	1	0	2	7	2	3	2	2	2	7	9	8	3	3	5	4	10	1	28	4	1	0	7	0	6	0	0	5	33	4	11	4	8	9	4	2	6	2	6	2	0	0	1	1	1	2	3	5	5	1	7	0	4	1	2	0	2	0	0	2	4	7	2	0	2	4	2	1	8	2	5	8	2	0	2	1	0	2	2	1	2	6	0	4	0	1	3	2	2	0	2	1	1	1	0	0	1	1	2	10	5	0	6	0	1	3	2	2	0	0	5	0	0	1	1	4	0	0	1	6	3	2	6	1	1	4	0	3	0	0	1	2	1	2	1	0	3	2	1	1	0	5	6	2	1	2	1	3	5	3	1	1	2	3	7	0	0	0	3	2	3	1	0	1	1	6	0	7	3	4	0	3	0	7	0	2	3	5	0	2	0	5	2	0	2	1	3	0	1	0	1	2	0	1	0	8	0	0	2	1	1	2	1	3	5	0	4	1	3	1	0	2	0	0	1	1	2	0	5	0	2	3	2	0	0	0	0	1	0	4	0	1	0	5	0	2	2	0	2	0	0	3	0	0	1	0	2	0	0	1	7	1	2	0	0	0	6	0	0	0	0	0	0	1	0	0	0	0	1	1	0	1	0	1	1	2	0	0	0	0	0	1	0	0	0	1	0	0	0	0	0	0	0	0	0	0
ne0291	765	689	504	342	386	221	320	165	227	300	209	212	229	171	242	226	182	265	156	173	164	175	195	209	190	176	172	157	126	190	230	168	177	141	179	141	218	129	155	130	171	206	156	101	99	155	140	128	151	178	104	150	209	129	100	149	155	151	131	207	91	158	158	105	145	97	97	102	149	141	199	172	96	178	177	98	190	99	103	169	144	120	81	80	116	127	130	175	127	120	90	124	67	214	160	123	78	124	105	131	74	132	152	100	86	114	88	72	86	71	88	83	97	63	90	166	74	84	94	67	91	73	123	100	81	61	142	174	68	68	118	113	122	129	100	176	73	119	65	83	190	51	62	115	114	65	86	125	75	119	117	98	74	116	99	73	85	87	58	118	71	90	148	89	81	79	115	73	51	118	78	113	112	105	60	128	71	71	68	138	31	97	133	83	136	86	120	69	85	57	76	60	50	107	81	78	107	58	72	54	66	79	161	86	159	60	79	54	99	61	60	43	65	73	77	53	85	103	71	54	96	129	108	61	61	34	51	92	49	94	44	87	59	92	36	145	86	84	59	88	25	66	86	65	61	60	52	70	71	63	85	70	70	112	73	53	73	81	66	61	42	58	94	45	36	101	50	52	96	94	88	146	60	80	26	84	82	46	77	66	96	81	74	154	41	119	94	64	85	45	53	82	72	66	28	101	31	108	64	93	79	145	54	38	55	73	35	48	51	55	56	80	52	62	103	58	51	51	91	48	33	111	63	43	30	45	66	59	37	27	57	38	58	116	44	50	50	32	44	39	42	49	98	39	57	47	54	52	83	85	66	44	42	61	76	30	42	47	56	61	48	74	30	49	38	69	48	59	32	48	73	58	47	36	67	85	66	32	49	56	38	29	63	48	55	25	58	47	65	34	22	33	26	52	90	62	46	56	106	96	49	26	53	34	35	62	37	53	38	56	42	43	46	35	70	42	37	34	27	31	61	55	32	48	64	36	38	35	69	60	28	39	40	28	43	53	25	34	42	56	26	45	32	45	49	68	28	45	75	26	44	81	43	54	62	40	50	50	34	60	36	31	40	59	57	27	49	26	25	33	37	23	33	77	51	26	22	42	38	87	33	41	31	28	20	38	29	23	56	50	28	60	52	24	40	52	28	38	30	58	41	24	26	23	37	20	65	45	43	28	44	44	23	31	51	37	53	16	30	24	54	21	73	63	39	57	20	38	42	37	31	22	31	29	37	31	43	26	34	31	41	42	36	22	36	56	30	94	33	21	61	23	17	34	40	28	20	36	33	47	19	50	33	23	21	23	51	19	59	31	81	40	23	33	54	22	15	70	25	13	39	52	34	40	33	33	16	14	13	19	33	17	31	27	26	26	14	25	44	32	21	17	30	83	49	23	43	44	19	21	23	36	25	29	39	54	24	45	40	31	41	26	36	27	13	29	39	39	18	21	11	44	27	70	22	28	23	31	24	12	35	23	20	26	22	21	31	18	25	29	32	17	15	19	52	25	10	7	22	14	27	35	22	30	52	18	18	28	16	13	13	24	10	14	19	12	15	24	20	25	15	14	32	16	24	6	16	27	49	22	34	31	14	39	51	8	47	39	12	33	16	23	29	23	10	22	21	7	12	23	43	20	25	16	22	14	18	44	43	60	15	30	21	27	20	27	23	19	44	7	52	13	47	28	36	27	16	15	23	17	14	32	17	14	22	32	32	28	18	54	19	55	42	19	28	22	12	19	15	12	14	20	23	16	16	23	41	16	24	39	40	23	46	5	43	24	18	21	9	8	12	18	45	16	13	15	24	17	16	12	20	9	14	17	16	22	16	23	8	39	20	12	20	27	18	18	24	13	13	20	21	11	10	12	27	48	15	21	17	33	45	11	8	19	20	25	21	18	19	35	12	6	9	25	30	24	20	15	38	18	16	9	6	28	21	86	12	27	11	31	14	21	7	20	28	18	27	25	19	13	17	13	23	28	11	14	9	13	21	41	19	25	17	6	30	21	3	12	28	6	32	15	9	22	5	12	13	22	26	7	17	13	11	14	12	17	10	18	15	12	48	30	17	10	16	9	29	8	26	24	8	22	5	19	6	12	21	24	24	14	32	6	15	10	9	12	9	12	6	16	8	7	10	18	7	12	30	19	41	16	27	4	15	9	34	18	14	22	10	1	17	22	15	15	9	10	35	9	38	18	5	30	15	16	18	18	11	13	20	27	9	18	19	8	35	4	17	15	14	14	17	11	11	4	13	13	12	9	17	26	38	6	25	6	20	16	34	11	10	12	13	9	13	15	9	11	15	41	20	18	11	13	16	15	7	15	9	8	18	21	25	34	7	13	5	21	5	17	11	11	16	6	4	6	15	15	8	20	13	9	15	7	12	11	15	46	10	37	21	5	7	16	16	18	15	9	10	14	12	17	7	22	23	9	4	17	25	7	16	5	5	8	5	21	7	12	6	11	13	18	12	11	11	7	25	6	14	11	14	20	5	14	7	19	5	3	10	6	15	9	14	5	14	24	8	5	20	2	12	10	18	9	28	6	2	20	17	7	24	36	11	10	14	19	22	7	6	20	15	20	6	22	7	6	7	26	9	9	10	15	11	18	12	0	4	22	10	13	4	4	15	13	20	17	7	8	16	8	3	9	11	17	44	11	17	13	25	4	6	15	12	9	9	13	4	9	16	3	12	29	3	14	12	16	19	12	8	4	4	6	1	5	16	11	12	7	5	4	24	2	2	12	6	11	6	20	7	8	51	3	25	20	12	6	4	5	9	14	7	4	6	8	4	9	8	8	3	14	11	8	11	10	13	19	4	11	3	7	12	10	0	5	7	9	9	21	4	5	4	14	9	12	4	7	9	1	17	11	4	9	16	18	4	2	4	4	4	8	13	4	15	4	4	9	6	7	10	20	22	2	19	3	10	6	17	28	4	10	8	11	6	10	4	10	6	9	12	8	8	3	15	24	6	6	13	9	8	22	3	3	9	3	41	12	18	9	6	7	3	17	5	5	6	7	12	4	2	10	8	2	11	2	5	4	13	2	19	10	18	4	8	13	5	5	6	5	6	6	8	6	5	11	21	6	13	5	23	7	4	2	8	1	4	13	4	4	12	3	2	5	1	5	3	1	9	2	6	11	8	1	8	11	1	14	15	4	4	7	0	2	19	2	6	9	7	4	12	8	4	5	10	2	3	3	7	3	9	9	5	17	7	3	3	4	6	4	9	11	12	6	0	13	10	1	6	1	11	3	17	17	7	2	14	7	1	1	7	8	8	3	4	1	2	12	6	12	2	3	9	5	5	8	5	7	5	8	3	2	7	7	11	9	9	1	8	1	4	4	2	3	6	8	7	5	1	4	5	7	9	12	3	5	12	6	3	1	4	0	12	2	8	1	5	7	5	2	12	4	7	23	9	3	5	12	3	6	3	8	10	1	11	16	1	11	7	3	2	4	1	7	2	1	1	4	0	3	3	4	1	6	1	7	4	4	13	13	8	4	2	0	3	2	0	9	5	1	5	9	11	5	2	0	4	4	10	8	2	4	5	5	1	4	3	3	14	9	0	4	10	2	4	3	4	6	16	7	3	5	1	3	1	6	5	2	3	2	2	6	6	0	2	9	5	1	11	14	2	2	0	3	22	0	4	5	6	18	2	6	14	5	2	2	3	2	5	11	4	5	4	0	0	2	5	1	4	1	5	0	0	3	5	5	15	1	3	3	3	2	2	5	5	2	1	5	8	1	8	8	1	8	14	2	5	2	2	1	6	2	1	2	1	2	5	0	1	1	4	9	0	2	0	5	3	4	23	1	7	16	5	2	3	0	1	2	2	1	4	1	0	0	6	0	0	1	2	2	0	1	2	2	9	7	0	3	4	1	1	3	3	4	0	1	0	0	0	1	1	1	6	0	1	1	0	0	6	3	3	1	4	4	0	6	0	3	0	0	1	1	0	0	2	2	2	3	0	0	0	1	0	3	1	0	0	0	2	1	0	2	2	2	0	0	0	0	0	0	2	0	0	0	1	1	0	1	0	1	1	4	10	0	1	1	0	0	0	1	0	1	0	0	2	0	1	2	0	0	0	0	0	1	0	0	0	1	0	0	18	0	1	5	1	0	0	0	0	0	0	0	1	0	0	0	0	0	0	0	3	0
ne0294	3516	3075	2179	1770	1558	2092	1770	1641	1528	1698	1233	1644	1621	1539	1191	1282	1702	1185	1214	1343	1196	1392	1075	1171	912	944	1129	1298	1127	1213	915	938	986	1129	1031	842	973	879	1064	782	954	954	679	863	908	841	976	958	1117	831	1055	821	726	793	794	1006	718	745	844	789	972	696	552	674	699	847	1021	775	919	670	659	583	854	564	605	751	591	636	726	633	920	703	926	723	663	818	691	748	487	624	751	655	889	541	674	615	813	534	609	625	611	627	645	809	576	629	827	783	538	612	658	633	792	850	719	632	718	694	566	754	580	782	601	609	558	639	636	598	688	684	599	622	635	531	631	535	570	527	694	496	536	755	442	518	393	544	468	551	587	605	610	384	584	478	490	486	596	513	668	629	512	520	508	447	593	612	439	512	337	631	612	474	528	439	604	464	598	605	467	451	550	416	539	527	465	415	510	503	452	426	381	537	433	495	473	535	440	631	462	487	405	462	476	540	426	621	558	436	556	471	603	538	507	507	391	637	533	496	394	460	400	371	424	470	463	486	480	307	613	466	454	441	483	424	690	304	306	480	425	364	448	464	284	753	340	445	432	400	508	329	464	367	482	404	371	554	325	418	440	444	480	341	287	400	308	365	354	491	350	420	377	368	453	369	406	300	303	443	399	460	391	357	421	451	369	429	327	279	321	423	436	374	463	417	662	386	424	300	368	355	299	377	339	376	400	356	387	498	346	405	361	313	465	408	358	270	323	400	419	434	327	295	279	434	380	470	348	362	404	270	356	405	345	354	347	330	361	376	255	306	500	353	270	375	406	437	336	251	284	310	270	328	412	364	283	431	267	276	322	334	306	292	339	279	280	219	420	299	468	323	338	254	317	271	324	304	343	245	350	292	360	244	291	332	383	323	274	308	220	257	390	447	324	296	343	234	352	330	324	340	272	249	345	299	443	214	337	249	252	355	264	257	261	317	221	218	243	276	287	338	306	270	294	277	290	154	263	327	257	313	288	223	185	257	229	350	230	233	214	255	263	337	256	295	332	282	215	245	325	348	234	309	243	246	305	296	281	299	254	282	316	335	234	217	192	313	214	223	221	184	364	328	236	287	369	270	286	213	231	230	290	194	221	244	351	305	244	234	285	269	219	221	185	250	240	194	306	216	211	281	231	216	369	254	273	227	316	262	294	352	202	213	246	152	171	285	302	232	235	266	211	215	253	161	260	213	261	305	196	290	297	265	241	205	237	209	129	270	222	258	251	169	264	265	170	191	171	249	272	244	177	211	244	245	234	197	302	207	188	197	219	241	261	248	220	271	222	276	210	203	240	198	195	216	162	273	182	297	179	196	291	214	247	178	228	138	182	213	162	199	180	177	200	251	176	187	234	259	272	154	195	197	213	216	173	223	219	125	120	203	238	140	213	218	185	229	155	204	149	214	203	240	202	151	290	180	245	124	187	184	216	129	200	223	185	227	130	135	138	186	171	98	175	288	169	170	115	198	212	191	109	132	151	134	136	131	240	239	134	102	203	177	216	239	132	185	201	169	166	210	80	96	161	210	184	169	146	163	168	146	147	162	236	167	161	202	268	207	88	107	189	222	179	172	166	180	191	140	205	164	146	229	164	241	178	144	190	235	229	154	149	205	110	137	113	158	127	131	154	165	193	197	160	174	200	214	120	184	147	158	202	134	129	156	185	118	147	183	155	108	173	131	134	116	244	162	129	147	150	133	199	123	151	135	192	137	198	157	151	127	115	340	194	140	139	117	117	233	91	198	120	143	198	156	117	138	222	119	157	116	167	175	126	137	143	112	86	118	143	138	154	230	297	138	135	128	175	175	162	118	182	145	107	187	115	133	138	142	113	149	112	189	158	45	112	77	122	182	143	121	60	122	181	116	174	124	121	121	100	111	96	103	106	238	108	115	129	103	105	114	112	114	198	104	117	149	116	135	101	138	119	137	166	120	95	152	136	115	147	155	169	106	83	112	212	84	123	108	101	107	113	122	274	150	108	107	109	111	126	187	99	120	137	102	138	142	130	139	89	160	99	137	135	134	152	140	173	58	141	187	100	118	103	127	89	126	182	121	57	120	74	125	120	130	126	116	113	162	84	121	66	143	105	112	124	95	103	142	127	119	105	160	107	102	151	121	84	118	129	92	65	142	104	92	93	97	97	99	121	105	85	97	91	106	84	115	117	168	96	93	129	87	127	116	114	80	113	110	60	169	91	109	93	106	102	111	154	106	104	186	120	83	115	105	111	99	140	105	126	101	106	97	97	75	89	89	75	116	97	87	108	99	84	108	119	86	132	126	80	110	140	129	129	102	131	104	76	106	153	86	107	116	92	111	103	85	61	90	102	93	87	70	102	89	67	87	94	61	51	105	93	113	103	207	85	114	142	89	103	113	71	96	94	128	106	90	195	90	61	128	77	101	131	90	202	58	66	65	57	77	87	62	92	114	61	84	93	63	77	105	86	88	72	80	49	63	99	115	98	68	92	73	75	72	113	74	51	70	104	61	82	78	96	44	69	85	87	82	80	93	73	67	83	82	109	52	80	50	50	81	105	66	70	110	65	86	85	111	79	59	87	87	79	94	49	74	99	84	66	59	78	64	29	63	64	80	61	98	76	54	76	119	65	51	81	102	77	137	81	89	69	66	76	67	62	50	55	48	81	56	52	90	91	46	65	59	98	109	54	61	77	56	60	88	56	79	124	74	56	71	110	75	64	76	100	78	66	146	73	134	155	38	83	73	81	102	67	66	70	53	32	97	50	81	62	67	38	59	53	73	73	58	87	38	33	66	56	61	81	64	49	76	54	97	73	70	37	19	59	49	84	41	71	81	79	86	80	56	81	53	66	74	97	81	44	79	68	59	66	77	79	51	61	52	102	37	71	71	58	65	62	54	61	41	64	64	44	38	57	36	51	58	54	32	76	36	77	74	46	87	90	69	90	76	63	22	43	42	71	51	46	70	60	76	52	41	45	44	62	57	53	83	35	51	51	90	62	42	45	40	25	63	35	52	51	73	48	39	44	32	69	38	59	54	52	59	70	43	30	47	116	41	70	69	50	41	34	38	33	34	44	24	67	49	38	36	44	35	41	32	54	36	70	57	70	54	34	27	31	51	70	48	45	68	58	35	84	52	46	54	22	63	61	51	37	52	63	43	36	54	54	52	40	41	68	50	45	81	26	45	54	44	49	39	61	37	33	40	74	57	54	51	51	43	38	43	54	44	42	43	40	75	33	39	33	52	38	65	33	29	47	48	40	28	36	50	75	30	34	85	25	24	23	40	27	36	48	45	153	49	61	41	31	68	41	48	64	57	37	32	43	36	22	64	24	79	26	24	25	30	38	27	49	35	45	69	25	35	33	35	69	23	16	27	43	22	29	36	45	18	37	48	39	18	53	48	34	22	48	52	39	34	24	22	36	25	23	24	33	60	67	54	43	30	26	38	38	39	28	38	33	23	26	29	47	24	49	33	45	24	31	57	28	38	69	22	45	20	31	43	83	25	21	22	30	17	24	13	35	21	14	28	47	42	43	28	27	24	40	50	25	51	44	12	35	26	29	21	58	22	8	73	34	21	21	11	27	18	29	13	23	24	26	54	31	14	18	32	13	12	34	27	34	45	20	19	24	23	19	16	25	10	31	24	19	29	26	40	17	20	32	29	26	16	34	11	14	48	36	26	16	17	17	16	19	34	20	21	44	31	6	14	12	17	9	41	15	17	16	15	29	25	26	25	14	15	10	15	6	27	11	19	9	9	26	8	16	28	10	5	9	7	10	14	16	8	6	2	29	15	7	13	22	12	15	25	12	10	15	14	24	32	31	13	39	16	15	17	7	31	16	15	13	19	13	36	6	49	9	12	21	29	22	17	15	18	12	13	3	15	8	3	15	11	22	9	6	24	31	7	12	5	9	3	8	24	27	9	8	23	7	4	17	18	7	3	32	16	9	11	9	12	10	5	8	14	9	4	2	21	15	18	2	3	7	12	14	11	4	12	6	6	3	5	4	9	6	6	4	31	5	13	6	2	8	3	7	4	3	5	9	19	11	5	4	4	6	8	3	4	37	5	7	12	3	2	1	3	7	5	2	1	0	5	13	2	1	2	1	2	0	0	0	0	1	2	1	8	1	6	1	0	0	3	1	0	2	0
ne0295	3365	2749	1942	1527	1516	1903	1478	1463	1416	1766	1421	1477	1303	1276	970	1129	1207	1146	968	1054	979	1157	895	1180	939	955	1071	1023	991	958	826	835	949	923	759	865	925	872	920	579	883	843	824	692	791	849	813	729	734	907	968	769	626	667	593	832	935	760	618	726	830	715	569	611	721	693	914	696	793	735	522	530	656	454	724	731	522	567	640	697	783	558	718	581	695	689	568	744	471	479	641	544	753	452	686	515	796	479	558	572	582	532	561	673	570	662	631	672	481	525	524	457	704	770	659	427	653	535	627	642	515	639	587	461	423	563	570	597	669	609	599	590	510	525	573	611	611	496	606	400	468	545	539	456	411	469	489	731	460	377	575	410	450	421	439	557	503	548	579	414	533	424	519	419	501	512	429	362	329	478	505	486	515	439	560	413	494	538	554	414	537	467	441	520	420	368	435	388	423	427	354	468	506	519	398	393	449	528	382	429	358	392	531	499	555	606	471	395	375	388	540	609	609	519	347	428	471	370	335	382	409	380	356	372	305	444	454	299	467	475	372	325	470	390	610	241	284	441	422	368	436	423	278	337	367	394	357	432	535	352	385	341	413	440	310	475	364	367	401	373	478	294	270	304	379	354	262	453	374	309	396	341	522	341	431	317	359	427	308	535	283	325	377	539	319	375	263	268	268	353	434	417	373	406	339	354	390	217	288	327	250	422	285	378	293	345	345	347	296	515	334	282	398	471	314	332	259	197	347	356	359	246	266	320	289	290	336	383	368	318	298	400	313	322	305	284	352	268	281	349	422	266	271	327	330	286	232	219	436	345	274	261	307	301	336	402	280	293	279	214	328	254	227	278	231	363	417	249	279	224	297	349	305	289	329	340	282	246	311	256	201	209	275	276	326	246	273	286	194	267	289	308	303	219	347	264	300	321	263	291	308	225	247	219	377	262	350	171	220	288	302	293	318	279	285	231	223	280	321	238	220	258	216	230	238	159	261	271	257	303	219	213	227	250	307	346	284	260	173	244	324	295	276	242	248	240	271	235	183	306	202	356	193	226	253	241	290	262	240	223	270	191	256	225	202	234	234	180	220	220	204	289	223	214	321	276	263	260	211	266	248	289	202	240	329	197	223	249	226	220	177	193	203	228	218	179	285	212	191	236	159	211	396	159	227	249	273	172	177	281	228	272	205	183	176	181	220	193	270	229	211	166	244	148	256	149	330	237	194	262	383	186	235	184	128	215	122	234	240	248	240	224	249	243	153	265	116	279	160	264	189	192	279	207	204	209	277	214	197	175	207	248	207	182	213	218	209	279	200	172	202	156	358	204	151	172	149	224	160	170	262	158	172	187	164	152	157	175	141	228	202	182	190	190	165	178	190	240	222	179	191	208	169	123	192	211	184	159	187	124	239	161	198	157	179	193	187	198	152	171	163	217	189	127	171	206	187	130	188	164	215	161	167	158	208	222	150	130	167	208	143	42	158	208	192	307	128	158	192	187	113	181	177	119	142	117	200	169	172	113	199	210	193	182	137	153	204	115	158	152	221	132	158	287	185	146	110	195	130	115	153	164	208	173	132	152	194	101	87	189	179	169	162	192	152	142	168	108	167	126	131	158	146	145	137	147	201	143	165	145	163	186	110	123	93	160	162	146	88	98	156	149	154	157	177	153	177	171	117	156	131	137	87	154	230	173	155	196	114	105	138	137	153	160	194	171	192	155	146	134	193	120	160	135	154	125	128	165	109	170	117	305	127	120	170	141	257	157	107	163	140	106	212	145	127	121	234	270	152	148	162	98	116	131	164	177	92	154	144	125	109	169	289	112	98	88	164	190	142	124	207	115	149	118	160	125	126	128	86	122	133	159	105	69	143	182	113	134	129	101	153	108	179	143	96	113	120	67	92	117	269	91	105	208	102	105	135	95	100	150	103	137	134	93	126	200	92	121	137	81	144	87	133	118	131	102	125	120	110	106	104	110	72	127	138	83	124	87	84	107	119	92	62	156	213	92	83	94	148	131	118	113	108	93	107	115	184	119	102	133	85	124	110	91	138	152	176	93	99	161	84	104	140	100	53	85	164	99	64	110	94	167	97	115	75	117	104	134	104	105	70	130	166	85	80	125	122	86	126	101	102	94	79	96	106	71	84	105	128	93	87	152	222	79	107	127	88	105	129	117	97	127	85	76	77	139	119	91	65	74	110	108	150	117	88	84	99	98	99	99	98	96	114	108	95	80	101	142	107	71	117	142	72	90	120	96	150	114	100	116	117	115	86	116	125	96	78	127	126	107	83	83	131	100	82	103	165	116	104	60	138	120	142	102	52	95	85	108	169	83	48	141	88	86	97	104	64	86	104	119	103	115	85	107	63	72	77	98	58	88	125	94	47	56	95	114	93	94	93	100	59	67	85	103	93	113	131	108	73	95	68	101	165	75	166	59	53	107	60	94	69	86	64	217	48	74	95	63	85	114	117	77	97	118	75	72	34	106	76	63	75	75	105	112	107	66	63	85	82	102	74	112	62	65	64	79	48	75	57	78	79	64	96	101	77	47	70	65	71	77	49	50	60	94	78	74	77	73	87	36	90	80	51	91	52	79	117	111	71	71	60	57	39	47	112	76	46	91	56	82	71	74	72	67	48	51	49	144	94	88	74	85	142	83	60	53	67	100	95	36	53	104	107	46	43	45	95	70	94	53	54	61	52	63	79	41	125	116	54	69	103	61	51	76	87	65	68	148	46	141	146	58	65	75	81	121	46	79	87	47	40	121	45	63	64	49	45	56	32	61	69	47	111	33	64	69	64	34	73	70	72	32	57	127	78	71	23	26	55	44	76	32	33	69	62	51	48	50	91	64	73	98	90	69	55	35	55	75	53	40	75	58	49	64	32	35	50	51	76	63	68	34	63	71	84	68	49	70	72	61	60	59	37	46	54	38	64	55	42	66	71	51	60	59	75	25	45	37	52	103	45	55	88	55	45	45	51	65	34	48	41	33	67	41	47	56	70	82	58	44	52	70	41	51	53	39	60	46	49	59	104	64	33	48	96	45	61	32	43	41	45	38	79	38	28	45	49	68	24	42	57	43	53	41	19	52	156	48	31	56	25	70	74	64	31	59	56	40	50	61	72	32	58	95	59	44	68	48	47	35	19	60	39	44	25	31	57	44	70	48	87	77	87	44	40	77	54	75	31	67	50	41	58	39	36	63	26	43	43	29	47	46	98	78	30	31	25	36	40	46	35	64	17	39	51	19	22	57	36	19	64	48	49	32	33	55	66	39	15	57	31	43	18	36	35	43	51	45	72	44	21	53	27	52	45	39	51	24	32	43	70	44	33	31	43	34	32	63	36	36	17	33	23	44	27	16	30	20	29	38	46	30	18	25	34	33	37	95	57	44	24	55	48	15	55	48	35	21	38	26	38	46	23	29	52	28	8	11	45	41	30	40	56	13	56	29	79	28	28	38	26	24	26	26	13	15	41	51	38	14	25	28	37	58	75	30	37	15	45	68	83	24	28	17	49	31	21	16	7	56	62	20	90	23	68	22	27	34	47	65	21	52	31	15	41	41	45	20	46	26	24	45	22	37	90	17	43	32	22	21	31	39	26	33	41	43	27	29	29	17	23	32	46	31	21	21	25	10	16	11	25	29	62	33	19	25	18	31	37	26	27	21	31	21	20	7	18	46	29	36	28	53	15	38	30	50	25	11	27	51	28	34	31	34	5	36	6	20	17	22	48	16	29	16	23	21	31	11	18	29	13	30	22	16	12	18	28	15	5	11	6	10	4	26	20	18	13	4	23	27	27	3	11	12	22	8	12	15	28	9	55	6	34	15	20	22	15	10	9	18	10	8	18	15	34	9	50	8	8	10	45	15	8	19	12	4	11	8	13	23	14	14	9	13	19	19	34	14	25	3	6	2	24	9	11	18	14	19	6	16	2	5	10	17	2	17	1	25	7	3	6	9	7	6	10	13	13	8	6	27	7	1	7	11	13	6	6	6	5	9	4	8	5	3	0	36	5	9	23	1	16	10	7	9	9	3	6	59	8	6	4	19	11	15	7	5	7	7	4	8	28	1	5	8	2	2	4	1	0	5	5	0	1	4	6	3	1	2	0	1	0	2	0	0	2	1	20	6	1	0	1	0	1	3	0	0	3	0
ne0296	5281	3684	2911	1943	2025	3122	2225	2207	2041	3305	1796	2348	1962	1978	1302	1843	2007	1644	1415	1734	1417	1621	1354	1696	1404	1278	1481	1629	1392	1212	1120	1288	1419	1515	1006	1131	1390	1155	1453	962	1318	1242	824	1116	1110	1059	1358	1343	1037	1231	1537	1127	895	959	979	1246	1099	945	1076	1000	1357	1141	784	997	907	1074	1421	1168	1314	1047	949	837	984	738	1043	1095	895	852	936	946	1204	856	1107	761	947	1128	827	968	644	778	821	835	1199	648	894	881	1145	814	878	932	861	811	718	1082	847	921	933	1083	796	700	804	733	1224	1191	1025	723	1047	940	796	1071	834	1109	623	726	715	839	833	736	997	977	784	925	705	735	735	587	504	711	991	690	677	859	668	660	497	740	705	696	703	594	828	668	695	761	610	702	722	790	923	689	681	603	663	549	836	743	561	577	439	772	627	714	708	440	856	548	822	846	643	598	671	619	696	818	611	519	647	520	625	618	517	766	517	719	587	577	605	836	550	718	568	543	549	825	490	948	796	582	703	585	832	675	524	873	539	622	717	593	531	592	543	454	566	695	443	695	666	420	644	663	587	609	521	539	794	354	382	665	624	565	610	674	396	479	524	598	589	594	618	609	641	541	645	582	622	766	419	508	547	465	455	456	494	504	404	598	530	536	491	372	592	524	754	529	557	485	429	496	392	618	396	503	568	465	460	416	410	359	350	566	667	516	588	586	545	488	536	386	474	507	425	384	530	511	533	397	487	457	509	574	475	475	673	550	396	423	477	266	622	528	513	385	447	394	464	430	468	528	639	473	400	583	513	511	498	482	466	356	377	537	631	516	422	472	600	476	446	274	415	477	474	414	458	515	392	615	269	414	412	288	479	357	368	345	266	237	638	406	379	424	414	479	452	422	529	393	494	304	383	385	317	376	477	547	364	406	418	394	320	372	480	525	359	239	493	417	422	435	352	422	326	162	476	336	432	430	444	249	391	394	412	405	346	453	175	341	358	425	384	383	420	293	313	353	379	229	343	407	266	316	336	336	256	355	431	570	335	261	275	375	425	321	430	353	477	406	440	377	244	471	267	386	287	332	365	366	425	364	315	448	392	253	318	310	280	345	299	244	272	230	508	462	299	419	274	304	379	404	267	265	332	312	342	372	458	300	352	367	310	271	298	271	296	286	339	272	402	425	282	481	284	347	532	222	328	332	354	324	381	441	325	278	329	270	247	257	347	216	394	345	291	228	330	230	373	277	409	461	206	442	387	244	331	248	221	302	205	434	220	276	278	304	369	349	199	172	173	233	233	336	254	265	339	246	237	235	376	252	209	262	286	367	368	247	289	328	289	388	304	291	337	286	305	295	247	233	413	398	269	227	419	243	264	283	240	249	270	284	183	326	350	262	290	298	315	264	269	290	425	239	243	333	209	160	258	249	224	190	226	202	304	143	298	197	211	277	239	322	199	285	267	326	275	137	211	269	324	246	257	223	287	212	274	194	218	319	144	173	250	295	264	73	177	321	183	327	149	195	260	232	157	272	254	168	249	133	296	243	177	179	226	340	269	281	178	319	322	181	226	224	214	154	192	211	252	222	240	239	314	193	189	157	233	208	93	155	288	149	108	188	219	286	193	247	161	208	302	151	283	168	240	216	219	274	228	182	239	144	287	205	260	253	118	223	156	217	227	177	203	115	218	214	238	277	180	213	215	254	233	245	191	178	143	284	236	188	258	271	187	121	167	189	191	184	404	218	106	198	230	189	193	193	249	153	196	191	263	266	141	242	109	488	182	153	269	224	180	244	102	242	152	125	390	184	267	172	348	264	252	193	219	218	207	167	192	259	89	212	262	228	203	258	333	152	113	143	243	164	221	203	290	161	123	181	219	172	184	189	136	218	103	195	179	56	183	121	256	174	217	119	54	136	199	293	160	150	152	107	124	176	259	149	142	246	112	126	209	149	77	165	141	105	182	152	141	180	189	172	121	122	198	128	194	175	144	183	153	167	194	160	166	147	105	119	204	93	133	126	106	152	145	99	142	193	202	139	162	144	133	160	162	205	207	137	151	204	214	207	158	170	123	201	154	138	214	249	194	135	152	309	101	128	157	190	133	163	223	182	130	134	148	216	174	166	147	122	104	198	112	123	73	164	123	129	150	122	107	104	150	168	143	152	108	111	135	116	111	120	118	110	196	200	190	152	144	132	140	125	207	140	166	132	133	119	156	143	153	129	79	78	141	180	183	169	120	150	149	136	113	119	142	182	117	136	108	117	139	179	92	137	98	142	84	135	137	132	234	199	159	151	102	161	119	164	120	173	75	119	215	114	190	172	114	139	137	150	223	191	110	91	192	136	236	128	106	145	68	157	232	109	82	156	92	74	136	179	121	135	106	108	170	117	112	152	92	101	91	60	57	106	108	135	88	139	102	71	125	118	121	140	81	96	159	179	118	117	206	84	125	120	89	212	223	120	287	86	67	126	113	138	95	115	121	213	73	134	107	111	104	66	146	123	82	154	108	87	81	193	118	69	132	104	161	103	151	121	48	157	120	186	108	95	140	86	109	122	80	119	93	148	68	107	65	118	163	72	103	77	67	77	77	82	92	128	48	94	122	161	92	63	157	106	101	109	102	119	159	137	87	86	73	37	137	115	114	98	71	110	86	95	134	136	119	58	78	102	66	256	84	108	94	108	80	125	61	69	33	51	144	51	59	130	114	78	102	57	140	87	48	91	134	78	104	91	83	94	164	121	59	83	153	86	59	135	113	80	93	218	94	197	252	63	75	106	87	105	64	89	75	100	34	174	55	78	89	97	82	138	39	89	87	93	155	90	58	112	64	76	71	83	98	45	103	166	124	99	63	63	91	42	116	49	66	85	72	76	63	104	95	70	69	101	125	115	80	80	57	159	50	74	72	70	51	61	52	80	82	85	158	57	81	135	67	61	37	123	83	58	67	67	68	58	79	56	65	36	65	95	40	93	145	86	74	107	78	25	94	36	84	64	63	105	117	72	38	100	60	107	61	84	53	41	36	87	58	72	85	48	50	59	85	87	65	63	34	79	103	74	41	76	66	74	51	120	74	66	68	26	102	72	93	87	84	42	39	79	63	57	35	60	49	57	71	68	60	84	28	69	60	81	58	84	50	71	42	38	117	74	52	55	75	55	49	129	92	116	115	46	48	49	29	78	64	55	43	75	37	33	63	49	91	34	68	61	33	67	59	82	46	72	42	55	55	44	59	64	31	69	105	54	73	71	94	57	55	45	49	37	35	63	64	82	37	34	44	35	25	78	42	32	42	77	86	42	41	52	51	61	64	92	74	58	34	53	22	63	50	59	170	73	79	62	37	58	120	68	91	25	32	87	40	73	15	45	29	44	34	76	33	41	31	30	60	45	33	48	56	69	50	56	68	27	22	45	45	30	48	35	106	49	44	93	58	17	47	56	38	62	38	39	52	70	24	31	36	34	28	22	57	41	60	61	42	57	59	31	41	41	37	50	52	51	31	47	52	26	56	65	35	47	34	56	54	68	75	51	54	24	47	32	112	40	57	25	53	39	38	32	32	56	62	68	42	39	51	32	21	33	51	49	56	54	42	22	41	82	34	27	45	21	32	55	26	31	21	25	64	27	24	37	21	34	31	43	36	26	29	38	35	22	16	33	55	53	15	23	20	23	22	31	52	19	39	92	27	41	18	33	18	31	35	30	46	19	32	9	21	113	37	21	26	51	13	26	60	44	25	14	45	22	33	35	10	28	66	65	10	56	23	28	43	23	27	33	14	27	21	20	6	30	13	40	32	10	17	34	31	30	16	7	13	8	11	25	17	12	32	7	28	39	18	10	19	20	35	8	42	10	4	29	25	12	14	12	23	13	17	9	12	19	15	16	31	19	25	22	26	14	20	22	40	9	15	14	29	16	11	27	17	17	24	11	16	7	23	14	10	14	44	4	25	9	14	9	14	23	18	15	9	52	38	8	23	24	35	9	26	27	19	8	15	15	13	11	16	6	15	5	25	12	7	10	8	5	6	8	7	9	1	22	10	10	5	5	0	12	9	3	11	2	7	11	11	18	7	1	15	25	1	3	4	14	23	6	7	2	4	17	6	16	18	2	8	12	7	4	1	1	2	7	1	0	3	4	6	4	1	1	1	5	2	1	0	2	3	3	2	4	0	8	4	0	0	0	0	102	0	0
ne0297	5139	4415	2772	2397	2153	3166	2906	2395	1885	3043	1898	2218	1883	1976	1354	2122	2018	1469	1790	1725	1658	1813	1399	1797	1256	1241	1455	1608	1477	1197	1048	1260	1411	1348	1243	1185	1398	930	1567	1177	1469	1256	991	995	1435	1305	1424	1289	1343	1297	1640	1173	880	1025	1070	1245	864	891	953	875	1232	1052	799	918	938	905	1475	1117	1346	962	874	869	1200	916	1060	990	896	821	768	1044	1177	678	1217	1059	883	1036	788	958	873	630	1245	973	1212	740	850	890	1187	729	1008	942	960	1164	933	1061	922	890	878	1090	818	848	896	739	1241	1210	1000	791	976	896	772	1152	881	1108	648	643	698	829	800	659	967	930	772	1048	682	668	806	504	471	732	945	660	766	960	698	711	543	783	771	539	547	587	838	683	667	686	567	590	731	822	935	764	669	637	725	522	910	668	635	586	461	863	755	733	713	559	807	517	735	819	595	576	710	711	573	866	434	547	560	659	582	576	784	627	728	724	497	827	712	815	581	727	530	469	582	863	427	947	729	593	753	455	814	662	525	966	832	524	634	536	474	534	534	458	527	503	452	528	630	512	722	690	527	513	439	561	829	419	470	577	618	541	548	619	550	467	398	538	547	534	646	724	587	552	722	515	709	741	552	441	496	357	629	474	398	417	419	620	555	494	472	380	568	510	784	467	474	530	585	633	418	543	424	504	510	351	428	371	454	416	471	542	612	628	454	619	464	546	698	487	372	465	342	330	533	641	389	347	449	377	518	539	438	442	495	451	436	408	349	218	449	583	510	379	409	392	364	593	544	529	612	396	412	601	512	486	495	375	449	352	435	494	599	354	531	510	476	476	324	271	412	437	500	443	484	597	416	611	302	425	309	298	452	358	545	342	357	422	583	421	436	324	442	377	522	406	520	355	470	295	373	444	388	377	486	478	363	390	355	383	343	371	468	384	414	193	437	430	433	508	310	340	315	296	391	324	492	375	370	332	429	430	343	450	347	415	362	438	380	455	348	453	411	309	370	410	388	301	410	459	316	321	584	349	326	331	420	587	356	280	296	346	421	261	380	323	492	348	307	363	259	510	263	334	418	335	336	303	418	362	358	458	440	345	358	357	278	324	306	318	246	348	258	406	333	380	499	381	425	378	253	301	322	334	334	282	495	234	368	448	534	288	268	259	289	255	313	278	340	379	251	536	216	292	560	396	683	310	284	269	398	493	323	263	312	258	315	264	355	179	404	303	318	218	338	351	403	307	342	546	167	463	440	251	330	233	230	287	226	428	282	228	276	294	359	376	223	379	185	225	247	409	399	264	405	235	240	161	429	265	244	287	203	358	386	251	299	357	302	399	331	266	217	318	298	277	252	378	297	282	245	346	454	191	264	251	310	168	196	259	246	367	311	248	309	262	247	217	365	305	479	219	281	232	185	211	277	237	239	238	226	168	293	255	261	219	226	160	284	357	241	265	232	256	302	134	417	307	298	345	219	184	284	223	256	239	198	287	174	223	178	248	294	116	184	324	244	266	171	305	241	252	119	231	222	161	222	157	275	373	159	180	266	339	262	225	183	385	350	216	224	194	130	142	177	373	272	298	205	211	256	158	284	171	176	195	149	197	251	190	219	178	233	362	200	203	130	190	331	125	280	155	195	306	177	322	206	217	231	171	220	202	278	195	122	215	160	169	242	228	181	145	222	206	220	253	217	168	205	253	245	205	164	185	272	236	229	161	165	261	189	153	223	179	202	214	349	249	220	155	271	196	176	210	188	165	181	188	276	280	129	252	198	413	213	171	265	145	156	263	220	219	207	115	384	178	243	154	325	279	232	230	204	261	269	200	225	201	154	199	186	198	225	266	366	139	138	160	229	184	165	233	253	193	126	157	219	205	191	186	157	228	83	175	242	140	245	306	208	212	225	104	262	165	186	233	157	158	184	149	167	183	165	132	106	248	159	90	150	125	115	224	120	135	351	134	154	115	115	152	121	143	135	124	226	165	140	155	140	145	181	145	110	144	171	133	173	113	140	105	122	167	154	119	119	229	173	138	181	110	126	193	177	195	149	210	231	140	209	183	135	134	132	220	137	116	142	207	275	189	125	276	174	150	109	252	87	126	303	184	108	161	125	209	109	147	100	210	121	166	132	113	120	183	184	143	163	89	107	119	122	127	117	131	99	138	211	75	78	165	124	151	199	225	154	158	174	155	169	183	120	186	155	139	92	177	91	135	113	122	79	86	158	157	129	178	100	131	134	187	117	137	178	189	71	160	113	116	130	197	166	197	110	229	130	128	115	104	201	154	153	133	255	108	86	164	106	157	97	144	171	168	167	178	136	127	138	162	207	151	92	91	194	153	208	102	215	95	133	109	180	140	74	177	104	89	87	175	147	148	164	128	148	128	91	187	107	107	94	79	79	124	111	103	58	97	89	78	154	65	157	142	113	118	182	167	101	103	228	86	75	85	115	160	194	126	284	133	111	121	118	111	116	85	160	132	93	173	102	111	106	71	129	97	91	189	61	72	54	219	133	71	113	89	139	117	169	103	57	92	105	139	86	145	172	88	114	132	103	80	67	161	56	75	70	100	154	75	87	88	91	125	70	60	96	124	45	127	96	174	96	121	124	99	91	124	76	123	194	132	74	79	60	78	93	107	112	114	98	74	90	113	131	103	65	50	127	71	70	272	108	144	93	107	58	103	79	75	33	56	87	77	55	118	91	128	89	55	103	86	55	87	162	62	74	56	109	107	86	116	73	55	184	59	93	86	118	88	103	244	62	225	258	55	62	144	81	74	79	94	50	80	62	152	46	155	88	111	80	40	61	81	77	67	199	45	81	106	61	106	70	105	96	26	112	160	113	73	39	61	74	55	91	59	110	68	102	70	55	103	98	61	78	117	122	163	78	39	78	107	51	72	90	85	41	124	67	75	66	64	141	127	102	48	73	77	52	76	79	60	73	67	84	52	51	42	84	48	83	81	83	70	165	74	67	45	37	45	94	77	61	86	53	70	123	59	44	114	64	83	106	89	19	68	32	75	68	75	50	45	49	47	83	98	50	58	61	69	93	91	47	66	60	102	97	110	58	66	67	62	89	90	39	76	96	61	68	43	46	71	47	24	56	85	70	52	43	44	37	50	45	90	82	61	68	36	47	47	102	73	41	40	72	37	65	59	72	59	89	71	29	82	37	74	39	64	40	77	36	69	64	78	84	45	60	40	102	49	31	143	44	107	81	73	40	27	110	58	41	69	98	88	54	47	87	83	80	74	54	51	67	42	99	94	45	21	44	50	35	51	38	21	55	110	85	34	44	53	64	62	31	57	53	50	38	38	37	58	50	68	15	53	23	32	31	69	45	58	61	24	50	48	39	63	60	81	63	64	46	68	33	23	43	61	64	41	25	70	28	79	39	29	66	25	43	59	45	31	44	15	91	51	52	68	32	46	93	71	40	34	37	31	34	76	41	20	69	38	41	18	51	42	43	91	23	45	33	35	34	44	52	66	37	37	43	41	40	44	56	53	20	37	28	34	41	55	21	46	44	27	53	38	132	34	37	39	71	56	25	48	14	79	16	70	46	31	38	51	26	66	45	29	31	75	68	38	36	31	31	37	47	25	34	55	44	46	35	36	48	16	51	62	59	25	30	46	48	37	21	80	34	49	12	28	22	58	42	48	36	28	33	22	24	18	39	14	38	55	19	21	14	16	36	30	48	48	52	17	24	92	36	19	23	46	23	34	46	32	23	33	36	50	22	25	11	26	19	51	24	62	22	21	57	24	27	31	44	29	24	13	15	43	23	9	34	16	7	24	31	19	17	14	12	15	16	31	12	11	24	19	44	23	24	9	20	8	34	20	47	12	7	25	10	27	22	18	25	21	17	8	17	32	13	20	26	17	14	19	21	18	18	28	19	13	11	7	23	13	13	32	8	20	25	24	18	16	30	18	15	24	32	15	18	16	23	6	10	19	22	10	6	28	14	10	21	18	10	18	2	30	12	4	12	8	16	21	15	7	10	2	7	20	11	20	5	24	13	22	7	16	6	32	8	7	7	11	8	24	3	14	8	5	11	8	12	11	6	3	7	7	7	6	15	15	19	7	10	1	11	13	3	15	27	2	6	10	8	5	6	3	3	3	2	1	3	6	1	3	6	0	1	3	1	0	1	2	3	2	6	12	3	11	2	0	10	2	1	0	4	0
ne0298	4665	3580	2427	1628	1788	2447	1962	1793	1476	2846	1576	1724	1572	1626	1121	1568	1630	1374	1360	1361	1025	1561	1165	1332	1089	1058	1062	1402	1198	976	936	975	1254	1158	938	970	1206	789	1217	727	1242	1167	801	855	1091	1010	1178	1051	1054	1199	1208	1062	773	769	914	1030	783	683	858	725	1004	800	620	619	878	836	1187	846	1003	924	748	678	844	528	814	718	623	658	633	842	1052	580	946	633	601	837	690	929	553	586	913	703	923	484	768	750	995	626	731	684	732	865	900	838	665	841	574	854	645	664	765	637	1000	993	837	625	820	699	881	849	546	903	420	590	550	791	551	494	766	760	752	839	511	540	667	441	383	707	792	574	627	744	532	650	566	618	561	446	519	558	837	500	618	568	520	495	635	626	730	663	491	479	687	521	673	559	505	332	624	663	526	585	708	429	633	482	653	654	461	460	734	546	437	518	359	469	431	565	482	491	369	662	371	731	448	638	565	648	403	532	475	433	489	649	401	717	615	497	689	391	637	518	420	694	553	396	592	411	488	417	365	322	437	508	396	413	457	471	571	573	426	453	363	512	618	370	448	478	457	461	423	508	326	358	209	471	471	461	535	544	448	415	544	402	553	592	327	469	387	349	488	403	334	434	364	607	460	383	379	329	467	475	668	417	355	346	397	495	312	498	366	432	465	311	338	384	444	376	410	433	598	479	354	505	371	403	527	299	395	353	273	304	466	483	381	283	334	292	322	424	345	388	413	394	310	215	333	140	351	557	384	380	316	332	263	432	467	389	470	283	339	501	442	274	446	344	298	387	349	474	518	349	478	556	406	376	321	228	297	404	337	390	370	521	378	486	222	280	296	253	433	289	416	288	304	358	515	340	354	310	366	311	428	342	433	321	330	243	304	306	345	317	337	432	302	461	272	283	259	289	458	360	271	204	327	296	348	373	325	228	299	172	349	309	430	404	270	229	300	342	336	390	315	356	243	204	295	395	315	397	315	290	308	405	333	162	272	367	246	281	399	258	204	228	338	517	218	268	216	234	360	230	343	271	424	268	262	188	197	433	203	245	338	237	276	240	318	270	245	401	345	298	301	348	285	224	227	231	183	199	292	448	221	284	334	235	360	305	222	245	346	245	279	254	358	226	252	275	404	249	198	246	273	214	220	202	289	353	169	450	188	268	435	284	450	222	226	259	304	381	309	260	235	264	217	189	255	151	352	217	224	194	256	255	329	230	273	490	156	406	391	208	324	212	248	263	190	298	155	170	240	252	281	311	184	104	208	169	188	330	240	176	279	164	233	173	328	287	200	177	166	309	347	215	217	260	190	276	359	270	164	140	190	229	186	284	187	188	221	217	369	181	213	221	280	167	202	201	133	293	256	187	265	188	236	119	276	231	374	211	205	225	174	173	192	219	220	159	177	166	290	175	195	149	169	177	193	275	171	222	162	169	253	88	246	283	248	278	179	153	213	129	187	198	186	222	288	148	192	211	266	104	137	283	166	181	144	211	188	218	120	203	209	136	186	170	198	287	140	167	215	254	211	186	154	359	238	133	205	197	113	132	155	267	163	247	175	134	179	125	189	127	183	156	157	161	231	176	82	152	203	335	162	178	125	134	255	116	302	163	147	222	190	179	177	176	178	320	196	188	205	213	112	178	120	140	162	152	171	122	159	169	128	164	105	148	204	210	174	178	116	159	163	155	159	134	106	230	192	95	143	155	143	188	340	240	102	160	199	172	313	147	167	112	146	192	221	229	80	255	118	333	199	156	204	146	99	227	149	196	125	108	335	139	134	143	259	198	161	165	213	189	184	159	124	213	124	157	138	140	160	185	238	119	92	148	197	152	171	169	258	153	101	148	173	159	185	152	104	198	99	272	196	117	173	232	159	149	137	121	144	98	288	158	143	128	150	131	194	127	115	79	115	152	121	86	133	140	110	168	115	91	250	115	141	117	142	135	116	81	133	106	200	158	89	122	125	141	139	110	93	82	107	124	115	94	86	93	130	118	99	101	73	185	154	103	141	89	116	145	124	189	104	98	153	86	190	121	120	106	108	145	88	106	142	157	225	135	121	225	108	232	127	149	55	96	195	155	65	158	81	211	111	102	106	121	133	139	116	66	85	122	107	119	108	106	113	88	88	122	95	95	120	93	113	72	88	174	131	70	220	195	120	126	96	121	136	137	96	151	108	140	66	69	85	90	137	87	74	65	144	98	117	136	86	97	110	113	116	68	140	155	62	116	102	95	118	142	101	114	102	149	92	129	111	98	210	152	109	92	140	129	82	147	101	117	86	100	118	136	133	162	104	112	132	128	220	133	129	85	155	125	200	53	187	82	95	96	194	69	60	130	85	56	89	131	65	97	144	96	110	136	83	134	136	110	81	81	68	125	84	78	77	82	73	105	141	83	127	123	82	75	152	142	83	80	162	79	101	76	100	100	248	106	205	122	196	102	105	96	100	70	74	121	75	115	95	76	101	78	111	105	74	120	90	87	38	221	121	46	107	88	90	103	109	59	62	66	76	175	65	103	101	89	87	95	69	55	74	84	73	80	48	104	120	86	81	61	74	91	62	60	113	113	59	100	73	142	65	77	114	105	59	105	79	75	152	96	53	61	52	73	72	66	93	72	69	76	50	82	129	95	104	36	103	78	74	234	70	110	113	85	49	85	115	54	49	38	88	56	68	82	90	77	64	83	95	55	51	59	110	62	75	59	85	88	55	89	42	49	149	53	104	61	85	60	94	202	51	164	174	68	43	101	63	42	89	68	58	81	41	170	36	84	61	74	92	53	52	65	75	68	167	59	60	84	57	78	67	65	79	47	82	176	77	73	43	44	50	44	59	68	82	47	110	67	25	90	80	54	67	84	101	119	53	35	76	80	45	52	90	72	40	80	52	45	49	94	86	56	110	52	41	30	34	70	45	44	84	83	80	40	55	46	59	30	72	60	93	66	100	60	49	48	45	39	58	62	48	49	45	73	84	60	33	58	65	50	95	45	15	41	31	64	76	67	47	79	31	40	49	75	73	36	49	58	51	77	29	48	68	44	26	84	51	35	45	50	118	40	33	68	85	36	71	61	52	87	43	29	38	60	56	37	50	45	96	37	27	58	56	51	32	40	23	18	89	32	30	36	63	47	48	60	64	41	83	86	30	52	30	84	35	74	37	66	33	50	46	56	52	38	31	19	93	45	29	105	27	74	66	33	47	24	68	42	42	54	78	61	50	38	74	50	61	50	41	52	42	45	38	79	41	21	55	42	38	34	51	38	29	82	55	40	29	50	40	37	21	60	32	26	43	22	51	41	37	64	31	34	21	33	38	64	21	42	64	22	27	50	37	45	14	40	32	61	37	61	23	32	25	32	31	36	30	40	90	58	48	46	33	14	78	50	20	31	27	17	53	33	28	61	25	16	40	48	51	45	38	27	28	31	39	36	31	38	24	18	43	27	30	59	22	25	31	36	29	17	36	89	47	30	38	37	21	43	22	66	24	32	13	34	40	37	22	26	58	51	33	11	111	30	32	36	48	49	29	46	19	50	24	40	43	37	35	23	22	41	27	20	15	53	49	30	25	26	13	12	28	15	17	48	67	19	9	18	31	22	22	46	37	33	14	30	25	20	21	55	9	25	11	19	31	47	39	69	21	15	19	34	31	20	17	51	26	22	16	22	19	18	33	24	55	25	56	14	28	88	69	15	19	37	16	22	28	30	22	16	34	30	13	13	19	24	26	49	13	25	15	16	45	13	14	16	18	15	11	15	19	42	9	17	31	24	12	13	14	22	12	17	7	14	11	26	16	17	13	4	30	19	9	3	10	11	18	14	50	18	15	22	13	11	18	14	29	11	15	5	6	37	16	23	14	13	15	5	9	16	9	37	16	14	6	10	15	14	7	23	14	18	23	9	6	4	33	17	6	15	29	3	7	6	12	2	10	26	14	14	7	5	6	5	31	15	6	9	9	21	6	5	4	10	14	7	13	3	26	7	10	8	12	11	2	6	9	17	5	17	4	18	8	7	5	3	8	8	5	8	3	3	6	14	4	5	5	10	3	20	0	6	13	9	18	3	6	5	8	6	1	5	6	1	7	16	6	0	6	4	4	5	3	5	5	1	1	3	1	4	5	1	2	2	0	1	0	1	3	3	3	5	1	0	56	6	0	2	0	0
ne0299	823	895	593	402	675	324	403	208	345	493	391	236	301	243	233	244	232	391	251	216	429	311	245	268	258	277	315	310	241	300	271	257	302	178	223	259	258	238	316	164	256	279	269	160	155	79	141	184	219	273	114	213	311	220	154	300	169	167	225	324	123	192	215	167	201	166	116	218	237	238	171	222	271	213	209	279	116	147	184	267	229	210	92	202	179	121	191	253	188	137	210	145	79	132	148	196	160	155	141	172	123	173	155	98	159	230	198	63	139	103	193	134	88	82	81	115	66	136	224	91	212	108	119	161	143	178	136	229	59	75	168	163	230	85	178	123	163	178	81	141	153	135	149	175	131	118	104	183	134	106	195	145	100	106	98	155	97	227	52	69	115	156	198	87	117	182	130	159	302	124	108	164	152	64	54	123	162	76	121	134	182	78	162	97	174	231	157	100	133	101	125	115	192	149	172	81	119	47	94	105	103	137	187	119	175	117	179	91	171	113	45	155	140	102	70	185	164	166	102	116	79	162	161	88	120	213	69	77	170	170	135	92	141	163	131	86	158	135	123	112	134	96	82	93	73	86	97	111	118	83	123	68	111	105	96	37	109	83	141	126	110	122	73	75	90	110	78	205	107	110	108	152	64	92	57	77	94	66	176	121	161	92	168	116	192	114	87	71	110	117	135	82	136	116	82	123	104	75	114	75	69	49	114	129	77	71	101	140	68	130	79	105	108	137	149	68	67	163	92	97	103	117	86	198	51	61	93	98	112	103	69	68	66	64	93	73	101	143	38	111	111	63	55	59	63	159	74	62	117	137	73	119	102	102	89	62	24	114	116	133	144	57	56	79	65	61	100	125	74	61	110	113	70	54	109	93	109	44	97	51	110	80	66	61	114	78	59	59	44	74	158	78	71	125	95	66	127	75	67	72	62	115	65	67	65	142	102	49	32	70	87	108	66	59	44	47	56	79	60	27	70	137	135	63	84	48	46	73	47	83	61	60	83	82	48	80	72	72	79	57	74	93	117	97	75	76	56	90	91	62	58	104	62	79	81	63	70	90	54	83	60	60	106	52	97	38	64	41	55	64	36	79	58	46	92	79	53	52	61	68	67	52	48	50	58	122	76	83	41	100	189	70	65	135	65	50	150	89	74	58	100	50	59	26	36	55	77	79	75	70	84	35	54	98	62	97	57	87	60	76	56	52	106	30	70	54	89	92	46	68	84	57	67	99	63	64	91	36	37	96	70	56	60	71	109	55	52	28	56	67	64	35	40	50	60	44	81	64	43	46	74	43	60	66	61	45	59	86	119	67	68	50	76	66	53	60	54	71	48	36	94	53	79	55	38	50	56	52	32	34	81	40	72	77	42	39	37	74	54	40	39	53	26	33	49	58	79	56	44	43	179	17	65	72	74	52	39	45	62	58	47	53	53	35	44	42	77	52	48	49	51	34	62	42	72	84	55	47	57	35	71	22	84	52	80	51	34	30	82	59	42	61	74	49	44	36	46	33	32	89	36	32	57	55	39	68	34	62	49	72	23	23	29	24	35	61	22	58	46	68	48	25	83	48	107	53	77	157	38	66	73	58	25	66	52	57	43	81	28	63	45	55	71	55	29	25	57	44	25	47	46	59	36	36	19	34	20	27	19	29	30	53	51	57	44	42	37	55	39	52	44	38	27	39	44	16	63	27	40	74	33	42	62	30	58	50	79	46	39	52	40	36	45	32	49	42	26	36	49	68	42	65	44	43	55	27	42	20	79	56	40	25	60	42	28	22	32	26	26	26	27	27	26	36	30	29	49	16	49	47	26	27	42	57	110	21	31	48	52	74	65	43	42	37	18	47	37	57	15	21	42	48	20	22	33	10	31	44	61	19	8	25	36	33	15	33	13	49	44	16	21	36	19	41	26	36	43	29	29	41	19	31	17	32	31	28	24	26	31	54	23	71	28	16	27	27	36	31	40	143	52	37	13	45	53	45	42	40	30	37	40	26	24	30	20	45	16	27	33	55	22	22	42	42	21	38	46	34	35	30	42	38	40	51	49	39	21	28	26	43	43	34	42	36	10	54	15	30	34	34	43	82	26	16	43	15	63	38	19	35	8	29	51	30	22	30	25	24	23	60	25	46	33	29	30	22	12	15	31	33	41	33	12	19	20	23	28	16	31	7	35	62	50	30	29	56	45	28	12	12	16	34	19	29	35	26	34	17	20	124	25	25	10	31	29	38	29	29	10	34	14	55	10	45	36	35	58	32	25	15	17	14	38	69	43	38	16	30	45	7	69	26	61	30	30	23	65	30	37	10	35	28	73	11	24	30	12	14	74	18	14	25	25	34	18	40	31	50	23	14	21	38	28	9	25	19	15	8	16	23	16	12	61	7	33	9	25	14	34	42	18	19	14	27	24	22	33	20	25	40	13	30	58	12	23	16	25	40	29	19	34	10	41	22	23	15	13	33	23	14	53	6	32	11	23	26	38	31	21	10	25	27	22	55	18	23	24	20	25	36	35	15	11	14	33	16	9	40	16	16	42	8	25	36	33	25	12	16	19	22	40	19	48	22	7	6	15	41	17	3	22	32	33	24	13	17	38	23	23	19	54	23	5	27	19	12	14	42	25	7	35	27	43	23	19	13	11	26	17	13	13	12	33	29	31	19	7	3	15	23	20	17	35	5	27	38	26	12	11	20	25	15	11	18	13	28	13	27	22	57	10	23	11	17	25	8	16	18	12	19	27	13	20	12	36	13	6	5	18	23	13	60	17	25	19	19	47	13	8	21	12	8	18	23	20	39	9	12	24	16	11	12	17	56	10	34	22	68	35	16	28	25	15	30	34	23	52	12	38	29	10	16	16	15	28	55	19	13	12	21	17	19	23	8	105	12	19	15	22	15	19	21	16	13	6	15	19	5	9	35	19	62	16	23	4	8	13	31	23	16	10	8	8	7	35	5	9	9	13	14	11	24	17	22	18	23	11	33	7	18	5	96	15	42	16	11	21	27	15	8	13	9	9	9	41	12	10	12	8	2	22	8	6	13	11	19	5	18	20	8	3	13	13	3	12	14	11	24	8	13	26	18	11	26	17	13	17	27	11	15	2	10	8	12	15	13	18	11	15	14	14	22	1	23	20	7	12	34	15	34	9	16	22	8	10	14	16	18	13	14	17	15	17	4	12	18	26	16	9	28	19	3	2	29	9	13	15	14	16	8	16	11	13	7	11	13	7	8	8	14	14	22	11	4	6	15	22	7	16	6	10	13	8	14	37	23	27	17	1	15	6	19	9	12	13	7	4	14	15	32	3	11	6	21	8	12	7	13	6	16	12	6	3	23	5	4	5	2	4	4	14	3	11	17	12	12	32	7	22	17	16	10	8	11	39	12	20	8	16	9	11	12	21	8	8	12	14	11	13	7	9	2	10	9	47	8	7	6	6	4	22	10	14	20	11	12	24	18	45	4	4	3	11	8	14	1	19	17	12	9	8	3	16	7	8	7	31	4	5	13	7	9	4	22	7	7	5	13	5	6	4	40	15	8	8	5	7	2	9	4	4	11	12	13	11	19	12	3	10	5	5	10	12	6	5	2	12	8	3	8	5	6	14	3	8	0	11	7	1	1	10	24	9	1	4	5	2	23	18	5	5	16	19	5	5	3	6	13	4	6	2	4	7	7	3	6	3	13	38	5	4	4	4	16	3	14	27	3	18	8	13	4	10	16	2	7	3	4	3	12	20	3	18	7	7	0	1	8	0	6	0	2	4	19	3	1	24	1	3	0	5	3	1	4	4	0	4	0	5	3	4	2	19	1	4	2	4	1	4	6	2	35	6	4	11	0	4	3	9	0	6	2	0	4	8	4	4	4	3	4	4	5	1	4	3	0	4	2	2	6	7	1	4	0	4	0	1	3	3	1	8	3	2	8	0	5	1	5	1	5	4	10	2	2	2	2	0	7	1	4	2	0	9	3	3	10	6	0	0	1	3	2	0	0	1	3	0	7	4	4	1	3	1	3	0	3	2	1	5	0	0	1	5	2	3	2	10	2	0	2	0	0	5	1	3	0	3	3	3	2	2	0	1	3	0	0	1	0	1	1	0	0	0	2	0	4	0	0	1	0	0	0	0	2	0	0	0	0	0	0	0	0	0	0	1	0	0	0
ne0301	2240	1696	1131	1061	1204	838	700	686	1062	717	991	724	764	640	560	632	534	705	489	608	553	494	516	475	651	714	579	422	595	521	612	627	426	504	379	547	445	688	628	409	434	406	735	561	300	338	429	276	294	429	364	364	333	323	470	350	636	415	527	337	354	418	678	411	407	362	390	410	329	417	438	449	393	325	436	504	355	510	428	576	327	734	343	418	527	374	370	326	437	370	274	270	312	296	354	328	339	493	294	499	345	268	298	310	303	301	299	327	242	351	268	300	305	311	327	298	317	253	349	302	301	303	271	308	296	280	286	437	288	323	324	186	300	259	333	306	398	436	308	279	253	287	421	239	324	271	284	313	262	266	260	319	229	211	226	428	139	227	283	147	289	293	312	343	148	311	264	251	251	221	247	247	247	232	327	252	168	314	291	252	165	223	229	229	181	250	175	158	368	279	261	149	307	218	358	168	302	258	267	322	268	425	405	244	404	205	215	148	128	227	253	317	306	117	151	322	255	216	140	244	185	137	210	183	150	247	169	278	176	154	210	240	224	266	221	246	356	234	146	214	191	205	182	226	700	159	225	279	200	182	266	328	209	709	187	232	391	112	420	223	158	191	186	124	309	188	105	294	260	218	198	201	142	245	233	197	170	125	166	198	198	197	235	157	194	197	125	160	181	130	149	170	221	159	105	239	182	156	136	209	203	103	282	138	172	240	363	268	102	213	169	260	199	1064	182	614	172	503	121	219	248	158	180	260	234	158	169	167	217	717	184	177	117	108	157	202	157	125	140	131	213	170	156	99	141	133	165	132	152	168	169	156	137	129	161	198	119	167	205	175	190	173	132	297	111	323	200	126	117	162	190	189	129	129	179	151	122	72	179	173	129	209	115	135	200	173	227	114	130	169	157	251	147	230	123	179	112	112	134	150	140	75	136	102	113	126	323	119	169	151	183	201	199	119	113	161	290	109	236	105	110	186	99	110	86	108	80	180	132	138	95	99	181	136	141	133	151	187	89	181	83	117	141	123	110	124	116	124	123	70	93	117	158	137	99	174	81	126	112	65	123	118	117	109	140	123	121	70	145	150	119	53	86	129	95	130	115	135	144	118	136	94	158	160	167	121	85	95	59	80	103	150	157	209	152	175	127	173	159	90	168	70	109	105	63	220	137	105	78	164	65	76	128	179	96	146	115	290	149	148	128	156	98	129	155	104	164	65	131	103	83	77	129	182	132	79	232	69	110	130	112	134	95	128	151	221	99	80	129	119	116	134	104	146	115	107	80	127	93	189	156	75	62	240	130	100	124	188	124	208	74	73	115	135	97	79	85	71	89	101	53	103	131	106	76	63	89	116	87	107	121	47	72	112	107	113	66	95	67	87	72	149	80	63	123	168	115	158	148	104	68	77	78	135	112	186	273	96	93	60	105	126	103	65	70	75	88	72	125	82	85	112	144	87	148	98	114	69	108	177	91	85	89	90	143	90	156	75	111	101	140	93	59	94	94	57	93	63	95	83	58	61	110	116	64	68	109	91	63	103	103	145	98	45	98	98	116	112	66	89	125	124	93	109	41	125	89	70	84	126	113	54	89	282	80	115	49	141	51	109	96	84	155	173	66	57	76	87	71	55	105	101	123	119	91	138	32	58	68	77	47	81	83	59	57	114	98	101	87	101	84	93	54	65	99	82	104	59	118	133	45	125	58	97	65	103	107	125	112	111	85	84	79	54	144	121	75	103	155	123	55	64	54	65	112	90	162	54	88	81	94	68	41	60	67	64	41	78	50	127	68	40	35	62	111	99	78	30	81	73	53	68	59	83	48	54	64	54	83	109	55	92	182	61	34	57	118	71	58	46	59	68	50	78	90	57	70	41	57	45	36	47	431	79	51	117	57	89	77	45	90	92	54	125	70	68	51	82	102	39	104	89	35	150	95	55	57	150	74	85	52	65	85	59	90	74	69	66	51	48	73	66	44	83	76	91	48	38	109	80	62	71	84	47	49	92	56	51	72	74	51	46	110	48	46	32	78	34	50	32	59	102	79	90	69	81	42	67	53	57	42	41	45	54	66	58	39	73	65	59	52	48	76	54	73	137	63	35	52	85	35	45	100	70	42	62	85	44	62	72	108	56	58	76	55	55	73	41	43	58	49	54	79	37	56	60	43	40	70	58	36	46	92	30	54	79	63	54	70	143	38	36	68	38	76	72	32	81	70	48	70	38	66	30	54	74	75	61	62	26	32	31	27	62	66	57	38	53	27	36	57	51	52	50	59	36	41	43	60	62	44	91	49	24	51	83	51	40	77	32	45	26	57	62	47	69	65	51	30	40	44	60	47	150	52	26	77	42	48	47	56	61	22	41	47	101	69	30	18	29	37	84	70	40	85	36	40	41	33	30	78	61	26	45	73	151	52	186	31	77	33	56	25	28	29	33	42	66	59	48	35	52	23	53	84	63	54	63	41	65	70	30	51	26	52	33	52	55	39	87	58	33	76	73	49	59	45	126	71	67	47	46	62	43	62	63	37	49	35	34	54	24	26	35	33	31	29	44	31	56	65	25	19	45	27	33	69	42	41	15	41	43	40	34	41	34	43	32	46	24	49	38	47	39	44	46	37	42	45	70	32	38	44	39	47	27	37	25	71	36	28	41	68	42	54	71	25	31	67	36	56	48	42	16	25	59	44	30	43	25	33	31	20	19	38	139	44	33	47	46	29	58	28	30	26	22	26	50	73	21	23	29	126	34	62	85	36	50	47	12	38	14	35	91	70	23	38	37	64	26	29	26	30	30	205	59	61	11	50	36	49	22	61	9	64	44	20	26	19	62	40	39	30	42	34	24	78	38	54	25	21	63	32	32	48	59	46	35	58	43	30	23	33	18	36	38	22	35	29	65	22	30	34	54	29	37	35	29	42	32	42	44	34	60	24	23	22	47	36	28	14	77	11	39	64	48	23	39	80	35	26	35	37	28	58	35	15	29	49	43	10	16	51	52	35	115	41	38	22	16	33	28	32	15	39	32	35	32	23	19	50	16	41	62	18	39	169	26	35	26	27	21	36	24	25	50	11	55	28	38	51	27	20	18	19	34	31	27	89	9	12	30	30	20	29	19	33	21	33	48	25	36	15	31	27	39	19	11	22	52	7	22	13	15	42	42	59	37	67	21	7	29	374	28	24	39	15	16	19	27	21	23	60	33	60	31	31	36	55	10	25	24	26	27	22	24	28	11	20	28	5	10	18	12	21	42	35	19	50	12	37	16	25	15	25	39	34	30	21	35	37	21	34	34	6	15	25	54	21	43	34	134	26	15	71	26	16	79	17	53	17	22	70	17	14	14	15	33	14	22	5	19	11	12	18	20	21	31	30	37	19	14	20	21	17	29	24	32	14	13	11	21	17	7	14	29	15	13	31	11	21	32	12	13	25	16	12	13	11	16	17	14	26	7	21	21	82	9	16	11	47	18	19	14	24	29	22	11	14	23	70	14	15	89	15	12	34	21	18	15	15	25	33	24	4	30	17	18	5	17	34	14	36	5	7	11	62	24	28	31	30	6	14	15	8	16	65	14	15	11	379	4	16	65	100	14	25	15	9	12	12	18	10	27	14	27	27	7	17	6	27	39	20	21	17	41	6	12	21	11	14	44	3	19	12	14	9	20	10	57	3	15	2	8	17	21	12	7	17	14	15	17	7	19	11	50	12	2	16	21	12	14	20	13	9	7	12	9	12	17	3	13	12	16	22	4	14	14	12	3	7	23	8	12	13	7	14	10	3	19	25	11	7	7	5	8	7	7	3	9	13	16	18	13	9	9	3	7	6	13	8	34	6	10	11	3	11	7	21	5	1	2	11	7	12	12	14	8	17	11	31	1	5	2	5	4	11	7	15	5	6	7	2	8	16	13	376	1	7	7	50	3	8	10	3	2	9	13	7	8	29	23	7	6	29	4	7	13	15	9	7	2	1	12	11	2	2	6	6	5	8	9	5	11	6	2	10	7	4	2	11	4	11	9	0	369	0	3	0	4	8	0	7	21	7	5	2	5	2	5	21	1	9	2	3	3	2	2	2	2	2	3	4	7	8	1	0	4	2	18	2	1	0	8	4	2	2	0	0	1	0	0	1	1	1	0	1	1	1	6	4	1	1	0	1	0	0	0
ne0306	2322	2529	1577	1086	1083	1565	1284	1262	973	1274	857	1178	1001	1007	1083	777	877	886	832	1097	982	769	800	724	720	594	888	895	802	1036	570	812	657	773	802	880	581	662	719	677	638	678	498	725	531	618	527	654	768	620	698	646	537	464	634	728	464	634	731	546	678	415	456	410	496	629	611	527	542	562	598	472	587	457	369	709	475	475	627	436	496	613	464	420	517	426	459	618	421	653	517	570	448	480	380	382	345	411	478	462	515	474	407	380	502	419	363	422	421	475	416	501	432	450	422	411	427	495	504	412	410	385	369	525	503	346	359	368	382	415	350	438	295	374	458	325	317	358	366	308	354	409	255	350	277	406	334	320	403	477	375	319	428	362	486	293	414	326	346	358	353	404	361	467	521	317	353	412	349	385	412	314	335	460	324	378	413	327	303	347	298	385	356	372	268	428	338	406	368	377	320	307	214	284	350	461	234	322	396	265	376	306	301	357	272	381	311	296	314	366	299	280	227	413	213	333	280	332	284	413	468	258	349	404	415	283	384	508	286	299	350	367	272	235	425	356	265	376	417	281	215	351	310	235	195	300	277	273	247	309	250	184	355	291	246	268	175	323	279	262	301	289	297	296	274	267	227	201	343	290	226	241	338	290	275	195	284	255	424	276	211	272	281	254	183	253	284	222	185	267	361	274	342	295	191	262	321	262	308	268	255	195	215	293	347	241	230	321	244	249	278	265	313	196	234	174	313	161	269	391	271	445	217	157	190	282	219	214	202	173	243	237	279	221	286	303	288	191	270	267	235	280	384	214	246	212	299	228	170	190	244	226	286	230	244	281	164	148	175	212	170	282	218	203	212	213	317	295	256	301	212	164	242	252	178	191	351	231	207	192	126	201	232	203	291	215	195	257	196	218	196	168	168	169	201	170	171	190	224	259	279	191	179	237	244	146	149	177	217	290	216	259	218	212	213	187	184	159	224	254	215	181	183	339	202	252	226	249	162	216	231	179	142	231	208	292	171	132	233	142	177	219	126	187	186	158	137	202	232	164	189	132	121	169	262	174	262	226	140	115	186	184	146	126	154	176	153	154	180	120	68	157	167	173	176	203	195	119	135	133	147	105	178	205	165	164	233	191	231	199	174	239	147	107	181	120	170	143	207	165	152	206	253	135	223	146	141	170	184	206	120	248	190	134	164	166	123	106	161	142	144	131	261	132	128	122	184	231	212	210	192	160	158	152	128	209	139	240	157	153	161	135	188	180	115	76	119	151	217	173	131	160	151	145	195	206	195	150	135	109	160	181	173	105	153	164	107	159	135	176	162	152	110	160	132	137	138	190	147	134	216	159	144	136	290	115	112	132	142	180	90	122	118	189	199	121	159	174	144	169	141	168	164	149	115	119	117	165	152	69	92	265	190	123	154	86	115	125	109	202	119	174	136	133	197	107	120	180	143	160	122	139	104	153	116	254	121	116	108	174	155	91	160	126	123	133	228	129	185	133	152	110	123	91	105	133	112	131	189	138	161	125	144	98	130	119	175	102	113	133	110	95	147	130	178	102	132	168	120	125	131	113	191	81	64	63	111	99	142	84	105	167	97	106	87	123	108	174	118	93	109	167	124	113	108	157	74	137	84	155	94	147	139	107	119	147	127	126	166	105	108	100	167	173	169	129	77	138	75	170	117	98	103	96	112	79	55	125	152	62	113	116	137	110	148	121	46	90	86	94	88	92	110	100	160	155	125	97	89	115	83	230	126	138	124	77	52	123	125	190	94	85	129	151	57	135	186	102	111	92	127	83	183	122	170	83	93	119	144	133	161	147	162	109	78	122	154	122	99	114	63	157	66	92	134	93	131	90	78	139	62	74	65	86	92	128	92	142	102	88	135	67	63	75	86	131	82	53	101	99	67	167	62	77	104	87	142	88	64	89	136	83	108	84	117	69	54	106	97	79	110	124	57	77	44	96	115	124	135	73	76	60	125	112	109	67	108	94	62	113	117	96	66	89	91	72	109	87	97	146	109	118	54	155	81	119	58	137	80	54	90	74	118	98	92	89	97	60	86	90	128	106	126	149	77	54	148	86	74	83	70	68	45	100	59	77	64	88	96	107	130	69	38	86	113	61	70	96	75	45	55	84	86	133	105	61	78	113	42	80	136	63	41	77	89	76	110	101	65	87	112	56	57	79	80	114	39	69	121	60	68	53	68	82	81	73	87	59	59	74	77	66	71	55	67	125	72	83	144	75	100	53	65	90	95	84	72	91	61	64	52	56	42	76	55	87	91	94	47	86	71	53	89	73	102	87	43	59	73	63	61	76	46	43	47	91	55	88	42	65	99	83	83	43	91	99	112	75	54	57	68	57	86	78	41	98	56	41	61	66	88	50	48	49	42	88	87	56	78	72	146	61	100	55	54	71	93	39	56	86	73	48	54	74	123	86	58	68	66	46	84	110	41	40	37	84	67	74	40	47	43	33	46	61	37	78	23	52	81	30	83	50	70	81	48	90	46	26	51	55	86	54	84	97	71	62	68	30	76	92	30	67	51	31	61	59	48	51	40	54	46	63	52	81	31	53	78	57	38	109	63	73	56	74	64	53	102	53	49	88	50	92	16	33	61	50	75	51	87	33	69	53	40	26	75	54	73	96	33	52	42	34	35	69	44	41	15	42	42	51	32	67	39	65	37	40	57	47	38	50	38	81	94	45	72	58	55	56	45	42	76	39	67	52	72	57	103	86	37	68	105	115	27	80	44	38	61	26	45	24	42	22	47	43	94	86	48	37	68	47	76	43	47	59	38	73	35	75	34	46	41	49	34	27	35	42	50	68	31	31	59	49	40	49	77	56	19	64	41	41	73	38	46	38	35	15	50	42	37	20	59	52	42	69	38	22	48	69	63	79	49	30	26	44	34	33	64	51	42	60	52	28	37	47	20	38	48	34	43	45	98	15	44	31	42	23	20	86	85	32	56	30	28	54	30	39	45	55	24	27	47	39	48	48	42	30	55	36	26	45	27	47	23	104	18	46	29	33	31	79	15	30	44	25	22	64	21	35	35	21	21	36	56	41	58	28	38	36	22	26	30	35	85	31	66	24	19	41	16	33	26	47	19	30	55	54	29	44	30	31	34	25	11	20	25	23	55	37	24	22	44	16	52	19	59	26	46	21	45	27	37	31	17	34	20	42	25	34	19	51	44	38	36	26	43	30	33	36	28	49	50	44	22	31	33	30	25	70	19	16	30	66	40	35	76	13	31	19	30	13	21	32	19	23	27	39	12	35	20	12	14	27	46	30	20	23	27	26	14	25	24	24	15	27	13	18	25	17	52	22	23	34	17	20	48	33	30	18	21	27	36	23	30	27	36	20	34	14	20	14	24	18	15	13	26	23	7	21	16	24	25	21	33	28	16	16	33	29	15	11	44	18	23	23	38	41	32	17	29	20	11	32	5	27	15	15	33	28	52	52	25	18	13	42	5	19	17	32	35	16	12	36	18	11	20	19	18	38	40	5	38	21	18	28	20	11	30	18	13	10	6	8	15	24	14	18	19	14	11	13	3	11	21	21	11	7	16	21	15	11	4	34	21	23	7	13	24	14	14	11	29	15	11	13	17	15	16	37	9	19	13	7	10	9	34	20	21	9	20	43	6	9	10	15	11	12	20	17	8	15	25	24	13	12	25	14	32	53	22	17	17	8	38	10	23	26	15	24	7	9	4	3	11	35	7	22	21	7	12	9	24	20	15	2	4	9	5	11	30	14	5	3	28	8	15	17	8	1	11	7	7	9	22	10	16	9	8	13	6	18	6	8	7	8	2	5	11	6	19	7	12	1	11	13	6	13	9	8	9	21	8	10	9	8	15	16	5	8	6	14	9	4	6	5	0	5	7	5	6	3	4	2	43	12	10	8	9	6	14	19	1	16	8	6	8	6	0	7	3	3	2	2	21	32	2	28	3	4	3	3	5	4	7	3	4	1	10	14	6	7	2	5	4	3	5	12	8	1	8	3	3	0	0	7	5	0	18	5	1	1	6	2	3	4	6	0	2	6	1	3	0	3	0	3	0	4	3	0	0	1	0	1	3	4	1	1	2	2	0	4	1	3	0	3	0	0	8	0	3	2	1	0	0	0	0	0	0	2	0	2	1	1	0	0	2	0	0	0
ne0307	2773	2834	1962	1600	1415	1428	1294	1058	1147	1532	1294	1160	1077	922	1025	1032	866	1155	843	951	887	823	1039	1047	910	856	1020	901	809	946	777	665	682	755	802	759	610	869	866	628	760	615	583	738	678	599	670	471	764	674	657	673	682	564	807	671	679	753	651	658	626	617	748	603	584	539	587	567	615	768	685	649	677	454	612	898	556	614	532	620	528	582	582	485	709	571	498	616	565	513	546	547	460	488	650	569	450	389	409	411	492	538	571	447	527	376	469	497	314	673	445	468	505	417	491	486	446	429	419	425	394	444	615	471	489	447	506	441	413	468	420	451	541	563	468	613	385	419	425	376	360	355	365	413	475	393	452	650	380	446	347	410	398	402	425	432	421	486	395	512	438	441	393	347	532	415	424	334	334	483	361	489	348	442	367	446	501	413	412	451	254	459	384	278	324	462	303	413	364	362	337	311	252	320	364	465	363	381	329	321	363	398	410	487	467	324	360	323	358	291	368	337	306	319	309	369	393	436	342	477	570	297	405	295	320	319	343	422	365	404	405	333	285	301	361	374	389	424	496	348	291	351	336	294	290	303	267	413	356	335	369	337	464	476	304	318	278	329	415	271	414	351	341	285	347	253	223	294	401	285	319	333	324	344	298	300	303	300	353	386	314	378	356	406	320	463	356	239	341	246	376	236	404	268	223	374	411	288	267	365	338	383	303	265	227	324	303	305	196	322	326	305	390	211	335	249	246	237	222	309	291	378	301	264	253	341	312	300	219	281	212	236	295	427	222	252	296	273	251	261	257	227	384	222	184	352	236	259	300	270	303	277	305	258	278	230	153	280	242	272	213	351	519	276	235	190	266	267	198	227	317	237	286	222	282	231	258	238	177	244	177	249	264	185	279	218	257	298	218	272	259	241	164	216	246	272	284	289	321	279	271	210	172	198	242	182	249	280	229	300	260	303	270	177	176	144	229	230	231	225	219	274	214	278	271	131	229	253	261	208	298	237	152	194	248	232	225	214	213	224	171	307	216	217	206	216	182	156	252	172	226	171	217	221	250	228	306	263	179	189	218	166	273	237	237	184	150	184	232	158	184	157	161	240	169	185	183	183	227	258	210	266	173	256	169	244	173	173	316	212	185	223	244	233	230	228	190	154	155	218	200	230	196	394	304	187	261	182	152	168	157	244	227	165	209	189	193	160	210	154	217	210	283	136	208	173	254	192	236	191	198	156	178	187	179	197	126	222	231	210	196	174	217	255	179	141	140	287	199	188	180	185	153	140	193	211	220	181	139	196	183	248	197	155	196	136	224	184	176	188	152	106	221	177	196	217	111	154	148	216	251	151	183	142	201	131	169	141	142	169	157	121	198	231	179	173	128	184	137	195	134	196	202	164	199	196	190	194	190	117	157	265	230	216	148	167	152	158	152	208	177	221	183	155	171	177	144	132	153	193	140	216	158	119	143	234	119	116	128	212	127	70	156	195	173	147	161	133	204	125	157	200	130	120	162	127	116	212	156	98	146	137	208	154	193	140	187	133	126	137	119	168	139	206	142	112	160	187	93	169	150	119	174	135	62	69	132	184	115	129	133	158	112	148	187	188	104	140	75	156	142	171	102	133	95	131	109	111	108	160	155	107	125	111	142	144	86	164	181	91	134	175	142	180	164	165	97	138	144	113	152	147	141	122	147	169	124	111	109	111	149	189	93	68	152	108	308	98	116	109	133	155	170	85	167	108	135	106	130	140	105	170	114	122	186	145	86	119	121	225	127	109	130	167	113	137	116	84	92	136	118	89	164	81	175	129	80	75	211	108	138	119	77	179	107	77	128	123	124	132	97	148	95	88	88	97	93	105	91	115	96	104	105	90	146	85	125	133	99	77	102	98	87	86	102	122	76	91	128	159	93	166	96	135	133	112	104	109	104	108	103	78	180	86	154	135	57	169	110	128	93	141	72	74	102	97	98	148	141	114	160	84	80	130	123	118	125	136	125	136	95	122	94	66	125	113	79	94	150	132	158	87	88	105	73	120	108	159	95	60	103	113	161	101	106	99	119	103	94	86	170	131	134	88	95	123	119	91	70	62	89	99	81	113	96	77	86	86	112	144	107	65	68	79	89	103	92	122	83	103	70	102	76	125	154	98	98	67	61	98	108	70	86	72	84	104	77	87	115	114	134	119	108	108	100	125	73	105	108	79	82	100	86	86	76	143	79	86	145	106	101	97	82	87	61	155	62	86	110	53	114	80	145	50	83	66	71	102	86	78	75	47	146	88	117	93	105	64	98	96	86	56	120	70	116	107	102	121	90	50	73	59	105	61	47	98	85	77	100	58	90	81	71	79	78	140	63	86	53	114	88	94	77	104	60	99	86	53	85	73	86	100	71	77	80	140	37	59	99	59	260	59	97	74	64	82	144	93	85	98	64	91	122	71	64	83	64	64	50	63	62	90	50	58	83	118	69	105	65	67	74	49	74	78	54	47	50	69	57	61	80	72	79	95	47	113	95	48	68	36	60	73	63	68	95	84	53	71	48	72	87	32	91	42	57	72	49	39	71	70	72	64	69	61	45	54	98	73	66	88	56	55	85	65	59	65	101	67	56	74	63	114	37	43	89	43	46	80	120	64	65	76	52	86	94	59	61	65	53	50	92	63	78	102	57	61	31	52	48	80	50	63	97	55	73	62	56	61	52	88	41	69	79	77	73	68	76	75	39	29	47	60	110	71	67	49	49	69	74	61	56	57	45	72	50	65	40	54	100	56	82	59	97	42	74	48	75	54	74	58	61	60	63	41	57	96	46	62	64	49	66	38	79	63	43	74	42	27	68	47	69	33	42	83	31	69	62	83	61	70	45	51	35	60	78	35	45	65	83	16	37	61	58	57	39	35	27	40	68	71	65	30	30	70	63	36	88	64	64	58	50	78	50	53	76	24	31	75	36	56	73	28	52	39	31	34	44	47	93	65	27	35	45	59	61	63	50	62	30	41	69	52	82	23	40	62	89	58	40	82	39	33	36	43	46	62	44	43	48	58	52	37	38	36	107	77	31	51	24	29	30	24	36	56	75	54	34	49	26	31	65	65	57	54	39	26	70	40	48	27	29	52	36	60	51	40	53	35	47	42	32	27	17	52	27	37	43	24	51	37	34	37	51	34	53	28	64	29	60	25	44	16	39	55	20	22	47	40	26	36	29	32	39	64	28	38	44	40	54	46	60	60	27	57	31	29	29	59	48	30	36	45	42	47	42	19	84	23	40	25	48	33	57	29	49	33	40	51	18	27	18	29	28	31	22	40	19	35	78	36	21	37	30	15	56	50	23	17	52	41	30	42	52	28	45	22	34	20	28	18	32	32	19	46	39	18	15	29	32	26	45	30	25	20	50	35	23	18	37	19	53	55	55	20	35	32	34	30	35	20	11	32	35	29	39	34	35	36	57	35	7	42	41	29	14	38	42	23	20	22	44	19	21	30	14	13	45	47	40	15	34	17	30	25	57	31	22	21	30	19	19	29	13	14	33	22	40	15	14	19	14	10	14	27	53	38	7	37	21	70	9	21	21	22	36	20	27	24	19	22	16	25	27	37	37	19	25	31	11	20	18	22	21	15	10	40	22	34	27	19	35	35	22	15	15	27	21	11	24	18	15	25	43	22	15	16	35	32	52	25	25	16	14	57	28	18	31	36	2	18	13	9	22	20	28	35	14	28	18	8	8	10	23	22	6	21	13	16	19	20	49	10	35	10	12	17	23	20	29	13	4	17	33	18	5	9	13	3	22	17	29	20	24	21	29	16	18	7	12	14	7	22	5	10	8	15	10	17	12	6	17	2	12	14	13	2	29	14	8	11	12	13	12	19	18	25	2	5	5	7	9	4	8	21	19	7	10	9	6	8	12	5	12	12	13	3	15	9	33	10	13	6	19	3	13	11	7	2	4	18	9	6	10	16	7	6	18	12	9	7	9	13	6	4	7	28	2	15	9	18	11	3	2	5	6	5	2	1	11	5	1	9	4	17	1	5	14	1	14	5	1	13	1	5	6	2	5	3	3	4	3	1	4	6	2	11	3	6	1	6	7	0	6	4	24	5	3	0	1	1	1	4	0	1	7	4	1	5	1	2	0	0	0	3	0	2	0	2	2	1	0	0	12	0	0	0	0	0
ne0308	1959	1974	1506	1464	981	1015	956	860	897	1154	966	906	825	741	685	657	632	890	606	733	731	817	723	757	712	708	710	637	637	654	588	541	584	563	731	591	493	653	602	465	546	543	502	553	477	480	511	411	448	571	474	533	423	498	430	516	572	597	490	459	466	430	734	501	489	462	441	451	476	650	482	425	479	384	465	545	475	458	445	472	437	433	380	343	640	405	413	520	368	418	319	450	334	308	510	379	343	312	411	363	375	379	396	331	394	394	474	348	275	290	401	331	348	359	376	344	314	305	355	372	299	359	471	386	355	273	350	455	302	357	395	342	365	356	388	381	341	360	333	333	269	291	288	357	310	333	321	403	316	288	358	346	317	304	317	269	318	347	321	469	360	337	390	350	381	301	341	232	251	300	287	333	287	289	280	337	403	306	340	357	351	295	308	238	268	319	252	307	345	301	203	251	206	289	301	292	256	272	239	276	275	295	343	351	377	292	304	244	220	245	288	281	294	245	221	265	357	263	223	319	373	300	250	237	261	278	284	354	271	331	215	238	217	237	285	288	227	302	297	346	221	257	258	227	210	263	239	344	318	262	252	275	318	392	212	232	209	267	283	212	241	270	288	209	264	186	165	263	339	238	287	265	326	252	235	213	183	239	286	298	226	281	247	330	270	275	211	205	174	179	254	204	267	249	177	270	214	197	211	251	197	334	173	254	199	214	214	229	120	215	219	236	244	243	211	152	191	144	234	249	278	265	221	216	184	156	224	289	169	263	223	212	236	205	204	182	240	194	210	241	244	178	287	172	187	219	175	211	230	195	204	227	200	191	222	188	219	194	162	271	183	185	178	178	161	166	225	181	143	170	211	193	200	258	232	153	161	153	185	174	162	166	195	164	165	121	249	228	150	235	199	238	180	156	206	194	190	224	228	198	251	124	181	163	175	175	203	194	193	219	237	225	204	164	146	129	149	185	220	159	150	152	152	212	143	114	200	186	198	178	154	133	109	160	222	190	164	161	118	168	142	175	136	154	154	151	160	104	199	129	224	156	153	139	213	182	211	195	110	105	190	146	182	162	187	146	114	191	142	142	276	143	140	165	135	136	123	139	105	170	123	249	133	216	127	130	144	137	175	123	131	189	156	125	192	146	189	165	180	132	155	170	158	102	143	175	245	175	95	151	159	169	161	126	132	137	123	91	165	136	148	145	218	92	156	116	189	156	137	138	152	113	152	167	133	166	103	154	171	206	124	120	135	180	83	141	99	273	139	150	135	160	132	131	146	164	162	140	75	123	133	177	174	194	113	152	111	168	171	137	143	58	154	159	137	98	120	141	108	163	172	124	124	126	148	97	113	108	98	139	130	92	153	122	122	147	97	116	79	152	88	163	135	93	112	114	124	103	173	135	122	200	134	141	110	123	121	111	139	146	89	126	116	98	122	134	113	113	102	159	171	141	144	114	127	151	84	109	109	163	104	64	110	156	118	186	166	64	149	140	126	117	123	94	117	108	110	88	126	75	131	144	165	161	140	98	150	68	86	133	109	71	83	98	105	68	145	167	115	87	94	117	143	111	53	76	111	123	66	106	118	128	104	108	110	119	108	97	82	289	121	96	92	107	134	124	145	73	70	133	104	95	97	74	93	156	75	116	112	70	116	114	118	105	143	126	127	111	91	146	79	100	74	110	123	86	84	98	98	70	105	101	75	67	119	119	89	89	70	112	73	89	126	71	127	143	99	94	87	118	63	138	126	91	130	292	101	89	116	168	99	80	80	102	84	118	82	98	92	87	96	71	148	87	113	106	67	66	130	82	95	90	71	98	74	73	76	109	99	68	92	100	93	61	68	102	100	82	56	74	83	46	50	41	45	88	95	106	74	73	72	55	52	116	72	121	75	31	79	92	83	98	58	67	85	71	99	97	83	84	84	84	77	98	112	89	142	106	74	61	81	104	70	104	100	89	55	121	92	91	71	64	69	104	89	61	93	99	68	64	90	105	66	67	89	42	66	80	102	116	93	75	73	83	93	85	119	92	86	67	63	51	308	68	74	76	87	39	71	71	130	71	77	90	79	94	69	54	57	74	49	112	61	76	43	69	70	60	65	82	89	59	57	63	52	70	59	61	110	46	45	81	76	93	66	78	61	63	67	83	77	59	85	71	77	68	66	81	53	99	99	86	66	74	77	76	78	50	86	66	79	49	65	68	51	84	71	53	92	70	68	64	61	61	60	91	60	69	60	48	84	64	207	43	74	60	57	56	54	55	61	40	113	45	68	50	63	72	80	83	49	59	75	79	101	66	82	83	53	49	81	93	92	46	75	83	58	99	64	46	53	82	49	89	73	101	44	61	54	71	52	70	48	103	31	60	49	39	69	61	64	67	52	64	43	93	46	71	64	69	60	32	65	51	58	70	101	86	56	61	39	59	103	60	67	47	34	68	72	61	44	78	32	78	43	57	56	275	39	50	55	33	62	58	61	38	34	56	36	38	50	56	77	73	45	69	36	50	59	39	48	48	45	87	61	59	21	52	54	36	52	43	91	45	44	33	51	55	50	53	29	50	67	35	28	52	66	43	73	70	60	80	81	51	79	31	76	52	38	73	30	23	28	47	79	22	32	95	61	26	51	55	55	63	55	42	50	58	37	45	69	40	48	67	50	62	16	27	49	47	44	55	69	53	52	46	60	45	77	70	41	56	66	41	62	34	76	47	37	51	44	61	68	22	45	37	55	48	38	42	38	63	41	57	40	49	44	33	80	39	54	58	259	54	63	45	26	44	38	47	44	48	43	56	18	60	36	48	50	48	51	23	43	57	60	33	32	31	27	33	57	38	30	55	39	68	19	49	32	46	50	42	40	29	38	27	60	59	44	19	61	54	36	43	35	25	31	39	56	43	58	31	30	45	31	29	48	54	50	50	42	45	36	31	48	27	33	33	24	40	57	16	35	70	33	17	23	58	72	54	40	24	53	40	32	29	35	56	20	34	28	32	39	33	43	31	68	45	18	36	33	33	12	27	22	56	29	23	27	50	29	28	23	33	48	52	43	31	24	237	51	24	33	27	42	34	29	34	11	34	32	29	61	32	35	29	52	33	24	39	21	41	24	45	32	29	41	32	25	34	26	29	27	33	22	55	46	28	37	26	18	31	35	36	37	18	24	14	30	17	18	21	30	44	12	21	24	24	20	25	20	33	44	36	22	21	17	21	43	21	54	35	19	31	27	18	21	37	27	14	15	42	22	25	27	23	15	20	38	15	30	22	40	39	17	26	25	44	16	18	31	12	32	43	14	16	22	29	157	32	104	23	32	23	23	56	22	20	24	26	21	21	10	13	39	26	26	7	23	18	24	11	13	29	25	17	18	24	37	32	29	23	16	20	18	30	12	12	22	9	16	42	25	9	23	19	33	30	15	17	20	15	19	13	11	20	15	24	30	21	13	20	23	15	22	20	33	23	29	31	24	11	14	23	11	11	16	38	28	18	17	12	36	26	92	12	15	10	33	19	19	18	18	16	33	10	23	15	4	12	12	18	20	18	29	12	17	12	10	26	8	24	22	14	20	14	16	17	17	14	10	12	13	19	18	6	25	12	8	22	20	18	15	4	14	17	18	24	25	16	18	23	15	6	12	19	19	5	18	23	14	22	24	28	13	12	11	21	37	10	22	11	11	15	25	16	13	35	2	17	19	5	19	19	31	24	8	11	10	13	10	11	20	21	4	12	9	10	11	13	32	18	7	7	9	9	14	15	21	6	7	8	11	12	7	12	17	3	11	14	4	1	9	12	8	19	9	3	6	10	12	10	3	15	7	6	4	9	6	3	15	1	12	11	9	7	27	11	2	14	7	11	15	12	5	17	11	4	3	3	9	1	7	9	12	3	6	4	2	12	3	9	1	8	4	13	33	2	16	10	11	12	9	2	9	10	5	11	6	10	3	5	4	18	2	10	21	10	0	7	7	11	5	10	5	3	5	6	14	12	2	5	3	3	2	6	5	1	5	5	3	3	1	6	1	11	4	3	1	1	7	9	5	3	2	4	2	2	3	0	0	6	3	5	1	6	4	5	1	3	0	0	1	3	2	1	1	3	0	2	0	1	0	3	0	2	0	1	1	0	1	0	0	1	0	3	0	1	0	1	1	0	1	0	0	0	0	0
ne0309	3263	3329	2154	2081	1295	1981	1556	1498	1213	1477	1184	1400	1190	1232	1149	1072	1189	1080	1306	1336	1250	1090	1140	1049	964	788	1142	1176	999	1185	744	980	881	946	983	1059	826	738	933	761	890	806	660	950	822	809	756	735	1033	877	778	830	642	653	800	937	576	836	797	670	856	634	645	766	639	781	738	652	726	677	854	624	798	647	532	867	761	609	694	569	679	642	574	707	610	593	551	707	660	668	680	736	574	647	576	585	515	562	607	712	625	607	625	538	608	517	564	546	543	611	622	571	540	541	509	597	490	606	477	533	618	528	569	643	659	616	498	466	487	512	507	526	411	570	572	373	358	458	481	465	515	558	436	484	398	460	457	428	472	577	465	397	480	506	516	348	558	474	444	658	426	487	473	524	760	398	462	518	332	502	540	409	491	581	428	493	520	440	387	403	524	499	419	473	354	507	395	492	464	396	470	353	327	375	374	519	390	424	492	389	471	339	287	510	298	430	444	385	439	401	380	390	343	415	459	441	382	330	290	464	636	339	354	418	486	376	447	502	399	402	449	425	321	334	516	397	353	418	488	379	419	359	380	394	296	359	324	324	362	421	323	378	485	502	364	345	372	355	376	306	378	385	411	301	356	375	273	276	417	307	343	330	418	315	369	276	371	370	485	367	329	361	317	224	300	275	338	365	304	361	406	433	339	435	335	333	373	388	368	376	317	497	274	377	379	261	240	395	278	290	301	376	342	228	272	232	363	222	348	424	321	442	309	222	300	340	334	299	317	292	305	308	308	303	337	326	346	293	346	307	341	325	420	443	326	346	314	230	257	265	336	309	374	315	325	302	270	249	255	266	253	337	298	207	235	302	322	374	269	342	284	215	304	296	252	187	398	246	308	286	244	241	293	290	301	375	274	320	280	240	273	258	289	246	311	238	262	293	207	292	383	254	260	237	295	182	200	263	287	340	246	302	292	281	318	256	247	218	288	283	302	177	257	344	324	269	306	357	284	279	263	239	181	257	218	338	190	191	276	211	218	233	195	253	285	238	219	256	245	216	208	216	235	229	298	207	365	236	203	172	239	269	215	219	214	226	202	249	196	214	239	202	202	326	352	243	213	189	157	182	252	217	228	212	235	185	227	252	272	252	158	252	194	135	233	180	229	203	219	204	182	257	274	219	276	207	151	242	217	272	184	326	257	186	224	230	197	158	220	185	175	133	310	290	184	203	239	300	281	246	269	220	220	212	218	255	204	285	238	247	226	153	229	238	142	103	264	387	282	238	191	212	223	150	260	307	234	175	168	193	197	233	211	152	208	193	176	195	123	204	181	182	128	204	181	233	172	207	193	167	250	145	159	179	296	195	189	147	167	183	132	181	206	189	234	164	182	216	173	169	203	188	150	243	175	168	134	183	188	168	153	313	201	141	189	127	131	183	187	231	122	186	168	172	267	150	152	214	147	170	154	167	123	130	134	231	137	200	109	188	168	149	165	147	155	154	177	187	207	165	152	110	172	114	166	141	154	164	236	125	184	172	134	117	163	188	211	166	143	156	175	223	163	194	184	175	164	209	156	138	166	133	279	119	180	161	174	93	118	117	143	232	128	136	86	158	157	201	117	109	133	220	156	197	172	191	108	146	150	162	146	180	159	128	125	184	142	122	174	103	191	131	181	153	228	117	115	181	126	171	150	101	149	149	131	92	85	161	165	88	162	127	199	134	181	143	79	131	128	123	200	137	122	132	140	198	175	111	101	139	148	247	155	166	144	78	112	151	95	232	92	159	150	136	126	143	183	122	150	117	159	109	214	136	206	156	140	128	143	148	180	153	158	105	109	131	149	192	133	98	91	171	71	138	123	102	168	136	124	172	109	182	134	153	110	222	110	117	146	126	221	100	172	105	127	147	115	76	148	165	89	176	101	120	125	113	132	110	86	131	127	116	141	96	189	162	77	170	141	119	105	154	87	113	95	112	121	122	131	86	70	88	131	151	132	63	117	112	60	89	136	112	112	129	138	110	140	84	104	174	176	103	103	167	131	125	112	142	88	95	100	105	135	91	106	109	100	70	80	106	225	171	155	114	122	101	149	93	68	104	220	122	87	113	68	107	62	106	143	120	142	88	73	123	153	76	94	151	93	64	78	129	107	138	153	82	66	114	57	111	133	66	56	88	87	104	119	124	112	115	141	100	153	121	80	146	66	117	171	64	83	98	93	105	50	114	92	77	83	90	84	93	107	82	108	112	72	85	140	108	150	82	209	69	102	76	81	93	63	77	112	67	67	125	68	107	95	119	98	96	63	90	74	104	96	107	68	56	56	108	89	108	72	52	82	116	70	73	75	80	135	109	95	85	117	143	94	103	85	84	61	73	106	104	95	100	64	99	88	82	115	67	90	61	53	65	112	60	116	91	131	68	108	90	52	94	101	48	74	70	89	55	74	83	97	101	66	60	79	60	87	121	77	66	51	115	83	80	44	74	91	61	42	73	44	56	55	68	93	52	78	69	87	120	80	100	39	41	44	60	68	75	94	100	93	74	75	57	77	89	27	71	45	57	75	71	62	72	53	90	50	87	65	90	77	82	85	98	57	131	65	95	100	104	82	81	142	32	62	89	62	51	40	59	92	62	105	72	97	63	66	51	37	43	82	84	87	106	70	66	58	58	33	77	62	54	60	104	68	59	31	92	65	78	55	40	64	47	44	77	56	94	138	76	68	41	52	78	65	55	87	76	89	89	78	91	108	87	114	99	90	105	51	79	44	35	76	53	33	64	53	57	67	58	83	79	29	37	77	48	76	69	40	98	54	88	44	63	42	42	53	48	59	67	43	40	45	49	46	28	56	58	71	53	59	62	35	74	37	33	53	41	65	68	40	25	73	44	47	38	79	58	61	75	47	49	57	77	71	75	48	40	52	53	81	39	76	51	39	44	73	30	47	103	50	24	60	39	67	49	123	41	54	52	48	63	46	78	73	70	57	40	38	64	40	29	48	73	41	73	26	55	40	25	68	41	95	34	40	88	31	44	39	59	20	53	38	19	51	59	31	47	51	42	57	80	34	44	34	54	67	78	43	63	52	37	48	36	22	37	41	50	80	76	69	80	26	37	38	45	56	59	25	38	91	41	45	72	37	45	71	38	50	40	43	44	56	47	41	42	44	35	42	27	74	46	46	22	64	43	56	44	29	46	32	40	15	52	15	61	43	27	49	31	50	48	43	60	41	63	44	94	59	51	51	26	38	57	47	43	45	73	40	53	73	35	17	45	36	29	26	44	17	26	27	53	98	51	49	12	34	39	37	27	40	21	20	32	44	23	116	43	23	44	17	33	33	25	37	25	31	30	16	37	46	46	58	49	18	23	56	37	44	33	38	40	29	30	31	11	49	35	14	23	22	18	10	11	40	13	56	36	42	20	39	51	33	39	19	11	36	32	38	27	26	49	34	32	48	14	23	37	27	22	21	18	38	24	41	40	33	32	33	32	25	29	13	35	36	19	23	37	28	42	7	40	15	31	32	14	47	19	21	13	26	26	27	24	27	11	20	16	31	19	30	36	21	19	21	13	19	16	30	30	19	15	25	40	18	19	6	42	18	17	99	18	28	12	16	27	27	27	9	7	32	26	13	17	21	10	18	17	9	18	24	36	25	3	24	50	13	28	35	6	20	14	22	17	22	21	32	21	19	8	27	7	6	47	11	22	24	4	23	18	26	35	16	27	11	4	7	8	8	17	15	17	25	14	19	7	20	18	12	4	16	14	8	9	23	26	38	10	7	10	21	19	8	8	40	5	18	21	19	6	28	14	15	11	8	16	5	9	14	15	10	29	10	8	3	12	10	9	14	8	6	12	9	16	11	23	12	12	12	5	7	13	8	20	1	11	8	12	32	9	8	14	13	17	16	6	9	11	10	9	4	53	5	8	26	8	6	15	11	2	8	10	4	3	9	3	6	12	25	36	5	22	12	11	8	8	11	7	9	5	7	2	31	5	16	5	15	2	4	4	6	4	3	2	9	5	9	3	4	4	6	2	24	1	4	16	3	6	0	3	4	0	2	7	29	5	4	5	4	3	1	6	4	2	0	3	2	2	4	3	0	6	7	0	0	3	0	2	20	2	1	3	1	1	1	1	0	1	9	0	3	4	0	141	2	3	1	0	0	1	0	0	0	0
ne0310	5322	4511	3183	2566	2385	3290	2844	2645	1935	2567	1828	2453	2092	2196	1820	1889	1785	1729	1879	2186	1892	1753	1504	1682	1557	1384	1547	1683	1394	1601	1263	1256	1508	1695	1196	1568	1342	1219	1332	1105	1341	1404	990	1346	1109	1367	1437	1245	1219	1355	1719	1469	936	1444	1281	1165	910	1305	1132	1087	1496	1002	944	850	1158	1084	1359	985	1158	1039	1173	972	1081	770	1027	1216	1064	1092	1096	1004	1138	930	1238	943	924	1137	830	1226	1158	1055	871	1048	1253	775	920	764	1017	669	886	910	949	885	819	1056	1087	967	843	1044	921	999	841	863	1146	1108	1128	929	1080	854	763	1107	827	1094	864	821	879	811	827	909	1038	1045	854	723	733	677	898	610	585	687	998	711	763	821	551	760	836	888	710	708	710	761	863	744	784	660	898	558	696	719	987	786	732	697	833	834	860	738	749	666	651	1003	825	699	745	766	904	602	810	939	719	631	764	704	738	782	725	620	648	713	620	568	786	640	407	726	636	812	575	879	681	641	721	617	689	731	541	783	665	665	488	571	892	557	543	708	574	575	619	525	488	780	772	589	626	632	754	541	642	854	577	653	657	692	454	431	735	797	528	697	758	603	537	718	670	618	353	518	597	714	661	546	669	454	667	615	613	780	499	548	590	442	533	623	567	511	549	455	553	453	504	440	514	482	687	543	631	422	557	533	678	507	413	601	575	448	566	359	536	428	368	508	638	564	626	612	533	580	551	490	478	544	397	496	441	668	521	467	348	538	438	492	558	528	575	470	448	372	565	269	543	663	587	683	481	372	422	513	584	495	392	454	509	546	550	570	563	493	509	433	631	585	429	504	705	446	490	382	467	449	444	466	513	448	577	494	435	625	424	394	295	476	434	442	566	310	543	397	550	496	429	464	396	358	495	488	381	267	534	496	421	437	638	451	474	434	383	374	446	498	435	352	415	376	366	302	477	426	452	465	336	511	405	387	441	484	399	263	378	447	530	478	426	459	389	430	344	412	405	376	523	415	400	290	465	541	323	323	434	423	298	331	419	299	271	424	343	494	517	245	315	335	375	346	308	383	496	366	254	313	267	319	333	373	342	372	416	373	433	413	374	244	457	277	398	299	333	416	246	319	323	216	372	388	298	377	350	361	297	262	249	272	272	313	405	335	358	253	389	354	406	287	326	385	326	239	375	328	307	290	405	373	338	399	428	389	457	344	280	293	332	374	223	340	290	340	351	317	291	177	352	306	296	204	452	304	331	301	312	359	336	483	374	268	289	261	270	332	322	367	290	339	325	307	355	438	205	213	250	402	363	383	274	260	287	277	359	373	350	313	198	277	309	332	275	281	276	334	290	348	281	277	344	207	256	318	316	330	211	391	358	278	404	285	295	248	386	203	292	205	320	444	248	294	302	344	330	440	323	379	289	319	297	325	260	241	291	215	226	290	278	305	307	630	334	249	223	242	202	298	256	357	159	283	263	233	295	257	346	328	209	245	279	323	256	198	227	365	186	239	240	272	251	134	227	258	254	226	361	220	357	279	250	200	272	196	312	209	192	288	304	189	299	234	268	245	248	260	268	222	200	222	153	203	253	358	297	183	233	287	193	231	248	208	346	177	249	160	218	277	174	243	210	323	156	203	164	227	227	303	193	214	214	273	223	499	218	300	178	230	249	268	234	209	260	265	192	295	263	180	330	127	266	175	213	273	283	187	190	218	243	217	186	212	199	221	184	149	159	211	225	135	233	264	303	197	252	230	174	172	164	179	189	244	206	145	205	275	188	160	151	214	181	400	229	271	213	146	171	150	234	344	157	159	237	254	178	208	274	224	165	169	266	235	298	198	297	222	151	241	249	152	199	219	272	170	177	182	206	282	165	137	138	294	126	160	315	207	237	152	228	199	154	157	225	191	178	243	182	192	193	154	254	113	169	193	166	163	222	126	200	186	126	204	148	109	199	164	186	182	123	194	183	160	281	168	180	161	176	186	174	123	180	215	130	195	114	165	180	220	228	220	133	121	241	155	135	122	199	163	124	109	115	154	146	174	158	139	224	154	125	186	209	154	131	259	196	170	210	234	165	156	137	82	186	185	141	155	210	121	142	230	236	145	175	311	133	147	161	157	125	124	118	213	147	141	143	144	145	147	186	172	252	106	106	210	159	109	144	152	164	92	100	151	130	179	409	106	122	154	153	161	144	108	123	158	165	168	215	156	131	233	179	173	131	196	144	190	117	302	161	119	126	129	124	213	146	189	137	100	144	186	90	135	138	154	132	187	170	139	190	147	150	147	210	95	102	185	118	129	105	144	118	90	96	120	121	157	159	168	127	214	122	129	144	141	210	122	155	112	103	114	159	206	122	90	143	160	119	119	124	91	174	134	151	88	105	208	101	129	134	146	119	143	134	229	87	113	111	116	176	119	149	98	99	106	98	171	87	129	214	167	288	64	156	115	150	101	181	99	126	158	138	110	141	136	218	173	120	93	105	123	143	184	70	98	71	115	106	127	64	115	166	99	72	175	72	102	121	123	129	87	137	109	115	196	106	148	66	97	127	84	153	155	102	180	130	99	77	84	110	189	72	147	72	69	117	113	77	117	99	89	82	111	108	142	88	163	160	127	57	238	139	118	150	125	114	77	156	77	75	136	68	110	77	90	142	102	134	69	136	80	117	102	105	52	150	122	101	159	71	118	136	112	75	137	70	88	52	122	76	103	69	89	79	120	92	76	122	69	72	129	87	111	222	50	131	86	115	134	96	96	153	114	100	91	108	97	156	133	82	93	194	147	96	153	89	65	89	63	67	84	52	79	72	86	159	157	100	49	101	116	114	124	98	84	58	127	78	110	83	58	84	54	72	82	111	71	81	103	60	228	103	47	105	116	117	115	40	159	40	64	105	70	93	87	101	35	86	96	71	49	88	83	70	144	124	55	102	113	110	115	75	77	85	80	112	51	107	111	96	111	84	75	59	83	92	158	85	55	80	73	115	63	104	81	92	54	56	171	115	86	100	46	67	101	69	84	74	157	60	67	83	120	49	60	69	119	118	62	94	95	44	114	85	123	64	94	56	69	76	148	48	79	72	66	73	106	79	62	39	55	35	42	77	78	69	80	56	98	54	58	80	87	111	73	96	82	146	51	52	96	39	104	45	44	87	119	67	61	50	60	53	45	109	58	44	66	78	72	50	84	79	66	60	46	118	55	61	30	95	54	77	66	59	58	74	54	27	59	51	78	66	75	120	55	68	79	49	76	78	53	71	94	70	79	83	53	47	115	58	59	36	57	69	58	78	28	61	46	57	68	49	80	28	54	29	47	33	75	42	29	48	62	39	56	44	31	50	56	54	62	89	31	35	55	34	50	47	26	60	60	32	63	53	259	95	78	87	46	28	38	67	48	68	61	43	41	40	43	67	48	48	27	68	39	100	34	68	40	55	61	267	79	64	41	272	52	52	67	17	19	73	39	45	53	20	77	34	49	68	63	31	49	32	36	33	23	65	33	55	86	61	42	26	54	77	41	35	38	54	36	62	50	67	38	33	35	30	43	82	17	57	48	38	46	81	62	47	50	24	16	60	48	31	41	42	45	18	39	62	25	22	56	43	48	37	32	41	42	50	27	46	39	38	42	16	24	37	20	26	33	51	40	18	27	31	57	32	47	39	28	26	24	11	22	52	29	45	13	32	67	15	25	35	28	46	24	40	27	18	21	56	39	41	28	44	20	90	60	40	28	30	27	27	36	50	46	34	20	17	12	8	10	18	29	27	34	21	20	15	9	42	32	23	13	40	34	20	19	39	22	14	9	17	28	32	54	21	14	22	12	24	16	25	32	18	29	27	48	28	23	14	16	16	47	6	230	16	26	43	8	10	7	12	19	19	22	12	9	13	21	23	20	30	19	17	19	21	5	25	6	26	11	16	6	10	7	16	12	18	6	12	5	9	35	13	45	31	20	27	14	8	8	19	7	16	16	3	16	2	11	13	10	34	15	13	25	15	7	10	2	24	19	16	6	4	2	68	17	25	12	8	1	3	23	17	6	19	6	15	14	10	4	2	5	17	29	26	14	1	6	4	19	1	5	12	7	0	4	11	6	0	11	8	6	17	12	4	12	7	9	4	2	3	11	14	2	2	8	2	3	1	5	85	18	19	3	40	3	0	1	2	0	2	1	0	12	2	14	4	8	2	0	4	1	0	0	0	0
ne0311	2659	2237	1777	1381	1169	1568	1174	1353	1121	1279	1043	1280	1059	994	1064	794	797	963	787	1092	1136	759	1190	796	893	795	934	774	796	1054	625	599	624	786	995	722	659	726	862	774	673	571	512	716	512	737	646	538	492	554	706	640	467	453	458	605	636	731	584	558	677	563	528	575	479	584	611	580	608	718	569	453	557	549	457	700	645	559	568	409	500	474	485	468	461	505	409	527	378	518	384	521	520	531	442	386	475	363	391	507	583	366	371	417	516	395	371	465	437	342	414	370	471	489	522	364	486	455	568	498	459	433	521	415	419	441	358	434	442	470	409	335	378	426	579	277	348	388	422	376	352	378	235	424	291	483	475	352	353	392	321	345	416	305	484	357	332	391	411	409	383	402	351	533	493	343	412	369	444	334	332	403	299	501	449	381	469	395	377	366	409	511	329	441	261	481	266	305	415	378	300	321	146	294	379	324	267	361	403	411	295	348	305	380	258	401	321	300	232	308	398	356	282	291	159	382	395	294	225	466	480	259	277	288	470	322	444	553	350	387	332	314	298	213	364	335	294	396	359	313	305	726	254	237	223	310	395	272	362	264	300	293	324	273	329	327	186	307	272	283	231	296	328	218	364	269	200	265	368	219	293	290	324	330	381	228	312	284	357	292	216	323	319	175	337	241	277	255	142	223	379	367	320	292	175	286	250	319	238	327	295	341	179	310	236	599	261	329	214	330	324	255	308	226	171	256	276	176	257	426	344	342	285	221	242	215	251	249	204	207	159	240	230	219	297	229	329	257	352	372	214	231	361	252	241	239	202	285	237	229	278	219	267	155	243	326	226	216	148	238	237	229	193	200	156	232	326	168	243	203	192	204	250	231	271	157	278	299	275	249	169	190	264	242	336	282	266	228	232	258	209	173	170	166	223	209	166	239	217	296	314	249	200	265	222	191	203	188	325	307	255	280	211	231	228	206	163	174	296	181	210	163	194	285	162	274	243	257	109	197	172	172	121	213	205	219	194	115	163	209	232	187	174	203	185	190	142	183	163	158	177	176	126	180	238	206	238	214	180	102	191	195	184	122	182	201	167	157	191	129	90	183	205	198	256	228	207	191	158	125	214	171	196	210	161	115	134	169	166	163	210	244	198	138	196	181	217	161	194	183	173	203	239	106	197	172	152	148	130	174	158	240	228	143	209	187	164	114	186	168	182	132	243	108	167	134	196	172	238	197	157	150	215	214	114	212	169	221	242	235	156	119	203	193	97	97	84	315	236	180	95	191	143	161	181	216	194	199	67	153	195	249	154	141	141	124	138	166	175	205	167	143	193	218	177	109	109	168	185	220	234	137	112	160	228	152	112	155	174	204	143	122	130	168	182	167	131	195	131	146	88	236	154	127	147	171	102	136	143	42	193	367	175	118	164	113	99	146	148	167	108	148	148	161	136	122	126	101	167	186	145	131	145	116	129	196	125	97	130	216	116	38	136	151	126	145	276	113	179	165	140	120	145	124	156	128	98	95	182	137	166	138	160	113	153	97	188	83	124	124	96	100	154	120	145	155	133	203	103	135	126	117	183	97	129	87	174	134	168	140	153	138	133	128	85	149	91	146	57	79	137	141	159	110	109	110	105	103	93	140	91	126	140	84	149	191	103	120	120	69	136	112	142	141	230	122	98	145	126	190	77	103	88	111	169	62	88	94	205	76	140	101	131	111	120	141	113	135	102	79	171	126	120	79	177	219	125	69	87	167	84	212	136	112	129	114	76	74	105	207	87	67	129	162	103	126	141	289	93	110	175	104	139	86	175	99	33	97	137	127	159	168	161	131	93	102	108	140	115	79	141	112	45	92	128	72	180	81	78	85	106	141	103	133	139	186	99	130	90	128	219	67	143	86	72	119	94	29	88	88	60	134	111	102	117	112	134	85	54	79	109	83	81	89	135	125	86	96	164	79	140	109	76	126	60	119	107	136	123	103	76	58	113	156	65	64	126	108	71	79	125	103	49	89	232	50	89	129	98	104	105	91	60	150	107	82	109	118	58	70	63	68	113	81	107	116	87	70	77	85	120	60	160	109	102	87	139	72	59	90	56	170	81	98	54	110	77	356	109	99	104	65	47	67	104	75	105	83	73	56	60	85	86	109	111	83	93	59	53	112	162	51	64	78	68	99	92	78	93	121	152	78	85	59	95	146	60	52	150	49	83	88	122	66	53	136	77	60	66	87	67	63	148	68	58	106	56	69	110	62	87	84	160	60	101	86	101	75	66	83	45	74	45	76	104	113	89	70	70	103	62	60	81	69	124	97	149	43	103	57	66	67	100	61	55	97	51	60	103	67	75	84	76	88	119	114	57	60	42	81	46	69	51	101	39	91	95	71	73	66	63	65	54	34	45	39	28	37	58	77	129	59	107	63	52	103	98	46	60	85	56	32	111	102	130	75	25	58	71	59	100	145	22	69	42	84	95	71	35	53	64	59	30	52	57	50	48	48	73	35	80	53	82	88	77	96	91	59	57	51	74	66	67	73	64	67	47	53	89	58	42	52	26	40	58	53	52	85	70	37	31	72	26	81	70	44	95	56	46	106	50	83	92	96	60	53	149	35	43	89	33	31	57	47	88	28	83	37	92	64	45	66	37	27	68	64	69	55	39	61	54	67	24	69	42	41	43	106	38	39	32	60	37	55	56	55	115	37	48	58	55	86	94	31	54	48	43	68	30	45	48	47	62	63	77	63	64	65	28	43	116	78	31	96	49	43	48	56	29	22	28	66	50	21	82	43	20	30	63	37	58	65	46	42	90	59	30	60	32	51	68	39	41	71	36	53	47	21	38	24	70	37	47	52	38	55	41	70	47	25	64	55	68	45	51	28	74	42	49	39	56	50	42	72	57	31	41	53	119	75	49	54	59	50	49	48	59	63	38	49	61	39	22	50	83	35	35	41	30	43	102	11	68	9	64	18	47	135	106	53	62	29	34	65	23	38	32	132	32	49	51	57	26	29	55	47	100	18	30	58	26	47	30	20	21	67	35	28	44	127	27	38	45	36	47	56	32	27	53	46	9	26	39	64	51	44	24	32	20	22	54	55	96	35	49	61	16	22	31	21	16	69	17	32	59	52	44	34	34	32	42	41	14	36	37	35	77	32	39	57	44	16	32	24	52	29	28	16	62	39	30	28	20	22	27	34	19	33	16	35	31	52	88	34	25	42	33	51	48	30	62	56	196	36	41	31	30	63	47	27	24	81	30	50	79	17	16	7	40	33	26	27	20	33	13	38	28	32	13	11	29	28	30	17	18	22	48	26	18	36	52	26	32	21	13	15	43	8	11	22	28	13	4	23	55	21	26	164	19	19	33	16	20	59	27	7	39	21	67	25	22	13	53	13	35	29	19	33	41	24	35	44	34	12	13	24	32	23	8	10	47	27	23	19	32	32	21	22	36	27	3	31	27	18	16	31	40	31	26	21	38	32	15	51	22	9	26	25	25	11	36	24	46	21	14	34	18	14	48	11	18	22	23	9	21	23	41	12	5	9	44	12	22	20	15	23	18	23	19	29	19	15	22	25	25	12	13	18	34	10	12	21	23	8	38	7	18	8	18	16	31	28	8	10	12	14	9	21	9	11	17	13	7	23	21	12	10	4	11	34	5	10	16	7	9	6	28	17	3	8	25	17	16	8	21	3	24	33	41	23	22	9	35	13	36	21	10	14	16	4	5	10	6	26	2	20	11	16	16	3	14	15	24	4	9	19	5	4	19	7	5	5	8	16	18	49	14	14	16	8	14	1	10	7	8	16	4	7	15	9	5	7	9	32	6	7	9	1	10	16	10	5	14	8	20	21	2	6	4	24	8	22	13	7	11	6	16	3	39	14	7	282	5	5	16	6	4	4	10	16	7	2	0	14	10	38	14	1	15	37	6	4	9	7	5	13	4	5	7	2	13	6	31	11	11	15	1	4	18	7	14	1	8	11	5	2	10	1	11	2	2	2	12	5	8	11	12	7	9	1	1	3	22	2	2	5	27	1	0	0	3	7	0	4	7	0	2	3	0	5	0	1	2	6	6	0	0	1	1	1	1	0	3	10	3	1	0	1	0	0	1	0	0	1	4	0	7	1	3	0	1	0	0	0	1	2	2	1	1	0	1	0	0	1	0	0	0	0
ne0312	5310	5252	3250	3694	2594	3188	2781	2570	2027	2661	2008	2443	2113	2002	2166	1948	1835	1784	2003	2335	1937	1815	1875	1985	1649	1596	1772	1816	1803	1908	1189	1647	1339	1610	1488	1592	1270	1301	1448	1380	1353	1156	1044	1565	1229	1529	1445	1151	1436	1277	1620	1365	1153	1226	1482	1248	978	1423	1133	1104	1525	1105	1029	1099	1020	1186	1389	1300	1313	1164	1165	1019	1259	937	946	1353	1290	1068	1162	924	1029	1130	1194	1078	953	1070	927	1177	1152	1145	1054	1174	1111	983	892	857	957	751	1241	1105	1043	1097	1054	1039	1087	860	825	1043	919	1218	1015	937	1123	1063	1074	982	1067	1001	642	1093	828	1039	915	987	940	834	708	672	1030	998	820	862	729	794	1018	554	755	709	969	748	752	801	774	771	656	896	818	655	781	850	745	821	775	785	961	584	714	718	963	1076	765	791	747	899	1105	635	775	714	641	894	805	700	716	938	889	713	976	944	589	654	753	948	698	712	647	728	629	708	583	623	663	576	602	661	627	960	619	886	692	709	656	873	483	740	497	753	785	679	617	658	857	658	627	696	706	616	761	593	454	835	980	591	644	643	918	586	694	841	603	644	743	659	607	564	750	530	537	742	855	711	621	679	980	429	490	567	595	729	631	676	655	668	780	702	597	752	561	520	612	598	652	579	592	514	435	481	462	474	541	530	559	500	636	605	625	453	663	522	726	482	435	595	457	409	502	270	634	596	423	548	778	616	559	666	395	610	647	637	471	586	512	708	378	722	561	647	407	518	434	483	580	428	547	505	383	509	597	290	679	638	512	644	503	388	418	528	577	562	443	468	510	582	533	1040	649	505	541	483	564	591	481	501	711	536	452	462	487	521	372	427	534	531	581	651	497	511	542	458	380	328	423	410	743	378	435	665	513	570	482	511	440	310	541	470	461	291	464	525	468	457	494	441	469	427	525	520	495	496	405	450	453	319	369	329	423	398	406	419	327	472	463	651	466	469	447	356	403	385	446	541	478	473	478	488	474	373	360	388	539	514	388	198	456	635	418	487	536	417	271	376	603	451	359	386	361	536	371	328	360	360	433	325	339	454	433	371	278	356	366	430	406	327	379	372	468	334	591	402	300	325	510	347	427	327	237	324	330	387	308	253	256	354	314	393	416	340	363	306	316	316	347	341	374	399	449	265	527	422	508	362	302	379	321	238	371	303	412	313	435	343	241	438	426	400	547	381	391	311	304	391	312	483	459	282	382	268	330	233	312	354	293	252	520	309	302	292	387	453	487	456	399	330	381	289	281	431	275	536	318	419	330	304	362	389	193	426	251	613	335	417	352	335	338	334	391	460	402	288	266	290	395	371	366	340	328	376	283	398	245	279	323	259	224	341	335	329	401	467	364	338	503	296	290	261	473	223	327	251	333	380	258	316	363	328	282	251	360	361	288	304	290	295	271	362	289	239	262	363	319	181	262	584	371	187	241	200	444	269	321	355	168	303	288	339	414	252	215	335	299	297	296	428	266	227	223	415	291	319	184	290	287	193	237	308	193	267	372	332	364	283	210	253	313	146	252	296	263	315	281	232	346	312	234	274	334	318	299	268	234	238	456	194	273	346	264	317	259	330	393	284	219	271	279	199	232	178	212	189	243	173	227	361	213	190	155	278	259	272	195	116	271	270	170	218	226	353	211	203	231	294	208	252	268	196	247	325	273	242	312	151	238	168	349	307	350	181	225	263	231	244	156	180	292	225	193	203	141	311	205	137	256	272	214	254	295	251	135	186	178	213	241	228	221	217	236	227	238	185	160	190	281	325	261	325	228	131	202	172	191	360	151	259	226	270	170	226	315	226	274	227	292	183	373	260	351	225	238	257	276	264	307	254	310	189	189	175	202	356	251	111	162	275	146	163	275	220	249	173	220	205	166	232	157	235	247	335	187	190	205	184	501	174	245	211	180	247	182	122	192	216	150	244	166	117	208	189	193	195	117	179	208	181	280	177	227	231	148	245	255	156	109	252	148	192	104	165	201	212	258	180	109	175	186	156	173	160	183	175	159	89	167	204	107	203	293	132	198	213	157	242	238	181	140	242	224	176	212	270	172	141	122	113	216	153	164	182	222	187	137	184	294	205	209	235	149	180	258	174	188	174	171	232	158	254	185	149	136	154	205	217	207	115	141	222	182	170	141	200	175	86	145	167	166	264	233	131	131	162	101	225	247	165	139	180	165	171	241	198	153	252	238	170	110	231	165	228	75	87	167	107	133	133	212	202	307	198	148	135	153	172	144	158	279	131	137	213	176	156	191	144	208	137	333	243	105	169	143	152	134	167	196	92	99	98	82	164	205	159	174	197	123	128	98	139	191	134	148	109	132	135	192	163	140	103	171	191	104	180	139	124	157	169	127	138	102	258	300	146	169	132	125	166	153	267	137	138	113	123	188	135	127	116	130	92	63	66	131	140	161	179	249	133	210	90	149	113	213	129	138	136	146	168	129	159	208	236	116	105	108	136	191	237	105	59	112	178	111	143	104	107	148	96	72	154	105	162	124	139	110	74	172	104	141	203	114	181	50	93	135	151	135	146	126	178	106	121	108	98	166	134	70	122	71	84	133	158	78	134	109	121	81	117	157	104	121	145	194	104	107	207	135	110	171	151	185	104	195	84	111	168	144	129	90	120	146	99	177	68	152	94	146	127	79	80	134	118	168	160	114	117	159	83	76	91	114	133	60	110	97	111	80	110	72	106	140	92	115	92	56	143	125	115	244	61	122	74	78	133	113	72	115	101	170	97	105	125	136	139	83	120	155	169	93	129	91	67	117	78	51	81	67	101	88	124	183	110	86	55	155	124	136	59	108	113	115	102	84	188	86	80	98	71	84	102	94	56	92	87	62	71	103	81	108	88	112	103	55	128	102	46	126	103	94	113	50	55	105	107	68	58	106	100	73	181	103	102	102	99	115	120	140	103	92	90	81	58	126	151	49	81	81	84	90	113	81	48	86	54	110	65	161	71	82	47	102	122	78	128	149	76	106	47	77	91	57	48	72	106	80	95	111	94	120	74	70	63	134	60	117	94	57	122	56	166	49	102	59	55	84	152	50	56	95	59	49	135	106	55	40	66	43	83	73	97	116	68	59	93	65	74	68	139	110	79	107	63	88	60	47	72	64	104	65	39	106	100	69	88	79	64	77	43	76	69	43	64	107	64	56	86	60	67	78	31	113	56	97	62	124	72	64	93	56	99	53	66	22	71	44	89	61	85	103	74	88	73	33	100	54	97	73	86	65	65	102	64	52	138	87	48	69	77	71	104	96	103	83	36	72	73	42	71	65	53	57	69	31	66	46	30	49	65	44	54	38	44	56	34	26	54	60	55	38	61	32	56	56	45	58	60	42	52	65	64	105	61	108	48	41	46	103	54	49	75	56	35	53	51	36	27	56	43	55	52	34	43	36	22	47	59	49	62	79	37	53	75	53	41	25	27	67	39	81	38	46	91	56	42	65	51	32	73	44	71	23	28	58	44	73	78	66	39	43	62	23	41	28	53	46	24	31	48	49	47	12	64	33	50	70	36	51	47	63	50	58	34	30	23	39	38	28	42	39	50	41	55	61	29	24	27	22	38	40	59	26	26	37	30	15	32	45	58	27	184	18	29	37	44	40	58	60	43	27	36	32	36	32	70	27	53	14	35	8	33	42	53	53	35	27	58	15	26	42	24	29	20	62	33	14	25	34	23	46	123	63	8	27	89	11	30	35	19	51	23	50	53	13	40	72	31	14	10	9	22	22	47	49	23	37	35	46	35	21	18	35	27	9	9	52	23	26	12	18	17	32	41	14	20	19	38	22	19	18	18	25	16	13	29	33	33	8	12	21	12	15	21	15	21	8	12	3	9	34	26	15	34	29	25	15	49	25	43	34	13	23	6	6	21	11	9	12	15	17	3	25	16	9	13	22	19	20	4	21	40	14	28	12	6	41	48	54	22	13	11	23	30	10	14	9	11	19	10	40	31	14	55	18	16	2	16	10	8	19	5	8	4	31	7	33	9	22	7	8	19	32	7	8	5	24	7	8	5	7	3	3	8	25	23	0	8	10	13	9	5	9	7	8	8	5	12	20	10	9	18	3	7	10	8	1	4	6	3	9	9	5	0	4	4	3	8	0	3	14	3	4	2	3	2	1	1	2	3	0	0	0	7	2	3	2	0	0	2	3	2	0	1	0	0
ne0313	3633	3814	2468	2247	1606	2088	1607	1629	1344	1725	1434	1476	1377	1316	1414	1164	1345	1335	1278	1364	1312	1451	1282	1229	1160	911	1388	1311	1332	1524	938	1090	896	964	1062	1254	896	979	1100	914	1019	898	743	914	849	724	789	845	1199	797	831	840	813	903	964	1031	706	924	918	882	872	641	658	774	615	879	788	701	825	885	847	712	856	556	646	973	691	759	821	681	712	830	644	731	710	617	724	794	710	800	688	722	613	522	720	627	530	538	602	648	633	691	764	565	719	507	611	612	529	692	649	598	573	553	586	796	548	652	546	572	601	551	673	705	674	584	542	571	503	525	509	628	451	627	760	412	495	496	509	552	417	634	571	525	397	585	551	492	555	625	589	505	604	537	587	442	623	508	462	652	548	575	575	619	744	501	529	540	371	556	566	542	501	522	441	574	642	482	532	488	414	495	536	491	533	541	525	565	445	464	442	462	492	379	442	545	449	450	548	400	458	425	441	600	372	523	491	368	537	434	413	545	446	461	559	618	500	493	416	595	613	450	459	411	611	442	440	633	448	522	523	461	438	367	540	441	339	525	551	441	530	434	448	637	273	364	421	435	472	446	405	377	549	484	336	351	369	394	456	390	450	418	423	404	404	369	369	343	449	390	388	432	437	405	471	336	377	426	542	406	344	409	377	324	303	394	439	419	283	382	452	377	460	408	790	465	426	272	332	424	388	437	304	472	407	379	340	499	306	393	366	368	438	299	344	243	361	309	354	474	409	608	306	311	354	471	413	334	320	262	317	376	329	410	335	347	431	345	307	273	402	369	409	456	319	398	338	308	206	322	347	380	417	374	363	326	336	378	251	294	247	405	353	252	293	273	378	379	373	352	302	260	320	287	317	273	338	278	325	323	419	259	312	280	463	308	330	339	280	320	354	695	346	309	275	267	290	359	320	304	444	267	345	293	404	258	238	257	278	399	316	313	354	283	218	229	263	320	391	316	277	277	260	387	393	208	290	305	189	291	257	268	202	315	227	363	251	199	290	238	268	290	215	273	296	265	197	234	350	289	277	250	190	280	329	287	416	301	260	273	303	201	238	232	213	267	220	241	271	191	934	274	214	341	470	245	293	156	184	183	260	236	222	291	261	254	301	269	305	333	182	285	228	187	271	224	294	270	266	241	192	331	345	209	282	248	255	246	268	238	217	368	296	179	251	251	226	179	260	214	241	186	384	232	273	230	247	293	357	277	253	299	256	186	269	245	194	288	309	357	215	160	214	249	156	163	174	304	390	253	196	281	246	218	391	356	296	222	197	205	249	263	288	161	243	244	246	247	192	220	228	171	165	228	198	227	135	230	227	236	320	212	197	220	318	140	240	228	207	203	204	184	214	243	192	382	192	220	211	188	227	240	226	190	183	213	204	171	249	344	151	309	241	187	233	155	226	200	196	274	194	232	182	237	323	194	177	226	207	197	192	195	180	192	189	256	133	214	179	237	223	144	223	224	185	177	222	231	267	186	232	162	132	155	164	171	183	202	214	149	228	172	188	163	230	192	207	184	158	206	109	94	185	192	182	123	202	256	146	212	169	198	209	150	90	172	297	113	135	155	162	198	153	194	123	219	173	245	158	122	141	220	125	254	141	217	154	214	201	187	193	246	186	114	146	204	155	185	232	146	140	164	142	211	222	202	140	202	157	140	234	145	202	157	175	121	102	145	144	110	174	176	153	153	215	155	121	165	162	133	135	172	180	120	166	161	232	175	132	132	179	211	205	166	170	135	119	190	135	273	71	172	194	224	125	156	182	89	120	152	177	312	201	155	256	127	126	139	231	109	173	169	219	185	78	153	201	206	160	151	125	192	93	119	130	144	184	132	112	194	141	141	146	104	132	119	138	139	165	124	157	109	111	107	131	151	119	102	137	178	60	223	157	200	97	130	164	247	118	87	146	178	168	104	154	61	105	184	169	125	114	192	133	190	92	140	179	189	168	116	152	101	128	157	193	98	119	104	94	130	100	205	229	141	93	136	152	97	105	166	231	112	94	160	159	161	163	172	126	95	139	138	173	137	184	109	181	78	104	123	228	161	174	145	140	155	163	124	84	111	97	134	129	141	121	120	109	118	153	181	123	109	82	150	145	73	110	194	132	82	84	160	114	136	188	160	130	136	74	192	137	107	68	104	120	129	117	144	100	131	132	144	73	145	90	158	72	159	170	84	146	103	124	117	131	162	145	103	65	83	134	112	145	111	120	166	86	128	147	176	182	108	212	126	116	140	108	89	93	88	86	84	104	85	103	104	87	117	89	127	120	117	111	128	107	132	88	88	78	98	120	104	127	47	75	123	68	128	115	82	139	115	119	93	85	153	81	114	74	90	64	78	148	111	71	104	90	84	108	115	93	93	132	147	69	44	104	102	127	127	170	94	138	91	75	68	153	79	56	102	112	64	92	85	140	92	78	67	114	97	89	170	90	59	70	139	128	114	82	91	98	81	57	78	60	86	66	107	104	59	100	82	99	143	65	130	59	55	72	56	112	82	135	95	100	109	101	68	99	127	69	95	72	74	92	107	71	81	46	85	70	107	88	102	81	92	106	83	78	81	81	92	116	130	71	108	111	60	77	114	102	40	96	58	96	99	82	76	143	59	79	82	91	67	105	105	91	112	102	77	67	56	69	98	44	81	52	65	66	92	43	77	71	92	106	72	84	107	34	104	55	117	79	118	66	80	75	101	77	76	84	209	97	69	100	99	121	97	82	63	90	119	60	57	50	49	72	63	44	89	49	61	85	123	68	73	58	58	75	88	98	65	77	58	41	100	47	107	80	55	49	47	70	63	76	80	41	43	67	57	89	84	81	65	79	62	59	68	63	73	90	67	80	66	72	49	77	66	45	70	71	66	72	73	25	50	74	68	77	70	81	63	63	68	119	60	98	99	61	61	70	70	46	80	79	70	77	73	63	62	101	59	97	137	63	43	41	85	106	60	81	49	47	82	62	53	48	73	46	79	75	31	56	40	74	55	136	50	68	92	66	74	38	63	24	82	27	46	42	56	45	60	80	55	71	92	28	51	67	40	159	53	78	88	52	47	52	30	45	52	53	53	93	92	84	57	93	41	33	62	52	67	48	64	91	65	49	63	43	85	55	56	47	37	42	29	77	49	59	57	45	37	62	31	88	32	68	31	79	69	71	79	39	52	34	28	43	54	48	60	56	49	64	76	48	44	56	44	81	67	64	72	28	57	51	47	50	100	43	74	46	47	43	59	68	156	25	58	29	38	49	49	38	40	43	42	48	43	67	31	45	28	66	26	32	23	49	35	227	23	4	45	37	39	33	59	51	35	44	33	27	50	21	30	51	38	61	15	44	40	60	42	39	44	77	59	31	63	19	35	56	45	30	17	56	32	22	49	28	51	47	48	83	35	21	63	41	20	24	39	45	43	30	30	24	56	34	53	47	41	45	51	44	48	11	37	59	37	78	50	23	31	26	91	42	24	40	45	46	36	22	43	34	33	25	60	19	34	43	43	51	39	31	29	49	14	23	13	60	11	20	26	23	39	24	51	21	17	15	18	28	50	31	32	32	23	28	45	25	44	16	54	28	60	32	23	30	29	42	25	29	27	30	11	33	29	10	43	17	24	22	34	18	30	16	32	37	17	35	43	25	20	35	15	16	39	21	20	10	23	34	35	21	11	46	22	11	59	23	24	18	8	40	20	24	32	10	37	10	15	18	20	11	44	12	30	48	30	13	7	35	32	33	20	21	14	10	18	14	34	27	20	30	12	36	32	16	12	11	21	23	16	18	19	30	11	8	2	27	26	7	30	9	16	7	5	18	17	11	9	12	19	15	14	11	33	22	37	12	29	13	16	13	11	12	35	9	34	7	21	9	17	16	5	17	9	10	21	11	14	22	8	22	27	11	13	15	8	25	11	25	13	15	6	12	12	2	6	13	33	17	7	14	28	15	7	41	15	34	7	8	6	7	8	5	9	16	6	16	9	8	7	32	6	10	4	5	1	14	11	6	12	1	3	3	4	39	3	5	34	15	9	2	5	4	7	5	11	51	6	9	9	5	9	17	6	3	5	5	6	1	0	4	1	1	4	1	0	2	2	0	2	3	2	6	4	2	1	0	1	0	0	2	1	4	7	0	1	2	3	0	0	1	1	0	0	0	0
ne0314	3576	3814	2367	2312	1873	2070	1580	1641	1616	1846	1590	1521	1356	1211	1435	1100	1123	1452	1195	1468	1335	1244	1161	1319	1079	1099	1393	1128	1264	1430	951	910	899	1002	1031	1078	891	1081	1144	834	960	914	929	1026	810	872	861	755	851	868	935	901	897	831	1096	888	950	1011	841	961	912	813	872	744	722	835	803	771	800	931	894	814	857	696	696	1138	885	769	760	705	727	745	622	752	862	627	616	885	769	777	631	721	583	652	742	635	537	543	674	661	687	672	730	555	699	583	604	585	586	854	636	596	555	609	592	583	545	605	604	563	573	542	665	627	618	647	507	677	507	585	598	528	486	585	697	545	610	568	515	531	580	544	424	506	422	558	688	776	519	669	578	510	524	415	615	493	491	548	474	720	635	557	600	655	674	501	558	499	465	589	535	545	513	594	481	607	627	489	591	493	497	588	589	399	527	551	524	485	540	593	397	399	390	447	499	547	459	416	463	435	463	470	540	620	512	531	481	368	400	432	450	598	529	415	400	537	521	467	360	677	744	514	462	383	625	455	528	660	419	495	531	414	448	394	488	385	422	590	575	487	521	405	558	307	352	378	386	481	499	440	436	510	490	485	400	366	368	412	470	382	415	426	451	390	397	385	307	399	527	333	389	381	472	416	503	369	380	424	509	419	382	430	444	406	354	256	396	387	277	328	510	393	491	445	242	457	436	476	365	441	424	542	298	439	330	464	347	466	221	353	420	379	477	338	302	340	382	250	441	434	463	511	363	357	385	306	363	363	288	377	354	336	396	747	372	303	412	330	374	348	312	287	454	419	274	352	279	344	392	365	385	328	442	324	365	312	340	385	353	320	280	279	589	321	261	348	352	349	275	311	320	277	352	370	339	213	329	307	350	315	264	307	358	278	451	377	418	382	303	368	306	228	300	270	382	280	298	350	233	410	403	395	245	267	329	195	283	280	263	412	331	371	371	283	268	205	262	269	376	325	271	227	273	370	334	272	332	306	297	298	305	239	247	327	343	317	293	278	262	264	279	325	226	308	265	274	262	201	276	257	286	310	243	272	398	332	376	303	250	216	329	306	304	200	252	277	276	338	250	219	258	218	261	292	214	292	224	238	303	250	299	371	250	323	261	194	216	246	286	256	216	287	267	197	335	237	251	250	298	213	245	294	292	451	271	294	236	204	264	245	161	318	360	280	263	247	216	198	286	243	224	244	423	169	225	198	320	257	363	249	275	235	270	215	187	264	253	297	292	353	191	215	302	268	194	187	171	437	305	290	222	274	223	239	333	364	270	229	225	188	293	258	218	196	242	220	207	230	175	256	295	124	192	257	195	206	219	307	261	223	337	202	196	221	285	175	201	180	262	205	199	167	220	265	237	215	172	238	187	251	199	291	193	358	216	242	188	242	208	135	175	405	314	192	224	177	263	194	266	274	94	280	178	265	244	232	219	207	223	204	167	263	225	161	196	299	123	199	183	266	201	100	190	186	190	177	294	184	313	198	218	177	172	152	183	165	184	170	235	164	221	200	235	176	228	191	242	194	160	189	195	199	205	167	225	119	225	233	182	172	191	218	234	163	114	135	192	128	123	172	169	202	167	160	113	226	148	238	134	137	184	195	148	178	177	207	122	139	179	211	171	250	188	110	204	213	120	135	178	128	160	170	196	243	315	184	162	221	161	213	151	142	151	149	177	139	117	147	160	168	188	152	206	195	185	191	130	159	129	162	200	169	196	132	185	202	187	139	125	186	173	233	181	156	205	112	201	111	105	236	108	150	155	217	117	166	156	131	139	190	180	128	201	132	265	195	140	110	220	142	203	164	159	162	106	133	168	247	222	87	124	181	116	144	130	123	174	134	148	127	118	170	131	108	182	168	126	131	135	126	228	115	158	167	147	165	125	94	147	168	104	236	139	111	147	144	185	158	84	137	202	159	131	129	196	260	112	204	202	105	123	168	92	137	106	137	169	193	211	124	141	116	133	138	155	128	134	103	130	76	145	204	83	126	115	116	140	110	128	171	186	120	128	161	118	141	193	213	93	118	135	131	190	152	154	155	131	99	128	132	207	142	167	162	140	135	200	112	83	144	151	155	142	141	121	154	99	111	150	173	128	106	89	132	142	110	144	146	125	74	110	157	131	118	170	99	105	129	81	162	175	124	113	114	121	128	117	106	132	135	140	175	85	103	100	186	106	65	146	78	110	124	169	117	165	116	134	108	107	122	135	116	211	106	132	173	105	96	148	75	176	77	138	109	145	103	100	116	85	108	125	90	105	134	112	133	104	119	113	134	109	103	78	150	148	140	101	86	117	116	110	127	106	102	124	135	100	96	102	102	102	150	115	111	111	132	89	92	78	142	183	113	121	125	89	147	103	92	141	103	100	111	168	61	72	81	111	118	119	119	422	47	127	90	93	123	140	130	93	126	101	65	114	133	101	143	69	86	110	110	133	134	49	55	98	157	104	123	69	95	115	93	63	97	76	101	48	77	82	81	104	94	128	160	85	133	65	51	83	79	100	97	87	102	110	121	52	81	97	118	77	87	103	69	98	84	73	112	70	98	63	76	62	76	78	101	116	103	77	119	88	113	125	117	90	78	155	77	78	133	90	63	67	70	163	62	92	60	131	79	94	87	91	77	124	97	91	82	91	63	97	71	61	75	122	111	59	195	56	80	56	95	58	77	111	80	86	92	67	85	77	111	142	51	98	55	76	101	54	52	69	56	138	95	89	75	96	87	123	81	77	117	91	76	68	64	74	70	103	67	58	54	183	77	105	74	57	84	134	79	88	64	68	79	35	91	53	87	79	64	78	49	46	85	85	85	80	58	62	77	92	88	69	81	55	79	57	84	59	36	83	131	58	74	63	57	93	76	67	48	71	55	69	84	50	53	62	79	79	74	75	87	64	81	172	46	97	124	53	65	89	54	54	92	95	72	49	71	85	92	111	61	58	40	64	40	40	109	114	86	80	52	67	72	39	50	49	69	37	71	78	49	91	36	79	37	121	65	68	70	54	58	43	52	41	67	38	39	59	113	54	61	85	37	77	96	75	49	39	50	46	52	69	64	59	55	38	59	36	46	63	83	89	79	82	92	67	43	42	28	38	75	41	31	109	50	43	79	44	89	73	56	31	66	38	48	67	29	59	48	48	49	48	43	80	50	55	32	73	54	49	66	91	58	64	38	31	45	42	66	41	59	78	61	61	58	37	58	45	60	59	91	51	49	59	37	29	91	51	58	49	76	52	77	78	23	42	28	83	51	85	41	48	45	26	44	34	64	30	36	55	54	68	66	43	32	60	47	29	38	33	48	49	36	47	46	44	36	47	43	45	46	61	42	65	34	46	32	45	35	32	39	47	46	52	21	35	45	34	27	51	42	51	15	45	44	26	104	52	48	44	60	68	79	32	61	33	47	29	28	52	35	42	35	23	46	37	45	50	36	12	55	27	49	27	35	60	47	57	41	37	40	30	46	23	24	40	36	41	17	28	28	51	56	47	55	16	37	55	30	38	39	50	42	33	36	33	18	14	27	34	12	32	31	26	48	27	35	14	27	16	26	27	42	24	29	33	35	24	21	28	29	24	87	31	26	39	19	19	25	28	23	19	33	23	28	28	41	56	21	27	27	14	29	25	54	17	15	20	50	10	31	29	46	17	17	35	50	25	19	52	22	25	52	44	11	16	48	13	12	43	19	34	28	34	36	12	36	16	18	13	21	18	36	10	37	23	10	23	18	24	33	31	15	30	14	14	16	38	20	26	25	23	19	20	47	11	16	66	37	15	8	24	27	25	36	19	7	13	10	38	16	14	16	19	17	10	30	5	10	8	8	20	14	18	16	27	27	17	23	20	11	18	12	25	16	11	13	33	10	21	10	15	15	8	7	13	16	8	19	12	5	10	16	18	70	10	19	17	33	7	10	11	9	15	16	9	8	14	13	14	5	30	17	14	11	13	10	13	14	8	25	7	14	13	8	17	12	15	26	11	2	50	5	12	2	8	10	16	9	5	3	11	10	7	7	28	5	6	3	7	8	2	3	9	5	2	4	8	9	7	6	5	3	15	13	3	7	2	5	1	6	6	4	71	1	9	1	1	1	4	1	0	2	6	1	6	3	1	2	1	1	2	1	0	2	1	3	8	3	29	0	4	0	0	0	0	0
ne0318	761	637	340	423	383	298	327	217	255	307	248	241	301	216	371	174	200	174	156	179	270	140	155	166	145	202	158	193	216	230	154	149	143	191	229	188	174	134	148	318	121	132	103	140	107	171	130	165	139	115	141	139	142	149	132	190	137	121	148	140	118	124	138	96	109	129	132	113	111	98	118	106	139	175	124	147	66	136	135	86	141	129	124	96	108	93	110	100	86	120	149	107	112	137	80	84	101	166	83	118	141	115	131	108	101	107	70	117	138	120	110	95	109	109	115	82	110	129	74	100	103	99	56	109	92	74	94	76	104	87	88	79	80	71	107	84	64	72	93	67	70	120	63	62	81	149	92	71	96	102	91	90	126	70	54	96	82	65	93	79	67	72	67	150	62	69	87	90	82	126	96	78	68	163	93	83	74	85	57	52	103	106	93	55	75	112	89	75	67	61	60	64	46	91	53	76	55	87	64	113	61	73	54	76	56	102	97	72	104	91	93	54	57	73	85	82	59	105	86	69	125	76	55	100	98	48	51	74	83	85	60	85	58	98	59	121	85	62	65	61	67	46	50	106	40	105	130	39	68	67	55	44	42	52	86	74	60	78	52	60	60	76	56	64	100	56	43	93	56	76	50	56	66	42	58	31	63	65	67	45	55	65	43	46	111	61	75	48	37	73	61	103	64	64	85	74	64	42	60	48	55	36	52	60	81	57	86	51	40	51	41	79	56	46	63	34	75	46	70	80	43	60	42	100	45	77	50	57	99	45	49	92	53	76	62	85	64	108	111	65	43	77	100	47	95	56	75	80	51	39	42	44	47	71	61	96	45	42	56	35	52	67	60	65	42	57	64	87	84	67	51	42	63	59	34	41	44	98	62	26	70	64	27	77	83	29	47	38	35	36	75	68	47	21	59	32	28	50	41	59	52	118	79	53	48	32	37	31	99	45	68	33	45	75	50	32	37	50	40	33	43	43	49	57	61	139	49	44	44	32	55	34	53	35	36	42	53	51	36	24	41	54	26	36	71	37	48	26	44	26	39	54	29	31	32	27	38	42	41	48	30	21	48	23	24	37	27	48	27	27	51	40	33	29	55	19	39	42	34	20	25	38	43	35	36	18	30	47	60	64	47	52	48	38	31	55	25	57	27	43	18	35	54	38	62	31	32	12	41	53	18	38	31	21	25	23	28	22	42	26	31	36	23	50	36	29	35	53	35	31	48	75	34	44	80	28	25	28	7	36	19	36	29	26	23	30	41	12	25	42	42	40	31	23	28	35	37	34	37	25	64	69	24	28	23	33	16	46	26	29	46	19	38	48	32	36	30	46	33	43	33	29	28	22	36	39	24	67	48	44	28	30	23	15	49	58	44	31	29	35	41	36	22	22	16	58	24	65	50	31	42	41	25	21	27	22	32	18	19	37	35	49	23	54	39	33	26	30	22	29	26	30	19	34	17	22	21	19	17	24	37	27	18	23	18	31	32	22	17	38	36	49	33	58	31	37	34	27	23	22	45	30	24	21	40	28	19	43	35	19	51	37	31	22	25	20	27	25	25	35	22	19	18	26	48	19	44	40	92	27	34	43	33	19	21	27	27	23	27	19	30	13	27	46	19	36	7	26	18	53	36	44	35	28	25	19	28	18	29	31	30	31	20	33	12	19	28	28	15	25	30	14	48	35	24	25	13	23	24	32	10	21	33	24	30	36	16	35	23	38	12	16	20	13	11	19	49	55	21	20	14	33	30	34	4	16	10	37	36	25	13	15	31	34	31	17	19	23	22	19	18	10	26	35	32	31	14	27	23	25	9	31	20	53	52	25	28	19	15	35	11	15	15	17	23	22	15	30	13	28	22	9	18	22	47	34	20	22	21	19	46	28	10	24	12	24	17	27	17	21	23	27	13	43	16	21	18	17	21	15	17	15	22	33	34	10	7	16	13	44	37	9	36	18	18	16	23	19	14	30	56	14	26	15	11	32	9	20	21	26	13	18	38	24	42	32	20	28	23	12	31	22	21	25	19	28	23	17	17	17	18	11	28	26	25	38	24	62	20	25	14	36	21	18	12	26	40	15	24	15	26	13	21	25	16	29	22	30	17	28	46	9	27	13	24	45	13	45	14	18	9	18	12	22	28	51	17	42	23	10	14	15	10	19	20	12	26	15	21	26	23	11	10	12	27	7	12	27	5	14	17	22	15	26	11	18	14	12	22	39	14	11	22	11	19	19	7	18	19	50	8	9	8	19	13	42	17	10	11	20	10	19	14	25	12	12	19	17	21	22	13	10	15	16	14	12	10	16	32	15	12	14	12	20	16	11	17	9	12	18	25	11	14	10	7	11	12	17	12	7	19	16	10	25	4	11	12	13	14	16	21	12	26	8	10	17	16	9	22	11	11	14	28	29	8	16	13	11	28	10	9	17	8	16	16	15	25	10	22	14	20	25	11	25	21	12	11	20	6	14	18	13	18	12	21	16	19	4	18	19	27	14	7	13	20	20	11	12	5	12	14	12	82	18	12	15	15	14	7	14	8	14	6	26	1	12	14	23	27	14	17	11	7	22	15	13	22	16	11	25	13	15	25	16	8	17	10	7	14	6	12	16	9	9	38	3	10	4	17	9	8	13	12	2	18	12	8	14	9	11	17	10	22	9	10	6	11	48	9	20	11	13	10	7	21	10	23	4	25	14	4	11	20	10	21	3	3	6	22	8	20	13	11	23	16	62	20	18	9	10	8	15	3	19	5	10	6	15	7	10	3	13	26	12	14	5	21	5	50	22	22	10	7	13	12	3	12	7	17	10	11	11	23	9	2	14	18	9	13	7	26	15	18	7	11	5	11	9	8	7	21	10	6	7	6	9	8	17	12	4	12	14	13	23	26	11	14	11	24	5	5	13	20	5	18	14	15	7	6	7	9	9	7	5	7	6	11	13	11	3	5	7	7	12	8	21	6	11	2	1	35	14	4	14	7	7	12	8	10	2	26	27	12	15	8	17	4	4	9	16	8	8	10	2	6	5	13	5	14	2	7	5	17	14	13	13	4	11	3	16	11	9	6	8	13	10	10	6	6	9	22	18	8	9	6	10	5	4	9	5	10	11	5	4	9	17	4	6	22	10	15	7	4	3	19	5	15	4	5	14	8	5	3	5	3	3	5	2	1	14	10	5	28	8	8	8	4	13	11	17	6	11	4	8	3	7	5	4	12	19	10	5	13	3	10	3	14	5	5	5	13	9	2	13	11	5	4	4	5	3	10	11	0	4	7	15	5	15	2	2	6	5	3	6	4	1	9	2	3	1	1	30	6	13	3	4	12	2	9	5	2	1	2	15	9	4	1	7	5	6	5	3	3	8	6	10	2	20	7	2	6	4	3	11	10	7	2	5	7	8	16	2	5	2	13	5	5	11	6	12	10	11	10	11	2	9	1	4	12	11	6	13	5	1	16	6	1	14	5	13	6	5	4	6	3	4	7	3	2	8	8	11	9	3	6	3	8	8	7	10	6	4	5	11	5	1	13	6	3	1	20	6	4	6	2	6	5	2	3	2	8	14	5	7	3	4	6	1	11	4	9	8	3	6	4	1	1	7	6	4	4	2	0	10	2	5	0	26	2	11	5	3	6	10	2	6	6	1	7	7	1	4	1	1	5	7	9	3	0	6	4	1	4	3	3	2	14	7	1	9	1	3	3	2	3	1	1	7	3	3	0	1	4	2	5	4	1	3	4	1	1	0	11	0	1	3	0	1	7	2	2	1	2	2	0	3	2	3	0	6	4	0	1	0	1	2	3	3	3	2	0	4	2	11	2	4	3	1	3	0	1	0	2	1	8	1	1	0	4	1	2	1	2	2	1	1	2	12	0	1	1	6	1	5	0	2	0	3	1	9	0	0	0	3	1	4	1	5	2	3	1	1	0	0	1	1	0	3	6	7	4	0	0	4	4	0	1	5	0	2	1	0	6	1	3	0	3	0	1	0	0	0	5	2	1	0	3	0	0	3	1	2	0	0	2	2	0	2	0	1	3	1	2	2	2	2	3	1	1	3	1	0	2	3	0	0	3	3	1	1	0	0	2	0	6	0	0	0	0	0	0	1	0	1	0	0	1	0	0	0	0	1	0	1	0	0	0	1	0	0	0	0	0	1	0	0	1	0
ne0320	136	144	95	177	144	65	72	53	95	71	83	59	58	52	54	48	40	69	33	43	77	37	76	49	58	113	75	35	56	39	81	31	51	45	27	39	57	53	55	47	38	41	35	33	20	28	37	30	11	49	28	39	45	83	28	24	60	42	22	51	33	52	56	44	46	34	23	35	41	40	40	40	30	34	52	104	52	43	21	35	42	21	38	22	78	36	31	35	26	15	21	18	27	38	42	39	22	30	25	25	28	20	42	27	35	35	37	25	19	21	30	24	27	21	31	31	25	28	47	22	27	27	33	16	27	44	33	33	28	25	49	19	67	37	14	78	13	32	22	36	41	21	11	31	40	25	30	36	25	24	27	37	26	18	28	26	16	44	20	58	20	28	23	26	11	31	28	13	67	20	12	31	23	25	24	14	25	20	37	30	84	14	41	20	31	53	22	14	18	27	21	20	14	31	25	23	30	19	13	34	23	28	23	23	33	26	36	17	6	19	19	21	17	14	42	13	22	36	13	36	39	19	18	17	9	16	17	15	22	21	17	23	30	22	16	14	28	34	22	34	20	22	16	31	40	20	19	26	17	14	27	24	19	25	15	19	16	10	20	28	17	30	22	16	31	8	10	44	28	20	20	25	7	19	22	33	8	21	14	28	17	24	22	28	48	41	12	11	20	17	18	18	37	8	14	29	15	27	10	19	13	20	23	15	13	20	16	12	13	22	35	34	32	33	15	18	16	36	10	11	13	10	15	38	30	17	19	19	22	28	13	13	8	7	12	10	17	73	18	14	16	14	16	52	19	15	12	11	29	19	20	9	15	9	11	18	10	13	24	17	21	21	11	21	28	17	9	14	6	12	21	34	15	17	18	21	23	13	9	16	66	14	15	14	12	29	22	18	16	15	58	53	19	21	20	23	21	25	26	14	5	43	15	6	1	18	30	14	21	13	12	25	18	14	5	16	16	22	8	5	6	36	31	10	5	16	2	13	33	15	12	11	19	17	16	7	16	16	14	19	12	40	14	12	14	16	13	10	12	6	5	14	18	16	13	24	8	13	14	5	11	7	25	15	16	9	9	14	8	5	58	10	11	14	7	15	6	7	16	13	32	15	12	14	14	12	4	7	8	6	33	5	23	23	31	15	6	13	10	13	20	11	6	9	13	16	23	6	14	10	6	9	7	21	13	10	14	18	12	14	25	19	9	5	13	14	12	3	10	7	5	4	10	10	18	10	14	4	11	11	5	13	15	14	24	13	11	17	17	14	16	7	16	5	4	9	8	15	8	15	10	8	6	6	9	6	20	16	11	6	6	9	15	15	13	18	7	6	11	14	9	2	11	12	11	10	8	1	8	4	18	3	8	20	7	35	3	17	6	6	5	11	12	13	21	14	13	5	6	39	37	7	14	21	2	16	19	13	5	10	15	25	15	7	1	9	16	4	7	5	9	17	14	8	21	8	9	4	19	9	2	7	4	8	19	16	11	1	15	9	5	20	8	10	14	3	7	6	14	11	5	12	17	9	9	6	8	4	6	13	22	18	5	10	7	4	7	6	2	3	17	9	10	12	27	7	8	38	5	27	7	4	11	12	13	7	6	8	2	10	8	3	4	15	1	5	5	6	6	4	15	7	5	11	6	9	2	9	7	6	10	14	5	12	6	14	8	8	13	20	7	16	6	9	7	21	16	10	7	12	4	9	8	1	7	5	8	10	6	13	31	13	16	0	22	6	9	4	13	19	4	8	3	3	11	20	6	7	4	4	10	7	5	8	8	10	2	13	2	10	9	6	3	9	6	7	2	2	11	5	2	6	1	11	30	0	2	4	6	12	5	6	10	10	3	4	3	5	3	2	3	25	3	3	7	0	18	3	10	3	1	4	28	10	1	5	3	4	4	6	14	6	8	7	4	5	4	4	9	7	6	7	6	5	5	16	4	5	7	4	8	4	4	10	7	7	4	7	10	30	8	4	4	4	1	6	9	2	7	14	9	9	16	5	4	15	4	1	5	5	5	5	9	2	2	11	9	12	4	8	4	7	14	9	4	10	2	5	5	6	3	4	2	6	4	14	1	5	6	1	2	3	6	2	2	5	17	5	2	8	8	5	2	2	11	7	6	0	4	4	7	6	6	3	5	14	9	0	8	10	13	7	5	4	2	11	5	0	12	0	2	16	9	3	6	11	6	7	3	13	9	8	6	2	10	9	4	3	9	28	4	6	3	2	9	5	1	6	1	4	0	2	0	7	15	3	3	20	9	5	5	3	12	7	8	4	2	5	11	4	4	8	9	5	4	2	6	14	10	2	6	5	10	8	0	4	8	2	2	2	5	5	5	9	6	2	0	9	4	9	9	8	0	1	2	3	5	3	3	6	7	4	3	4	10	19	4	6	1	1	4	3	5	5	2	6	5	5	4	9	2	6	6	4	0	1	4	9	2	8	3	6	7	6	3	3	4	8	5	0	7	2	10	5	13	1	5	6	7	7	16	1	4	5	0	6	8	19	6	4	10	8	12	2	6	2	2	3	3	5	5	5	8	3	0	5	0	4	9	6	4	1	4	8	3	1	3	2	1	6	3	2	6	1	3	1	6	19	7	1	5	6	9	2	9	1	2	5	6	6	2	4	2	4	3	2	0	2	1	2	6	6	10	21	0	6	1	2	6	2	5	1	5	2	5	4	2	5	8	5	2	2	2	2	3	9	14	5	10	1	1	20	1	4	4	2	3	0	5	7	1	2	5	13	5	12	3	6	9	1	4	1	3	2	0	0	4	3	7	2	4	15	6	5	3	3	5	2	7	1	4	1	4	5	7	9	1	3	11	6	6	6	1	4	6	0	9	6	6	6	0	6	4	5	8	3	0	4	2	4	0	3	5	3	29	5	1	4	1	1	3	3	4	8	6	1	4	0	6	2	1	6	4	10	7	16	4	6	2	7	0	10	5	10	1	4	3	2	5	15	2	4	7	3	2	10	2	6	1	8	3	27	4	4	2	8	4	9	1	3	8	0	1	1	2	1	7	4	3	3	4	3	0	6	4	3	3	2	4	2	2	0	3	3	4	6	3	4	3	3	5	5	0	1	1	5	3	3	7	1	1	6	4	6	3	0	2	3	3	6	1	2	5	2	7	10	1	0	1	1	1	3	1	4	2	3	0	2	2	6	2	2	5	1	0	5	2	2	1	1	4	3	2	6	0	4	2	2	5	0	2	8	2	11	2	7	1	0	0	1	1	4	4	3	0	5	4	2	2	2	7	2	2	0	5	8	2	2	1	2	5	1	1	3	3	4	0	6	10	2	6	1	0	1	5	6	3	5	5	2	9	0	0	2	0	1	0	1	1	1	0	0	1	1	2	3	7	2	8	5	1	5	5	2	7	3	4	1	2	1	6	7	2	3	8	1	1	2	2	5	1	2	0	2	3	1	0	0	9	0	0	1	2	0	5	6	6	1	0	0	5	1	3	3	4	0	3	3	1	2	4	5	1	1	9	1	6	1	4	1	0	2	2	1	3	3	3	1	6	3	4	12	1	2	6	1	3	2	10	4	2	3	2	0	3	3	2	1	1	1	1	0	3	5	4	0	1	0	0	1	0	2	4	0	1	0	1	0	4	0	1	1	2	7	2	1	1	1	3	1	8	7	10	3	1	0	2	1	4	6	1	4	0	1	1	1	7	1	3	2	2	0	2	1	1	1	1	0	2	1	2	2	3	1	0	0	1	3	2	0	0	2	4	0	2	2	4	1	0	0	14	2	1	1	2	1	0	1	5	3	0	1	2	0	2	3	1	0	0	4	4	0	4	1	1	0	0	4	5	3	2	1	1	1	2	0	1	0	1	1	0	0	3	7	1	0	6	0	1	0	6	2	1	2	0	0	0	1	0	0	3	2	1	0	7	0	2	1	1	0	4	1	0	1	2	1	2	0	0	4	4	0	3	0	4	1	0	0	1	0	2	3	0	6	1	2	1	1	1	1	1	2	1	4	0	0	0	0	1	1	0	0	1	4	1	0	1	1	1	0	0	1	2	0	1	0	0	1	1	0	0	0	0	1	0	1	0	1	0	1	0	0	0	4	1	2	0	0	0	0	1	0	1	0	0	0	0	0	0	1	0	1	0	0	0	1	0	0	1	0	0	0	0	0	0	0	0	0
ne0321	4878	3830	2348	2541	2383	2625	2478	2045	1975	2364	1973	2035	2015	1991	1558	1895	1841	1385	1507	1700	1458	1583	1365	1644	1327	1363	1359	1280	1280	1324	1274	1238	1486	1498	1123	1137	1510	1212	1012	1025	1096	1270	829	1316	1241	1353	1402	1042	1088	1368	1328	1228	970	843	952	1234	941	920	843	1096	1199	1045	893	945	1226	900	1266	1029	986	799	912	853	930	974	1008	921	1130	1000	821	758	1188	724	1192	729	831	1111	582	1023	795	789	900	723	1119	767	696	728	1059	810	909	1180	913	802	682	1152	813	1046	615	1135	804	776	710	695	1179	1175	1060	680	1043	813	622	995	816	1087	653	652	682	884	645	861	1018	1009	983	792	657	573	636	592	592	645	984	665	956	827	626	594	592	787	790	487	617	652	894	674	778	621	651	652	674	690	943	828	759	600	878	738	736	531	610	597	609	812	538	582	889	690	919	469	658	896	664	493	773	623	743	525	668	460	658	540	465	532	547	606	609	919	601	670	518	888	507	685	617	559	649	518	472	696	553	633	656	468	912	563	431	668	469	523	579	383	525	530	490	568	361	522	456	548	529	547	511	473	438	520	461	475	549	510	505	478	529	559	554	540	632	455	450	565	669	541	506	471	662	461	519	480	686	822	435	511	388	396	530	517	425	483	436	503	496	413	387	347	596	478	494	551	565	462	382	530	354	385	324	434	418	311	601	238	394	433	394	496	464	539	378	400	442	359	667	654	434	442	388	388	505	443	385	384	410	406	438	413	408	325	419	498	296	461	394	282	593	409	552	398	424	430	359	432	450	509	368	512	336	539	416	518	422	374	432	382	495	424	385	424	496	510	456	351	339	325	409	394	446	311	314	376	338	512	308	396	359	371	440	280	510	435	372	414	341	306	395	353	376	401	400	387	411	268	326	276	454	353	291	445	391	499	343	457	367	312	339	411	326	392	362	273	494	435	254	296	227	570	341	352	437	347	374	302	311	278	464	290	327	351	312	430	252	305	418	362	357	330	319	207	312	417	411	538	293	291	336	244	450	349	273	249	422	321	306	295	274	353	336	302	318	242	306	322	411	289	253	317	320	423	336	328	214	282	314	273	252	370	409	276	247	277	257	285	253	525	293	335	199	340	282	325	318	270	299	391	243	244	420	315	394	291	333	148	335	356	414	244	328	207	295	206	249	315	281	316	322	414	298	391	265	385	462	316	225	237	309	316	251	304	373	313	307	233	282	259	276	395	303	330	239	321	256	303	250	290	238	253	287	335	336	242	246	321	335	333	233	239	198	275	304	335	244	222	290	276	203	327	218	199	292	336	212	229	254	233	242	253	315	395	236	417	275	253	242	268	222	241	384	218	238	251	248	306	241	375	296	279	218	297	321	183	272	336	258	287	196	255	314	232	380	186	317	210	239	210	329	223	225	275	235	446	283	253	184	236	237	196	275	316	188	136	175	204	264	298	267	192	168	267	210	185	218	233	191	159	185	177	219	188	221	181	173	177	380	217	232	262	152	211	185	212	248	206	230	187	178	224	231	328	284	206	304	163	206	293	191	225	217	284	241	287	292	229	261	215	226	191	226	200	221	281	220	400	213	180	306	179	256	179	169	199	198	175	208	147	230	204	187	202	191	210	170	196	186	166	200	117	247	250	148	175	176	196	218	173	207	167	261	147	166	263	188	183	197	186	235	142	180	94	169	148	200	143	160	224	218	167	164	220	181	293	205	168	176	234	145	139	144	147	230	185	198	161	115	194	185	165	302	205	115	172	172	154	201	157	124	209	145	188	178	193	252	134	141	207	198	184	210	176	290	139	255	163	167	173	156	259	249	162	204	209	160	200	150	181	116	196	161	186	133	181	154	149	194	194	134	141	178	143	142	165	186	177	152	178	171	152	83	285	207	195	166	222	165	159	191	88	211	214	266	213	171	199	186	91	200	148	185	119	161	162	165	176	151	162	115	186	124	139	233	111	131	236	130	117	157	71	178	109	139	193	113	123	120	128	109	152	157	187	136	112	101	167	108	82	166	104	111	138	142	190	155	137	128	96	154	100	114	155	156	206	109	168	218	119	120	162	93	134	88	131	117	208	180	191	112	155	180	118	116	173	109	115	202	127	124	132	149	144	208	155	145	122	134	157	149	98	138	176	118	154	162	153	153	173	127	55	112	81	115	104	99	146	106	124	113	141	128	174	138	160	122	163	161	151	141	173	166	103	99	134	77	110	119	124	99	144	148	152	113	144	121	128	102	151	134	105	130	106	109	145	92	74	183	172	150	181	122	116	124	124	81	115	109	116	135	88	96	173	116	176	190	168	101	149	211	140	122	124	92	128	123	149	122	129	130	107	128	134	102	109	218	111	116	81	96	103	94	113	118	98	106	98	166	146	120	148	147	89	110	154	77	101	127	58	127	115	120	107	103	85	89	106	151	145	123	120	79	107	97	137	176	136	95	118	166	98	78	151	113	98	101	118	101	148	106	142	116	95	121	86	159	128	129	63	93	96	127	158	123	168	99	124	74	141	140	82	84	84	140	106	114	102	133	135	165	134	86	154	106	104	151	113	78	113	75	121	119	87	84	119	109	67	70	147	121	69	40	89	76	129	51	84	135	69	100	139	78	75	145	112	110	82	134	119	95	88	68	44	138	120	137	111	60	73	70	96	67	106	116	76	60	61	87	119	81	95	152	100	63	95	69	88	35	121	95	82	112	117	67	120	109	84	100	75	78	59	114	74	99	44	100	62	86	94	80	106	94	94	88	130	85	69	92	93	71	127	76	77	79	129	70	67	79	90	48	111	64	94	61	46	107	79	95	24	113	71	93	78	104	130	176	118	63	89	69	83	95	110	66	68	113	75	86	57	93	46	97	71	50	72	98	53	52	69	68	43	68	90	133	83	67	72	45	101	67	53	88	78	41	83	82	106	46	48	144	76	125	71	124	38	86	68	52	65	100	56	41	41	87	71	102	77	67	67	73	65	101	96	42	95	63	50	60	104	78	129	50	62	112	99	52	64	71	116	108	92	52	86	38	47	49	72	44	50	61	43	60	69	71	84	50	53	65	53	78	107	66	89	59	74	46	38	67	79	55	56	47	73	65	62	46	72	70	36	32	49	77	65	93	66	29	65	47	52	43	57	78	84	44	26	55	59	112	90	54	97	68	61	70	53	98	97	66	32	58	74	38	67	36	63	34	54	48	83	37	92	45	30	52	73	58	66	22	69	29	48	46	86	83	39	48	77	27	42	60	68	64	72	81	66	45	65	54	78	56	62	94	48	50	59	45	47	23	46	67	53	43	75	54	59	33	49	48	43	57	57	83	69	64	55	47	37	58	44	58	51	87	38	54	38	50	46	69	28	47	58	27	40	63	45	41	32	43	67	36	32	47	57	45	39	37	53	53	56	48	63	28	39	71	53	41	62	46	26	100	35	60	70	29	52	73	44	34	107	37	58	34	36	43	44	36	38	28	35	76	33	49	49	38	27	34	22	21	26	45	45	46	52	33	44	36	44	37	27	41	38	30	34	56	75	32	36	49	33	57	19	61	40	65	19	35	32	27	34	34	55	52	40	65	25	30	31	52	51	56	24	46	38	49	24	24	41	24	32	21	13	25	45	26	57	46	33	31	38	18	44	54	34	25	37	22	36	23	67	24	73	41	26	30	39	23	40	22	24	18	16	36	32	46	27	27	22	31	27	28	16	28	46	24	32	31	35	25	31	34	26	49	40	19	33	37	13	21	19	25	17	35	28	13	31	34	9	19	40	19	24	16	12	32	17	35	27	21	28	64	34	15	26	51	19	22	26	11	30	36	29	16	15	23	16	20	51	31	37	27	40	28	19	30	14	17	26	26	11	23	23	15	19	12	21	13	19	6	8	17	25	13	50	24	12	6	9	26	14	11	6	16	19	27	23	14	14	14	21	16	21	26	16	20	12	18	30	8	22	23	18	12	19	24	21	12	12	7	22	11	10	17	6	34	18	16	8	24	14	9	6	12	8	9	18	9	9	8	8	7	19	6	12	4	14	11	12	9	19	14	20	6	20	29	17	25	20	7	20	9	5	4	10	3	7	12	6	6	16	4	10	15	8	10	48	4	5	3	11	14	4	4	4	4	16	5	3	9	2	2	5	2	3	4	2	11	8	7	1	1	2	2	3	1	1	3	0	1	6	1	7	5	1	5	4	1	2	1	0
ne0322	4818	3533	2372	2081	2194	2747	2254	2040	1899	2383	1836	2197	2156	2141	1513	1681	1882	1401	1272	1783	1326	1659	1228	1494	1362	1191	1442	1554	1291	1410	1201	1168	1443	1487	1124	1149	1330	1167	1064	964	1114	1196	721	1208	1037	1375	1368	1028	1155	1227	1370	1195	1000	920	997	1290	788	842	1016	1019	1193	983	724	808	1099	995	1327	1022	920	854	897	685	941	894	753	907	1105	943	975	694	1031	797	1177	679	696	1150	747	993	664	905	814	757	1083	562	754	673	1040	746	705	827	1070	687	619	1045	797	943	774	1145	683	754	672	692	1232	1141	1021	722	1082	801	511	1018	694	1063	603	803	706	650	683	724	1073	1054	866	810	675	556	699	475	568	654	980	751	674	820	529	686	510	841	704	561	754	625	818	615	817	709	658	543	723	669	959	775	760	634	803	747	750	633	658	591	367	677	582	638	782	707	936	491	734	921	593	503	611	572	592	507	647	400	627	525	481	556	399	667	367	806	617	603	527	943	491	613	549	531	478	583	381	636	515	636	792	548	934	601	486	666	307	522	567	407	573	655	498	528	399	593	510	544	582	528	494	515	395	604	417	345	579	409	451	585	610	566	641	519	468	430	320	640	699	549	501	464	659	423	552	423	627	851	405	520	386	381	497	478	457	519	420	521	444	416	420	393	572	466	580	551	558	448	401	538	499	389	335	483	449	274	486	230	428	406	313	414	534	523	459	471	576	376	520	407	413	479	362	318	450	444	468	382	407	421	366	416	370	402	461	443	297	305	463	266	546	395	502	444	457	364	397	475	458	464	362	404	394	495	468	379	479	421	488	251	470	500	414	517	406	240	450	394	410	368	318	356	415	349	345	395	395	529	446	341	277	345	413	335	396	297	391	341	369	362	352	411	344	338	469	457	447	256	291	336	536	381	370	397	404	438	368	341	356	264	349	406	288	402	295	254	458	378	309	316	231	447	326	315	410	361	374	283	321	212	445	331	417	361	362	376	271	252	355	417	367	410	360	185	309	407	473	457	367	331	240	329	323	307	218	314	350	399	307	206	324	359	371	258	297	251	380	352	347	225	296	336	307	343	278	330	262	312	364	292	215	422	428	251	240	204	195	251	205	334	264	257	391	358	296	352	337	234	300	291	187	181	241	283	364	267	311	202	353	306	342	337	224	235	198	239	243	340	293	274	346	471	270	320	248	269	352	327	208	223	330	360	270	273	342	270	320	221	272	268	282	433	299	242	259	205	250	294	222	325	232	221	282	315	351	243	269	374	268	313	218	252	215	253	250	314	237	134	212	221	332	350	205	222	266	304	289	232	277	314	270	276	305	289	247	372	266	274	255	283	186	233	323	153	207	325	277	274	229	299	340	331	258	273	304	210	290	252	295	261	228	262	242	270	291	182	246	217	258	225	368	233	264	239	269	211	270	259	207	244	276	256	233	204	211	152	191	220	187	315	216	235	159	262	194	210	296	247	275	186	208	198	195	172	228	201	206	183	232	228	186	231	187	155	170	195	215	209	174	221	173	286	249	306	284	257	274	166	182	255	190	157	205	253	217	292	186	220	237	218	170	227	163	158	172	233	201	211	201	180	251	207	221	188	132	154	106	186	208	136	197	152	243	229	268	233	138	241	186	215	255	136	226	236	152	164	196	150	292	215	217	172	208	212	191	236	183	198	195	166	205	126	187	133	173	156	170	209	191	240	225	179	214	164	152	258	194	110	163	239	174	105	156	133	200	172	193	244	88	221	147	147	119	211	159	176	154	164	241	127	92	174	133	187	193	143	216	136	119	321	142	195	136	184	326	185	195	170	146	136	147	179	270	171	136	153	227	161	118	190	180	148	184	196	157	219	163	145	187	199	152	125	225	179	131	156	181	147	193	147	156	157	83	119	162	130	202	207	136	210	179	66	206	174	100	207	214	113	175	100	171	129	152	155	189	124	155	157	169	99	96	178	116	134	200	122	135	115	243	158	144	83	150	147	112	238	85	153	140	134	118	135	206	144	139	111	164	153	102	130	111	85	117	142	110	253	127	128	151	117	114	130	130	166	160	117	134	181	280	118	103	190	164	114	132	178	173	219	152	144	116	176	163	127	142	152	115	140	225	116	125	115	125	154	202	139	119	103	95	135	154	121	125	227	85	156	115	120	163	189	125	104	99	148	132	85	159	163	127	127	101	147	71	170	108	149	142	172	119	134	147	148	161	145	91	134	93	120	64	88	139	97	187	109	140	162	109	105	137	120	101	157	135	125	137	110	101	126	183	143	138	159	133	88	129	131	107	120	118	111	94	81	82	172	88	120	107	131	67	101	192	109	88	135	88	118	122	120	125	123	92	122	114	136	111	73	187	121	111	112	115	135	98	92	114	91	81	117	117	125	109	122	93	98	129	137	75	101	156	45	130	128	90	96	114	151	69	56	134	81	131	161	109	116	95	138	178	74	119	105	122	114	95	94	131	148	123	80	92	127	102	142	93	121	79	86	101	120	136	89	93	97	112	115	64	159	61	86	79	127	165	60	100	81	114	126	98	111	66	93	175	83	117	138	134	119	126	110	90	100	97	124	75	83	44	132	95	64	110	190	87	50	78	118	93	154	38	119	116	71	86	96	111	81	129	110	106	69	143	110	132	93	76	52	93	79	87	75	84	82	91	99	79	102	94	50	64	87	88	162	79	97	142	107	53	106	51	79	30	95	71	84	78	82	48	122	101	75	101	68	44	49	122	97	79	40	96	83	97	87	54	85	110	112	69	138	74	88	84	135	69	97	77	77	61	123	68	45	77	48	47	134	57	107	51	69	77	137	53	27	57	85	103	99	102	104	85	111	55	86	56	83	81	77	74	88	84	80	105	39	91	153	102	77	51	64	83	61	54	95	60	34	89	69	149	99	54	67	54	95	47	75	84	51	37	71	74	78	66	64	123	69	88	105	137	77	76	53	69	54	69	63	51	69	65	66	79	109	75	71	55	68	115	89	76	102	52	25	66	68	61	75	70	61	89	112	37	63	75	94	80	101	59	53	28	27	52	61	48	76	48	39	61	72	61	44	31	60	51	51	70	59	64	99	47	71	74	60	36	56	59	48	106	74	50	66	45	61	56	57	33	27	63	47	87	82	47	57	38	67	51	57	65	64	48	31	58	57	103	87	58	62	54	82	78	36	103	71	72	58	51	61	26	35	42	50	43	71	46	44	45	103	75	44	38	49	57	61	25	54	35	56	59	77	72	56	37	61	25	45	56	115	74	40	58	43	57	33	58	56	57	87	87	32	28	64	58	40	39	46	41	37	44	50	39	52	31	38	50	36	59	43	55	43	40	37	43	35	62	25	98	49	172	44	50	61	44	30	58	16	45	51	35	58	26	33	37	43	43	36	36	35	44	57	51	25	26	57	30	46	22	40	38	36	50	24	67	36	35	35	72	41	32	71	29	24	38	37	20	76	31	44	44	25	46	35	23	27	22	38	39	39	36	44	51	24	21	21	42	37	35	50	49	49	30	48	39	32	48	31	20	17	36	29	45	64	18	30	41	27	43	33	81	42	36	42	36	32	22	48	57	70	24	24	40	26	22	44	30	30	24	29	34	44	43	22	27	27	18	19	23	33	24	41	15	25	37	48	33	22	24	45	42	39	12	25	22	18	23	50	24	62	27	26	25	61	10	38	31	26	11	24	10	22	23	18	20	19	25	20	19	25	20	12	19	11	43	8	13	39	17	16	30	25	22	39	59	18	26	21	33	27	3	6	11	23	19	25	27	28	20	10	31	18	37	20	41	31	12	11	23	53	23	16	31	25	32	38	12	43	28	22	23	9	19	26	25	23	20	5	32	31	31	16	17	14	34	20	29	13	13	16	21	9	21	9	13	26	10	24	20	11	19	20	18	15	13	10	25	25	8	11	5	11	32	18	11	20	16	26	10	15	30	2	14	15	14	11	6	11	14	24	14	20	14	8	11	15	8	19	14	8	8	3	12	17	9	20	28	11	10	1	22	6	12	15	5	3	16	1	26	6	6	7	5	11	11	7	9	13	10	12	5	7	14	4	9	8	8	6	9	21	2	7	7	3	5	7	9	9	13	10	9	16	9	30	1	2	2	8	10	4	4	2	5	13	5	5	3	3	7	3	4	4	4	0	3	0	4	2	1	85	1	1	0	3	8	6	5	2	2	6	3	1	1	4	1	2	0	0
ne0323	4580	2961	2284	1738	1730	2514	2035	1991	1677	2033	1595	1949	2023	2115	1420	1584	1806	1263	1160	1728	1173	1451	1130	1263	1247	1043	1275	1396	1066	1269	1080	956	1348	1469	1040	1028	1379	923	1011	796	995	1104	642	1112	981	1365	1288	992	973	1162	1397	1071	891	629	959	1197	691	733	920	899	1151	820	595	636	1013	867	1269	820	801	764	807	660	721	652	631	756	795	853	869	594	1036	655	1147	655	642	1112	721	952	580	840	754	691	1084	545	680	567	1012	700	576	650	891	615	505	1027	700	954	736	1111	704	726	550	632	1132	1085	1037	597	1078	789	472	1031	643	1033	517	618	654	629	574	663	1075	982	876	739	549	486	636	403	515	564	933	650	722	822	479	561	395	738	620	447	610	656	740	605	819	661	609	481	690	558	956	625	668	497	757	686	671	495	627	485	338	565	509	564	749	644	914	506	559	911	467	451	406	484	449	431	402	306	430	525	424	499	380	631	401	802	531	585	481	919	465	580	452	467	417	540	306	619	431	605	628	441	929	525	378	602	302	510	498	324	562	451	402	431	340	555	433	433	518	490	411	485	348	539	360	291	543	418	394	442	528	524	460	474	352	481	274	553	621	516	461	361	610	389	516	409	541	848	413	554	362	317	406	403	463	517	413	498	473	295	362	330	505	460	499	509	462	392	421	502	381	340	219	461	422	220	360	223	383	343	312	369	463	550	323	406	508	302	508	344	458	438	286	284	352	362	391	297	381	362	375	319	310	375	333	422	286	278	400	294	362	489	412	356	467	312	357	399	416	388	335	349	348	511	461	323	425	357	425	202	379	477	333	463	363	248	447	326	348	348	354	297	407	284	276	296	389	495	293	278	242	316	362	295	397	256	303	344	325	277	371	340	340	281	406	383	377	223	243	310	450	363	167	325	368	452	303	317	332	229	385	342	241	377	303	246	323	385	263	295	199	327	320	187	397	328	347	244	228	158	418	290	366	325	332	392	300	229	329	348	307	300	239	135	243	328	405	382	344	309	203	271	302	221	199	233	330	323	232	192	261	301	347	234	310	221	251	323	227	216	292	246	225	244	241	309	211	227	332	254	166	315	389	217	193	190	215	218	181	225	232	227	217	328	239	367	367	233	313	253	204	185	231	171	309	212	257	144	261	262	314	237	133	257	203	187	211	287	233	217	313	406	244	286	255	288	339	250	164	193	318	329	228	278	240	265	277	197	268	253	257	404	276	200	208	186	258	334	183	269	219	155	218	246	317	229	233	319	263	249	209	186	190	209	238	280	166	143	191	182	300	279	150	168	276	274	257	232	241	269	295	246	254	269	233	295	249	227	223	219	157	219	227	165	157	279	279	267	149	245	262	234	204	269	270	170	249	230	210	213	147	221	222	248	171	147	229	168	215	201	300	233	208	209	201	208	267	232	194	206	188	215	150	203	186	111	168	160	173	274	176	195	168	210	206	135	255	237	167	131	179	185	202	191	166	209	133	147	168	151	163	181	133	135	128	168	201	164	149	180	160	277	190	214	259	192	250	171	200	245	164	136	226	199	203	295	159	222	220	155	147	201	188	134	189	233	187	146	148	182	173	134	209	148	132	164	97	162	210	85	157	134	232	176	214	183	95	186	150	195	252	115	151	247	150	148	198	156	273	253	183	139	177	169	128	198	122	137	214	136	150	134	187	82	123	123	173	133	151	220	215	150	180	153	136	197	196	115	113	197	161	88	148	116	217	151	167	221	103	166	147	127	158	200	112	131	112	154	208	136	96	156	136	128	160	127	232	84	126	279	97	167	117	147	249	141	194	149	137	157	129	172	266	164	129	143	168	189	126	203	138	107	140	159	137	139	104	153	162	164	111	121	201	166	70	136	196	132	155	121	137	116	62	150	129	159	184	264	99	140	142	72	230	151	150	140	201	102	171	85	148	126	114	110	148	168	136	145	150	105	80	138	101	118	208	108	98	100	99	130	144	57	113	108	113	189	81	108	89	109	105	70	154	103	155	110	120	106	84	107	92	75	106	127	116	216	122	87	159	127	124	96	145	189	106	141	135	119	233	117	76	174	97	100	101	133	103	198	137	123	127	136	134	99	122	100	89	89	170	80	101	85	99	111	150	130	86	97	83	130	142	99	115	170	88	129	136	93	149	157	124	62	63	108	125	72	114	128	89	123	83	137	78	177	97	128	132	150	106	79	112	142	154	111	84	120	106	131	76	133	93	90	165	122	98	126	84	74	135	97	91	104	97	105	108	102	69	92	189	117	130	182	112	99	83	126	70	95	108	99	70	77	65	137	63	131	73	134	75	109	147	105	75	114	57	111	109	106	114	85	87	101	86	99	90	83	116	114	76	82	96	101	140	90	109	59	81	73	86	91	89	125	84	92	91	135	80	78	147	42	75	81	105	60	99	115	47	70	137	80	102	107	106	98	86	109	186	70	93	74	110	86	74	80	99	101	110	88	54	113	67	146	65	88	95	75	94	95	146	64	69	103	102	97	86	128	79	90	36	128	151	56	87	65	93	90	99	87	43	70	177	63	105	129	112	105	126	91	95	83	75	131	67	66	53	105	86	43	71	132	79	38	62	87	69	157	42	75	88	77	67	109	84	77	95	75	70	96	129	83	110	96	65	46	71	63	98	43	54	56	70	79	73	73	69	35	50	98	84	133	53	88	117	86	32	73	48	79	37	67	63	60	55	67	75	107	73	51	84	66	37	43	76	55	96	53	101	40	51	76	43	92	93	76	63	95	62	80	62	85	59	90	72	74	48	97	49	42	75	49	31	91	37	79	30	72	81	93	60	24	82	51	72	78	122	91	62	111	66	77	51	73	82	60	58	66	100	67	65	30	70	50	82	65	43	66	67	57	56	70	57	26	63	49	146	97	32	54	44	83	56	50	101	42	33	63	22	53	50	43	131	50	74	59	101	48	70	40	47	58	62	45	41	50	55	49	79	24	69	50	75	54	101	46	57	39	63	31	45	70	64	93	46	49	88	102	35	38	49	75	62	57	44	29	21	21	49	42	49	28	68	18	47	65	51	40	28	53	42	41	57	45	45	61	53	57	57	46	38	57	49	66	62	60	47	68	27	51	43	45	23	60	54	44	90	62	31	52	21	40	40	51	77	60	56	33	60	52	64	58	49	43	68	57	50	26	92	48	87	32	48	41	32	35	29	33	36	47	27	40	45	95	55	43	20	42	23	35	18	52	39	49	42	53	52	37	23	60	22	44	48	102	59	46	69	53	37	37	39	50	40	77	90	37	38	53	38	26	12	64	42	25	27	45	38	34	18	39	40	23	53	40	55	29	48	26	35	17	43	34	60	32	68	33	40	41	32	45	65	21	37	56	31	40	43	26	29	62	29	55	27	17	25	38	33	39	24	96	28	46	20	31	35	18	35	29	40	22	29	21	99	47	24	48	29	19	44	34	16	50	28	53	26	29	30	44	16	37	32	29	29	37	77	42	33	23	21	13	27	31	40	52	40	47	39	40	40	24	33	18	29	21	27	54	42	42	11	32	26	20	53	20	63	26	42	23	36	33	18	50	34	43	20	26	35	37	18	23	29	45	27	22	35	38	30	25	21	31	13	19	16	16	32	50	17	31	35	28	21	21	36	28	29	31	17	29	18	27	24	56	17	61	22	18	18	56	18	30	25	9	13	11	23	17	39	29	14	12	16	18	4	15	18	17	22	13	31	12	16	42	30	22	31	27	19	39	31	15	11	23	28	17	28	12	3	23	9	19	13	24	15	10	14	18	29	13	20	28	12	9	34	32	33	11	17	14	29	36	7	15	20	17	15	6	10	12	12	24	20	16	33	13	16	15	24	19	19	28	14	26	12	21	11	25	13	6	3	21	8	8	12	15	9	32	17	8	7	3	11	16	3	13	11	12	26	14	15	9	14	24	13	7	16	11	11	13	6	20	10	24	12	9	12	8	24	4	20	8	3	16	13	17	13	8	28	13	11	3	24	3	6	3	25	10	9	17	7	6	13	7	20	12	6	2	6	14	13	6	6	14	6	14	3	9	9	6	9	7	14	13	3	30	5	2	5	2	6	5	0	5	29	9	15	13	4	15	1	7	4	11	6	1	2	2	5	14	7	8	4	0	0	4	1	5	2	2	8	2	3	5	2	100	1	0	0	2	0	1	2	2	1	5	1	0	1	6	0	0	1	0
ne0324	5299	3095	2300	2294	1660	2736	2390	2185	2026	2252	1753	2214	2458	2436	1537	1907	2086	1470	1305	1916	1439	1598	1226	1402	1491	1269	1406	1572	1225	1455	1128	1107	1465	1716	928	1203	1524	1145	1103	913	1128	1242	644	1334	1001	1566	1557	1161	1135	1256	1531	1273	926	696	1077	1393	833	799	1057	947	1368	819	634	747	1186	1020	1467	938	1013	912	803	743	853	872	646	688	1046	1131	982	562	1170	754	1363	629	675	1265	724	1117	587	958	782	736	1294	675	686	626	1211	732	652	796	1065	617	559	1195	826	1044	763	1347	687	827	585	736	1325	1255	1244	666	1230	872	534	1190	760	1237	518	725	734	807	586	635	1230	1169	951	745	579	491	679	402	579	631	1160	742	847	919	492	639	508	887	676	509	755	692	911	667	961	637	651	499	872	592	1156	811	833	566	856	827	601	570	670	553	410	654	565	633	867	813	1123	450	667	1074	609	454	667	577	513	558	389	384	455	602	522	502	409	687	351	897	601	599	532	1084	560	761	570	491	394	644	309	670	503	691	650	561	1119	678	388	622	301	602	577	372	668	578	485	450	377	616	535	555	515	511	506	559	436	583	445	303	605	470	362	591	564	578	507	500	454	569	345	628	756	553	528	335	603	416	457	464	636	1040	382	672	404	388	424	524	364	571	562	530	529	358	384	338	529	450	649	527	580	386	377	535	461	355	228	517	430	217	399	230	367	365	315	459	531	645	382	395	617	375	593	449	507	523	369	318	454	406	480	373	587	441	455	393	348	409	366	437	259	278	466	449	412	531	514	378	448	401	516	523	453	452	417	457	402	581	511	352	529	436	525	241	441	482	334	535	435	323	509	336	409	385	318	285	432	319	376	317	400	601	366	262	241	287	409	298	385	290	255	415	358	292	534	429	372	276	442	431	404	269	311	285	597	324	196	373	373	467	329	381	437	271	370	416	318	405	349	318	360	410	224	387	200	427	380	256	409	442	427	244	291	237	526	415	446	347	331	425	317	239	360	326	359	369	338	193	333	405	458	438	343	350	210	296	338	288	231	324	386	297	253	242	348	410	369	232	267	252	255	369	259	247	332	296	262	284	264	312	253	259	303	252	191	341	397	194	184	228	250	255	181	349	283	193	138	414	237	320	438	216	386	251	176	160	289	215	404	241	270	173	340	339	345	258	198	222	242	310	242	403	243	276	336	443	240	390	267	314	347	378	149	174	371	385	234	308	309	258	330	235	297	343	341	458	271	182	207	241	319	305	242	235	249	195	228	357	303	262	236	361	239	262	184	194	213	203	233	334	187	93	273	231	227	348	154	192	286	325	276	254	266	299	304	294	269	267	233	357	279	277	227	278	161	220	280	186	200	299	250	308	171	267	270	272	232	291	290	203	292	247	248	219	183	233	254	229	270	182	311	185	260	204	336	241	226	249	214	235	254	215	209	253	226	202	197	260	212	133	189	174	206	296	186	236	204	169	209	179	264	310	188	156	202	177	204	177	200	203	193	211	238	194	202	235	154	149	214	165	252	195	170	201	178	317	235	264	294	279	262	164	200	268	240	158	240	274	199	298	180	205	217	171	205	186	178	166	199	267	246	214	176	198	227	235	244	176	145	188	96	192	290	123	210	125	251	188	224	211	104	221	188	178	286	127	201	369	152	210	203	165	314	408	236	154	123	163	186	252	160	158	189	120	160	136	177	105	149	141	159	147	223	262	208	132	176	173	122	193	179	99	113	221	192	91	141	138	206	153	224	252	77	204	155	168	226	191	96	128	185	184	254	145	136	158	98	147	219	172	261	120	94	258	99	193	104	172	271	140	213	171	142	127	178	194	273	140	138	139	172	199	135	181	128	133	122	178	147	180	152	147	185	161	119	147	217	185	108	159	178	149	163	181	160	132	68	198	147	131	184	285	123	159	201	70	250	239	195	181	240	163	172	97	191	122	134	130	158	254	148	153	157	95	85	116	125	108	238	143	135	145	205	131	168	79	152	122	127	174	96	140	105	137	126	92	221	139	155	93	135	111	70	116	80	87	103	132	151	274	143	94	124	102	150	103	122	180	151	192	144	103	269	132	96	199	125	112	110	175	156	242	203	106	131	131	151	103	132	113	65	97	170	106	85	81	68	117	158	158	109	106	98	167	173	123	121	207	90	159	117	153	207	129	134	97	93	124	126	93	109	148	100	112	105	176	60	128	120	182	162	126	128	108	95	140	154	130	107	114	85	124	94	174	116	121	159	114	111	109	92	76	160	126	93	150	113	96	123	100	72	84	200	140	96	181	94	76	112	119	84	111	133	101	65	64	65	192	54	99	105	149	59	127	153	157	76	137	88	118	114	126	124	89	93	164	118	114	104	91	144	132	70	94	103	189	130	115	124	78	75	92	114	140	82	134	85	69	98	143	102	82	175	21	88	120	92	80	108	137	68	50	115	53	80	129	106	119	87	138	190	76	66	85	131	96	89	101	131	82	108	86	69	143	72	177	87	89	84	96	60	111	133	82	65	110	86	162	128	143	91	69	70	109	177	112	72	76	111	110	115	71	83	69	183	63	93	169	113	109	154	87	122	66	75	154	89	102	31	121	114	63	78	147	77	45	71	128	44	168	24	103	97	95	62	120	101	62	106	115	82	87	136	74	121	92	58	24	77	60	121	78	56	71	67	69	62	83	58	55	67	96	87	108	66	109	158	86	23	80	46	51	22	62	57	68	58	75	56	136	84	43	98	48	49	50	100	67	116	30	127	55	54	98	61	71	83	83	79	141	82	68	102	83	48	111	79	101	49	95	46	48	75	44	38	104	68	99	36	70	91	99	33	34	68	70	105	73	120	100	77	138	43	108	62	95	91	69	50	82	102	66	59	46	43	44	88	63	54	56	72	55	84	73	93	28	68	75	140	86	53	69	39	69	47	55	86	35	42	64	68	86	53	41	132	46	62	45	140	43	50	66	68	60	46	45	26	51	45	70	97	48	90	53	52	47	81	50	56	61	68	40	58	94	43	92	54	65	97	120	36	59	59	74	39	68	50	59	27	31	35	33	41	32	59	36	119	68	67	50	23	53	47	41	95	51	64	104	62	46	51	56	52	53	52	68	55	56	54	38	46	63	40	37	28	32	66	51	111	67	30	86	32	34	105	38	105	96	47	27	44	40	96	86	64	103	72	67	65	36	107	34	91	43	56	62	37	35	33	39	38	67	47	55	40	112	70	33	62	65	44	34	18	53	50	37	51	87	77	42	51	87	18	53	52	56	53	63	67	78	37	47	31	58	35	106	121	38	47	45	61	28	12	47	46	47	59	51	35	42	40	40	53	35	42	50	37	40	68	15	49	40	75	42	32	18	208	39	40	44	44	25	112	58	23	47	40	47	30	37	42	47	47	40	35	28	45	45	48	37	29	97	35	37	22	37	31	27	33	36	47	61	23	24	83	48	43	59	27	28	58	40	11	67	30	67	31	26	27	28	37	43	28	40	45	43	85	34	40	24	26	20	34	36	37	37	47	33	38	43	31	27	34	42	38	21	84	60	52	45	15	36	38	27	44	47	57	36	20	18	25	36	18	47	74	61	8	32	36	30	7	16	31	29	31	30	34	31	30	26	12	26	22	19	22	24	15	76	33	26	24	33	29	17	36	46	44	32	10	14	21	33	25	51	12	96	16	19	12	78	10	35	34	22	12	12	23	37	6	30	18	18	29	27	10	25	15	14	19	5	36	19	18	27	29	14	57	18	12	39	32	25	11	29	30	12	15	17	5	24	22	27	22	23	10	22	15	28	31	16	25	25	15	27	41	45	21	10	17	17	33	32	3	33	36	10	32	6	22	16	14	47	13	6	40	26	15	13	9	93	8	23	19	36	12	19	7	25	6	10	18	15	12	11	10	11	16	30	17	11	7	4	12	15	6	16	5	10	29	9	6	15	20	30	13	17	8	12	9	9	11	31	11	35	6	13	11	11	18	9	14	9	5	10	10	4	9	8	21	14	9	4	40	8	7	6	28	4	9	6	7	7	8	4	9	6	8	4	10	13	8	8	2	3	10	12	2	9	8	5	7	9	5	5	3	20	6	5	2	6	7	6	6	5	7	7	4	14	5	10	3	4	10	3	12	6	3	4	2	2	2	2	5	3	2	4	3	15	0	2	9	2	1	2	0	92	1	0	1	0	0	2	0	2	2	2	1	0	3	3	1	1	0	0
ne0325	6971	5750	3056	3656	3098	3305	3432	2959	2505	2819	2204	2606	2491	2597	2426	2156	2554	1594	2170	2085	1780	2120	1682	1972	1433	1915	1597	1869	1868	1754	1583	1659	1583	1687	1753	1598	1728	1207	1306	1622	1281	1561	1159	1352	1728	1451	1499	1810	1606	1390	1708	1415	1250	1435	1713	1674	1188	1428	1333	1132	1321	1187	1262	1196	1344	1295	1348	1198	1239	1058	1071	1179	1271	961	1217	1259	1196	1104	1259	955	1259	1272	1431	1228	1120	1178	963	1195	1097	1134	1306	1178	1202	904	888	1028	1080	1021	1164	1066	1284	1304	1163	1223	968	1102	1610	1090	1223	1405	1024	1028	1158	1102	1114	1329	1282	1234	708	1059	733	1108	1025	1032	1110	957	871	876	1191	1064	1000	1019	965	777	941	870	798	864	983	778	884	1203	915	742	850	1115	946	687	933	1066	963	734	1079	1000	798	823	949	788	950	986	839	667	885	1035	853	823	789	764	856	1116	881	670	836	1031	1025	645	858	868	840	645	725	728	727	760	873	845	861	680	650	665	708	927	760	848	675	1133	862	908	620	888	727	726	702	734	698	938	733	745	753	807	920	678	740	811	879	597	675	728	873	643	795	666	726	879	716	610	911	717	672	570	675	756	661	599	735	632	633	790	861	629	678	655	772	679	524	774	790	660	648	801	641	603	639	675	653	803	575	733	628	599	1037	663	470	803	608	535	705	649	577	555	610	476	589	564	713	620	737	581	617	756	602	676	539	588	676	585	630	620	530	545	644	752	631	546	1028	598	897	518	587	563	641	530	572	496	715	603	509	479	571	537	710	458	527	516	500	573	646	417	600	630	603	603	547	590	463	833	472	548	579	577	548	745	605	748	537	583	548	592	560	553	475	592	655	502	758	512	572	590	566	450	496	502	585	494	454	613	539	511	531	436	557	453	816	480	527	551	412	412	694	552	523	402	519	432	462	486	365	606	488	470	608	613	476	665	536	481	430	501	515	388	530	643	574	353	411	443	365	403	495	446	549	690	707	519	543	339	406	512	574	520	495	414	381	615	443	431	509	512	513	505	525	426	490	573	398	459	418	479	359	451	721	438	359	503	389	433	441	436	476	422	532	405	333	361	465	429	470	303	405	688	430	359	385	365	456	348	375	332	422	409	504	354	400	382	364	426	337	377	352	385	1441	488	385	349	564	391	491	354	367	428	384	429	555	306	431	389	336	448	747	416	461	328	338	354	431	433	354	412	338	439	281	363	451	669	730	339	435	254	438	483	329	432	324	297	419	287	396	285	308	372	374	326	362	413	318	367	280	346	371	296	547	460	390	293	447	340	270	381	404	353	276	734	377	392	372	251	388	395	496	339	357	334	394	309	374	332	378	383	351	315	336	401	390	311	394	346	340	321	209	253	332	247	312	293	330	566	343	303	348	387	395	282	336	244	330	328	311	354	390	656	304	401	360	333	394	299	355	329	368	306	316	296	339	354	310	327	274	330	256	1011	377	402	413	268	260	261	363	304	358	321	250	283	310	436	529	262	258	271	373	261	216	363	292	317	244	336	320	282	345	238	276	281	299	343	313	237	327	311	321	247	354	312	281	306	340	299	274	540	285	171	304	319	246	228	285	316	285	277	310	260	260	241	230	710	303	284	221	261	285	327	280	265	213	223	295	272	264	351	248	180	265	271	380	248	255	291	401	313	337	292	312	325	224	328	226	336	321	646	310	299	281	293	273	311	347	268	418	260	237	197	260	247	254	292	300	270	267	283	259	207	227	267	224	336	222	198	296	233	174	221	281	186	236	299	247	223	102	211	239	280	271	254	248	222	238	190	347	615	161	241	218	183	211	212	236	228	195	381	181	171	223	247	281	194	210	206	240	243	282	185	256	337	276	323	323	218	210	378	209	213	232	249	232	289	363	251	180	243	184	223	214	190	155	141	336	212	229	250	250	223	177	271	344	213	286	240	209	196	238	126	308	198	212	230	200	234	248	211	198	166	282	143	197	187	163	179	188	201	199	156	184	208	468	223	214	230	223	146	219	227	226	226	238	321	234	160	210	201	228	293	239	143	242	166	272	238	240	179	201	197	212	169	223	227	166	195	201	181	169	221	164	263	166	171	192	154	205	233	187	226	194	153	149	148	184	177	234	194	191	179	191	157	149	167	189	212	381	138	170	194	191	148	138	205	154	155	208	170	201	157	204	230	138	149	204	192	188	191	146	159	154	185	167	145	183	241	217	228	166	144	144	227	151	172	186	158	207	234	149	207	165	147	202	203	151	158	116	206	192	123	199	164	167	158	216	188	198	158	162	248	136	126	157	175	178	107	166	215	250	295	197	190	164	140	207	178	172	160	141	150	228	209	192	132	146	93	192	133	198	195	116	140	152	208	170	135	123	152	128	128	163	221	166	145	145	129	181	161	159	210	162	191	136	104	197	96	145	161	209	617	231	138	156	174	124	105	157	108	164	177	154	137	120	206	115	133	178	189	126	167	142	151	212	161	147	95	213	143	237	128	211	124	220	124	127	159	160	92	194	136	152	219	181	153	145	126	182	116	157	128	121	218	141	135	137	110	180	178	140	106	181	128	115	121	174	82	235	97	140	179	188	159	265	157	156	116	157	122	96	165	170	78	139	89	155	100	118	130	173	191	141	139	129	148	86	123	116	155	153	133	82	104	133	120	102	173	147	139	113	125	115	147	225	143	128	94	126	77	110	95	101	114	110	68	97	96	105	133	176	107	140	92	124	117	160	113	85	98	94	157	98	110	101	129	150	121	116	145	144	161	164	114	144	119	126	78	148	87	199	128	106	157	150	161	93	108	136	119	138	169	98	83	113	105	129	108	119	166	101	119	98	102	210	129	87	163	102	80	90	138	158	84	165	160	119	131	78	145	120	122	114	79	141	83	78	85	94	38	115	185	121	76	93	85	151	87	76	101	99	68	136	213	90	160	89	81	62	94	80	104	78	101	82	140	214	77	82	83	111	115	140	93	96	128	122	58	89	130	117	74	82	95	68	129	145	136	116	92	116	80	117	92	122	173	151	84	88	142	99	110	146	91	87	97	91	72	84	85	131	81	162	198	95	39	83	109	63	110	73	121	47	144	118	58	95	95	92	445	104	115	115	120	173	114	92	65	65	91	63	93	236	113	114	139	117	98	81	75	78	81	152	132	53	116	42	93	83	52	78	58	98	93	67	71	59	60	77	113	96	82	107	109	66	62	68	61	111	54	100	78	101	93	72	76	75	76	53	56	106	84	75	97	50	78	64	100	79	94	69	99	114	90	84	68	111	102	61	79	100	175	80	95	87	71	69	55	117	66	114	90	84	76	106	48	62	99	108	100	111	76	48	85	62	77	78	83	85	77	137	61	42	76	65	29	65	414	135	81	219	87	80	66	83	59	48	68	88	51	101	47	66	63	63	56	108	48	52	44	76	76	59	45	77	25	71	96	61	135	60	77	72	75	58	75	71	60	46	78	41	59	79	79	49	29	76	89	60	110	43	69	83	108	55	33	53	24	65	49	67	42	82	86	87	31	53	44	34	48	56	79	50	60	27	69	64	44	66	36	50	34	45	75	63	25	81	119	72	57	47	83	65	43	25	56	43	56	49	24	114	66	50	22	56	30	57	75	60	46	92	31	43	51	45	15	64	32	34	46	45	61	33	84	23	90	113	31	32	55	64	24	70	35	33	36	52	32	31	83	30	86	49	38	29	88	58	112	92	48	29	28	26	44	39	37	45	72	42	45	28	35	39	29	37	66	60	43	37	36	41	47	37	14	36	37	48	14	50	23	36	39	29	45	22	31	35	20	68	29	62	24	20	38	48	37	27	29	28	45	27	37	35	27	34	36	17	40	33	19	10	37	21	10	19	24	31	23	23	27	36	31	21	20	22	20	34	34	34	22	36	22	31	26	32	30	38	52	35	29	28	51	35	25	16	22	18	25	15	54	22	13	22	27	18	17	21	29	22	19	19	13	31	11	35	22	25	23	14	23	33	37	19	19	18	11	20	13	7	18	15	13	13	11	38	31	15	14	425	21	97	25	16	11	12	9	14	49	15	11	61	15	24	7	28	8	24	11	21	15	10	14	11	10	14	21	8	16	4	20	2	47	16	10	5	9	9	12	5	5	19	3	26	6	14	4	15	8	3	5	6	11	7	17	7	21	91	6	3	5	4	15	2	7	2	0	6	8	2	24	0	0	2	4	1	5	5	5	3	3	6	5	7	0	0	7	0	1	1	0
ne0326	7588	6697	4124	3209	3467	3866	3359	3390	2941	3250	2773	2892	3264	3317	3210	2293	2753	2198	2247	2490	2003	2371	2372	2038	1917	2220	2111	2291	2186	2837	1799	1841	1932	1912	1934	2263	1902	1465	1748	1829	1729	1849	1252	1389	1629	1664	1682	2046	1966	1580	1905	1460	1427	1350	1714	2142	1441	1730	1790	1379	1409	1198	1401	1255	1521	1520	1588	1391	1312	1414	1443	1146	1471	980	1307	1339	1141	1352	1629	1192	1278	1476	1413	1455	1054	1386	1214	1341	1276	1578	1285	1399	1300	831	1080	1176	1227	1053	1191	1127	1495	1147	1194	1295	1098	1326	2353	1351	1306	1310	1113	1223	1301	1184	1271	1416	1462	1336	897	1244	940	1228	1318	1332	1367	1160	1051	862	1394	1224	1063	1201	921	1218	1397	1124	1036	1119	1148	899	835	1299	866	830	943	1365	1094	926	1162	1488	993	794	1510	1146	988	1020	1275	929	1108	795	1047	737	1084	1322	974	1002	1009	1140	814	1035	1245	842	879	1396	1160	835	819	1021	896	798	564	842	837	858	969	1001	973	781	855	803	683	1267	775	867	813	989	908	1063	959	1023	868	773	771	1072	790	941	845	863	1139	984	1048	1039	1038	948	833	1189	962	878	1208	755	752	734	799	1190	1158	895	1163	1121	791	728	603	904	758	682	954	906	641	931	943	697	942	1001	804	1085	567	928	1068	852	894	887	747	776	796	758	785	916	707	992	977	654	1442	765	657	1168	834	623	817	791	724	689	710	582	687	756	781	572	828	602	856	1344	629	918	728	654	720	806	820	681	525	596	710	919	607	720	1341	689	788	434	839	747	856	483	682	706	792	789	797	986	664	737	724	778	558	650	620	558	807	910	590	944	852	914	659	730	748	1002	608	539	629	668	585	831	803	704	814	704	807	610	618	650	602	754	765	500	790	663	691	752	695	462	606	596	596	491	723	792	582	522	545	547	676	636	641	629	571	689	499	511	954	680	532	415	603	478	574	579	397	737	783	599	537	731	543	704	802	467	488	482	626	466	512	980	607	556	498	533	492	613	597	521	660	574	739	634	615	445	488	610	670	535	693	473	470	657	640	461	660	654	762	535	524	516	494	749	541	461	478	578	423	564	544	526	377	655	413	502	591	459	606	545	618	530	435	451	512	502	434	341	623	651	510	414	420	484	456	387	541	367	511	537	538	309	398	377	502	470	378	321	559	436	1286	621	354	554	990	431	601	270	379	374	393	421	651	407	490	448	355	487	637	691	475	450	422	454	432	532	444	461	448	490	348	438	474	524	587	479	510	334	480	552	361	559	328	326	522	465	459	488	376	420	437	454	349	465	376	440	331	444	631	320	1009	721	454	355	574	381	343	376	534	503	296	766	334	428	438	306	390	317	809	346	318	477	473	423	690	555	499	515	456	434	305	421	476	393	386	416	455	442	291	371	396	256	408	472	368	593	241	377	443	363	342	388	392	316	485	290	339	543	465	772	249	562	436	316	445	388	434	423	441	371	368	410	421	263	363	446	338	410	291	1101	380	467	366	362	380	320	380	326	381	294	385	346	321	635	549	288	369	348	423	315	231	413	337	418	383	296	266	319	468	396	313	278	461	423	338	248	475	346	281	458	528	337	332	380	334	335	282	436	376	228	337	355	320	338	320	341	354	339	345	317	271	243	305	1051	359	277	262	364	186	510	259	356	291	338	208	396	516	329	256	232	441	322	488	232	322	342	407	531	416	343	297	351	284	512	314	329	483	730	335	368	319	526	447	353	429	391	489	255	211	244	347	354	277	277	351	373	307	370	294	248	358	248	194	306	363	232	279	272	247	244	350	215	291	334	326	375	143	200	266	262	244	283	324	221	306	284	468	703	283	270	308	237	336	304	278	237	200	419	251	219	202	265	340	259	202	272	236	268	282	281	328	392	289	330	316	228	191	448	306	184	248	314	308	369	280	335	191	271	176	309	263	191	206	182	433	195	306	352	242	251	261	230	328	310	283	314	245	241	275	157	355	249	210	222	225	371	254	189	209	315	214	221	300	367	247	220	257	228	247	181	242	260	399	272	281	126	173	251	328	199	253	250	288	345	230	239	354	267	192	285	313	143	295	245	322	255	272	214	218	250	236	259	333	320	190	260	292	216	247	301	254	389	279	261	208	187	234	205	186	322	217	303	200	184	301	184	284	170	246	223	225	187	245	214	235	319	351	119	254	173	247	185	163	202	159	241	215	296	258	209	230	282	170	164	235	237	259	303	168	171	164	245	207	200	204	422	333	213	174	182	208	216	171	186	220	188	223	242	192	245	233	169	166	189	194	172	154	234	272	185	278	174	234	167	185	192	262	255	214	203	232	137	284	181	231	165	215	211	256	331	233	262	134	172	210	247	224	169	135	138	136	259	305	169	177	107	209	168	170	253	138	173	225	253	196	234	185	110	184	169	194	260	218	133	128	146	161	198	182	295	212	169	150	161	193	134	115	187	211	691	237	176	221	231	122	160	209	151	192	222	214	215	242	222	158	178	156	147	97	214	167	243	316	189	213	120	292	153	232	169	192	114	191	142	139	225	165	165	200	164	109	231	207	195	147	239	208	155	142	219	143	259	180	135	134	103	148	229	164	177	202	151	149	152	148	117	245	132	206	183	173	150	262	180	188	210	240	193	99	176	179	113	173	141	179	126	117	105	172	156	139	219	159	154	102	112	130	224	197	131	88	140	119	127	102	157	158	112	95	184	191	175	266	171	136	117	140	121	118	90	123	97	134	119	118	134	101	155	233	150	132	121	156	147	157	165	86	55	96	171	122	134	98	145	216	142	182	172	207	209	169	146	148	151	131	107	230	117	195	176	123	199	161	212	166	131	169	176	168	161	112	135	163	128	111	107	118	327	137	165	161	119	206	140	102	193	125	101	114	159	230	101	203	113	139	137	120	194	120	146	179	129	144	106	126	141	78	71	176	174	180	94	118	144	186	120	147	118	159	80	151	164	133	200	154	195	79	117	98	128	103	83	112	113	111	75	128	102	152	131	140	101	131	122	116	87	139	154	100	127	94	122	69	173	195	125	144	112	122	125	130	92	188	212	201	104	79	176	144	96	169	151	126	119	79	110	86	105	123	92	226	112	101	57	120	133	114	119	109	143	73	144	131	54	64	136	110	506	148	127	87	140	233	121	114	81	83	140	90	80	279	80	141	141	142	126	79	97	109	79	185	169	81	235	70	128	91	84	149	75	121	124	112	75	92	93	77	127	117	80	128	186	79	129	73	68	134	90	130	98	123	75	160	81	77	74	106	86	148	101	112	141	72	89	71	110	111	83	65	79	93	97	146	83	136	138	75	69	139	159	135	124	89	93	75	52	98	63	96	94	119	81	110	43	91	112	95	128	112	71	69	87	46	90	64	72	79	84	188	99	50	140	65	75	55	484	200	89	150	75	45	101	87	53	75	58	119	92	63	42	76	82	60	61	96	57	44	51	61	93	112	49	93	73	120	144	86	154	58	57	75	131	68	69	80	52	42	70	39	114	116	91	92	35	66	118	90	72	47	96	113	257	47	54	75	41	41	54	99	65	97	60	93	49	53	78	70	58	104	83	63	62	44	91	68	36	59	58	112	43	106	95	88	33	89	55	49	51	57	135	69	35	32	59	61	47	53	63	98	50	42	56	62	53	71	98	56	56	66	34	60	66	75	37	37	46	45	72	45	54	31	68	40	44	135	36	43	55	83	27	63	57	25	44	56	51	47	108	65	102	62	45	25	104	40	120	76	38	26	37	41	49	27	35	39	59	44	42	54	57	52	34	35	75	58	51	44	76	68	43	33	24	47	55	61	35	18	26	43	34	28	23	50	39	27	31	92	22	39	23	18	37	46	39	19	35	40	38	35	64	37	11	35	57	26	44	18	16	12	19	25	10	29	29	42	20	25	11	67	34	13	32	48	34	20	46	30	37	41	27	19	74	26	25	29	57	23	42	31	83	18	33	15	27	21	34	7	69	23	13	14	37	41	18	16	32	28	33	23	13	29	22	38	44	17	33	4	43	42	52	10	33	21	22	29	15	15	13	15	10	3	21	39	44	4	18	434	45	52	29	37	22	5	9	25	81	16	19	48	15	15	8	16	21	17	13	30	15	8	11	4	18	21	29	14	5	4	14	10	72	15	8	12	13	31	16	9	5	10	6	6	20	15	17	11	9	14	6	4	11	6	17	8	28	67	4	10	1	3	4	2	9	4	9	13	22	0	3	1	0	1	7	4	10	2	1	2	4	5	2	1	0	8	2	0	0	1	0
ne0327	11265	11835	7076	9175	4207	5920	6545	4984	3999	5157	3147	4142	4238	4090	4840	3880	4087	2988	4456	4013	3460	3437	3123	4324	2742	2423	2834	3531	3665	4156	2010	3293	2856	3037	3081	3691	2988	2065	2726	3057	2786	2649	3587	2404	3118	2926	2653	3234	3510	2456	2701	2207	2168	4483	4753	2630	1707	1881	2969	2163	2577	1947	1409	2514	2114	2704	2468	1751	2076	1835	2268	1609	2250	1865	1490	1799	2079	1830	2827	1951	2121	2136	2346	2329	1301	1720	1831	1790	1719	2617	2374	2292	1788	1884	2078	1671	1684	1368	2053	1858	2297	2368	3734	1905	1922	1722	2140	1799	2180	3500	1722	2066	1820	2025	1564	2044	1833	1841	1418	1774	1965	1783	1348	2237	1869	1927	1751	1510	1693	1665	1341	1745	1240	1527	1913	724	2115	1401	1699	1777	1520	1925	1950	1418	957	1966	1472	1721	1697	2067	1442	1322	1848	1736	1886	1183	1361	1193	1500	3167	1433	1341	1389	1911	2153	1241	1361	1724	1012	2144	2180	1158	1606	2031	1434	1831	1563	1429	1055	1252	2458	1325	1236	1364	1546	1016	1569	1566	1355	1575	1733	1587	1687	1218	1270	1994	1401	1385	1844	1096	1296	1106	998	1471	800	1505	1313	1546	1373	1508	1318	1666	1512	1489	2508	1892	1147	896	1355	1203	1221	1416	1195	1538	1942	1319	1460	1800	1242	919	1646	1412	1414	982	1443	1314	785	1092	1252	1057	1515	1060	1424	1677	751	1307	1204	1240	1116	1646	1220	1044	1486	1180	1085	1163	929	1350	1315	1287	1561	1186	1187	1518	524	1152	1396	763	1111	1000	1064	942	1355	1098	1069	983	1153	1128	1324	943	784	962	853	517	581	474	1374	1137	898	1103	1079	1445	917	1279	1695	1225	1493	985	1082	1168	930	1575	990	1291	1373	930	948	1200	1274	785	781	1066	881	918	912	874	1187	824	1085	1378	1077	1378	1042	641	873	1615	1062	909	985	660	1475	1207	1168	2156	893	1162	1205	1872	944	970	929	1148	1234	2336	1010	1026	1066	1229	585	740	867	1003	953	1058	1022	973	1243	789	627	665	809	906	2348	705	1335	920	1009	950	1452	1245	997	400	982	1188	740	493	835	1134	1054	841	2465	950	1126	912	918	1104	670	809	971	718	1973	1069	1009	774	888	720	740	725	670	953	1414	1278	1056	1133	821	569	642	631	824	755	580	760	806	1069	1159	927	746	976	1039	1354	892	352	1029	1211	854	768	952	866	801	758	1223	783	607	1098	618	1207	642	700	514	715	729	579	741	939	858	662	456	777	860	929	716	731	609	829	774	641	1143	704	647	610	921	1555	635	717	600	652	606	633	763	1009	1885	875	611	882	1205	476	951	508	452	618	857	584	695	661	642	654	949	765	1159	826	530	848	318	359	532	552	778	641	779	604	398	678	755	2004	1034	654	488	618	1090	769	556	666	884	713	715	673	780	558	660	695	575	541	561	660	593	665	729	767	992	700	832	1051	692	513	703	777	687	998	600	859	763	530	518	616	280	863	607	854	804	791	716	828	743	615	902	1140	811	420	743	530	585	468	729	443	574	911	558	599	275	493	740	790	361	400	614	910	515	886	694	465	530	765	536	582	836	347	692	624	727	594	495	689	534	394	389	382	620	479	522	757	609	450	387	705	535	358	451	404	437	598	387	794	421	280	561	439	597	475	909	598	415	351	458	898	1400	519	551	674	591	598	540	702	447	595	416	567	338	583	466	508	551	419	466	507	383	364	444	817	423	433	551	367	584	464	378	524	499	834	655	349	547	473	435	433	453	668	766	687	487	607	134	238	691	831	397	435	433	650	423	654	392	633	410	371	566	652	630	218	363	247	401	633	547	480	275	518	466	677	615	355	403	466	445	616	570	543	481	583	535	591	413	802	687	414	496	433	619	314	551	487	477	464	632	351	434	424	399	593	409	345	463	245	467	356	491	190	318	443	521	579	489	406	441	469	670	438	457	341	352	334	496	377	296	561	410	397	505	491	283	253	735	450	587	605	304	210	662	464	304	633	330	576	395	429	328	421	563	331	467	323	462	623	614	388	427	386	865	593	273	343	547	637	443	248	271	433	604	583	514	249	293	496	226	379	586	442	441	335	393	515	312	531	482	374	314	538	333	416	317	392	693	440	526	271	661	427	394	220	341	546	131	412	379	479	433	386	461	390	165	350	449	427	760	388	428	355	378	498	482	219	246	441	621	313	205	317	508	279	326	275	280	331	416	375	596	241	263	480	261	287	252	314	512	445	323	281	520	445	270	449	577	516	430	549	423	267	359	272	307	384	337	232	208	358	383	368	390	211	411	488	296	427	507	347	264	273	492	500	213	346	194	303	334	370	444	314	168	427	380	245	380	304	367	577	360	281	290	374	278	170	296	397	319	327	362	408	186	441	263	343	119	316	103	273	309	326	505	369	210	351	486	234	228	482	312	209	165	320	329	223	350	201	472	392	173	259	351	285	205	240	300	246	610	280	324	222	359	325	383	351	462	225	580	279	133	518	373	254	226	411	395	300	162	155	162	415	332	445	228	263	336	396	97	309	265	393	155	139	225	442	359	353	152	135	390	289	148	288	245	474	289	235	177	169	212	422	242	242	352	161	193	183	595	317	325	288	226	272	255	392	335	351	491	390	101	209	519	212	335	442	1494	234	489	200	335	125	350	213	129	206	282	199	154	264	270	403	278	92	212	304	370	237	317	129	148	306	242	179	127	318	337	260	160	369	100	412	134	245	293	111	181	224	253	267	205	160	112	158	290	173	313	194	226	283	222	219	346	241	222	214	161	261	129	310	401	249	278	194	123	275	190	282	326	323	235	263	212	274	219	310	284	194	247	407	156	174	316	79	111	259	256	84	87	267	226	197	377	143	168	206	252	201	156	100	262	357	261	302	257	213	136	163	174	130	270	157	230	181	174	225	142	208	155	224	262	121	149	227	99	160	197	232	373	135	204	72	346	340	144	292	210	220	319	386	262	244	275	301	92	337	170	286	293	108	167	176	210	89	76	236	132	105	226	414	241	257	110	213	227	268	349	142	222	106	138	212	148	292	175	182	138	257	91	131	103	128	145	103	180	266	221	172	273	214	162	187	140	176	117	84	288	141	137	278	47	168	164	222	139	122	346	120	116	319	124	125	295	289	163	234	190	113	204	92	262	114	251	228	102	241	125	72	136	208	192	140	240	122	136	206	353	163	123	175	279	381	110	150	258	161	191	109	89	177	168	35	173	177	170	123	326	120	134	86	123	99	216	75	246	195	94	259	215	335	117	210	89	174	246	136	116	131	734	80	146	144	127	46	73	94	237	149	175	145	298	79	131	95	110	59	161	192	205	256	210	156	208	64	65	198	207	65	164	62	203	182	118	108	91	161	203	207	102	168	70	44	215	129	126	99	206	90	103	87	189	81	135	103	114	111	109	210	116	142	188	63	45	160	155	131	93	105	136	75	171	193	67	162	118	201	155	86	99	128	98	100	137	155	157	161	216	159	155	200	279	119	32	73	107	111	106	166	87	98	79	60	176	62	108	106	67	95	141	79	91	37	603	42	135	106	77	89	65	93	83	64	158	165	79	83	49	85	174	134	121	149	302	95	83	100	244	109	156	165	105	175	70	86	220	24	143	96	107	49	91	55	73	102	59	148	150	163	203	119	90	103	38	35	46	44	118	66	86	63	42	173	113	186	92	160	202	124	92	151	40	51	104	90	105	122	51	98	77	132	89	69	63	110	85	45	49	75	71	141	45	269	60	84	150	195	105	30	69	41	88	71	55	81	69	31	26	28	83	164	39	222	130	76	205	40	79	86	110	89	42	31	43	92	42	56	63	87	79	58	306	59	121	46	84	66	107	59	41	22	81	57	26	81	62	126	67	78	10	102	68	60	103	85	57	103	34	57	78	64	88	46	69	26	16	48	77	45	48	102	75	21	42	205	21	28	35	33	79	30	78	52	52	104	50	79	20	197	23	29	52	92	91	42	43	52	56	58	47	36	45	66	31	10	80	40	44	26	39	34	86	86	49	12	40	31	63	34	80	26	40	18	19	81	80	14	14	91	40	7	35	61	26	15	24	33	4	19	75	73	15	58	42	54	30	59	46	43	23	28	64	31	4	75	19	17	9	30	85	8	20	57	47	37	49	19	19	11	42	28	14	8	4	64	70	48	7	25	22	10	8	33	24	28	94	6	44	11	30	36	41	17	79	46	14	9	22	5	37	28	7	10	26	5	62	7	33	9	26	50	9	4	31	13	22	41	20	12	8	6	15	11	149	62	6	58	24	10	7	7	17	6	6	14	9	9	84	36	19	28	13	4	17	24	6	10	3	59	4	1	9	0	7	21	5	2	24	5	17	4	7	3	6	0	3	3	8	2	5	0	1	7	4	3	3	3	6	0	46	3	3	0	0	0
ne0328	10590	11663	7208	7724	5112	5026	5615	4138	3737	4501	3108	3450	3490	3555	4046	3352	3357	3126	3929	3364	3433	3376	3191	3254	2635	2371	2892	3243	3506	3651	2184	2983	2571	2440	3122	3590	2725	2073	2825	2952	2743	2751	3119	2189	2673	2498	2216	2836	2952	2368	1939	2184	2267	4070	2902	2150	1688	1857	2774	2217	2074	2231	1481	2531	2061	2614	2000	1929	2113	1857	2379	1836	2271	2003	1484	1756	2191	1666	2572	2201	1933	1999	1476	2494	1307	1357	1768	1801	2001	2445	2028	2250	1357	2006	1938	1788	1308	1504	2097	1781	1978	1943	2903	1414	2033	1517	1993	1414	1937	2002	1703	1887	1391	1599	1130	2080	1368	1565	1286	1272	1843	1323	1386	1955	1712	1796	1624	1632	1223	1221	1336	1689	1241	1337	1803	838	1862	1550	1262	1747	1614	1641	1695	1459	1167	1619	1447	1018	1376	1873	1418	1333	1405	1581	1735	1116	1227	1309	987	2832	1343	1467	1378	1814	1890	1215	1428	1807	919	1529	2131	1138	1490	1603	908	1629	1488	1010	1103	1270	2413	1246	1341	1328	1462	1247	1528	1484	1307	1423	1716	1293	1981	1170	1189	1361	1293	989	1755	1045	1311	1170	1069	1332	1064	1342	1479	1411	1312	1330	877	1453	1347	1266	2271	1604	1246	970	1160	1154	1072	1418	1332	1298	1803	1275	1383	1789	1248	984	1538	1223	1435	1059	1185	1474	842	1098	1246	1151	1424	1044	1554	1546	789	1087	896	1226	1194	1444	1087	1207	1385	1245	1008	739	1096	1278	1437	1307	1163	1144	1223	1272	709	1093	1274	714	1162	1054	1139	993	1207	1016	1069	828	1177	1069	1200	1056	807	1041	1033	568	671	527	1230	1121	979	1060	994	1370	873	1297	1442	1286	1174	1095	1033	1077	1009	1762	1065	1116	1215	877	1051	1149	1171	762	877	1126	930	851	941	793	1109	1018	1092	1101	1057	1362	1016	694	857	1136	914	1089	955	635	1370	965	1037	1084	913	1016	1226	1649	820	836	887	991	1222	1965	933	892	905	1027	682	771	891	940	940	1051	955	830	1311	969	534	880	821	817	1085	796	1230	807	798	947	1283	1089	1038	490	849	1147	718	594	894	1078	824	795	2098	940	1050	720	859	951	680	884	886	730	1802	1119	1068	874	822	702	747	808	685	778	1343	1482	919	1067	731	617	680	669	669	781	644	779	721	910	1137	920	848	799	960	1151	813	489	977	1126	876	701	852	776	804	803	890	875	695	949	644	1071	595	761	506	674	708	436	807	999	863	684	514	836	893	975	754	658	641	818	745	638	1004	775	664	604	886	1354	724	652	707	613	590	681	660	1088	1567	733	633	839	961	593	831	667	524	604	732	575	729	604	630	700	735	893	745	639	587	770	381	412	526	600	730	712	782	553	537	704	659	595	669	582	509	755	963	650	609	610	709	831	735	549	690	655	720	607	574	598	565	796	578	806	635	740	999	713	838	713	647	532	738	695	835	923	656	672	836	373	561	685	352	556	747	1054	732	692	791	741	689	602	891	1073	772	416	641	569	550	453	712	452	618	872	608	618	315	490	596	745	466	406	577	505	606	690	670	412	553	622	539	490	797	429	615	516	625	482	592	651	658	405	406	412	551	593	459	673	560	402	353	797	474	332	534	445	465	635	451	724	493	402	561	419	585	453	803	576	385	326	455	803	1152	551	544	659	580	586	500	543	473	566	435	593	433	624	452	507	509	446	661	495	437	335	542	844	445	472	601	405	531	440	386	538	476	452	637	423	502	515	422	451	464	694	714	653	569	611	237	313	554	449	376	559	416	670	482	464	402	601	480	420	501	689	588	334	328	309	435	661	470	481	316	423	487	712	450	368	395	414	374	526	556	587	484	596	447	513	382	721	524	441	464	461	616	343	567	505	440	390	496	366	364	420	406	516	390	377	331	338	477	299	476	239	312	416	445	579	469	474	513	464	617	492	612	306	417	413	362	365	327	454	394	363	479	503	362	350	830	442	571	614	344	216	440	489	381	575	293	503	459	311	363	412	610	244	490	307	428	529	556	450	398	351	701	566	306	349	505	551	390	359	355	356	522	466	422	323	276	460	234	444	510	520	362	460	380	465	370	406	480	461	334	500	319	350	383	437	661	400	415	265	605	484	357	258	419	437	193	425	373	363	426	363	446	414	233	375	427	369	345	378	458	556	577	385	492	250	333	443	529	337	213	326	471	298	305	319	325	291	364	352	506	314	264	445	314	275	255	340	497	369	256	322	521	352	318	421	476	463	451	471	374	266	328	297	307	351	310	271	190	332	440	327	294	221	362	421	298	470	528	303	350	259	538	527	285	272	201	256	260	307	431	404	268	427	289	247	361	259	478	497	368	224	265	300	290	186	193	351	374	321	369	355	209	392	223	345	227	298	123	251	257	415	498	341	181	287	410	204	193	448	289	193	224	378	379	232	289	194	367	268	188	311	338	286	232	357	312	253	466	288	265	221	322	360	322	395	349	282	728	279	127	373	299	243	226	426	456	237	183	140	226	388	296	459	169	195	283	335	126	338	287	334	197	175	216	407	346	272	158	159	350	261	188	251	226	309	249	223	207	179	201	425	267	328	374	142	201	243	449	266	296	281	235	275	214	395	179	273	520	435	125	91	488	212	356	357	462	214	375	199	297	139	342	264	176	241	277	211	183	269	241	366	223	150	266	264	382	317	300	138	190	336	212	150	166	206	194	215	197	258	122	316	183	298	248	143	222	210	218	248	204	147	184	159	258	179	344	161	286	266	226	246	277	169	279	167	147	248	110	314	354	247	226	200	129	291	166	318	392	253	245	263	206	328	180	291	304	203	281	337	166	193	292	97	132	319	315	177	104	223	249	206	327	242	187	241	295	181	187	137	242	301	310	208	276	212	117	149	213	119	235	169	223	280	261	222	175	273	165	191	201	90	168	224	105	184	254	208	342	110	182	80	171	265	163	261	169	291	302	230	263	258	320	233	135	319	184	301	123	132	135	151	217	100	90	246	188	112	234	296	209	222	133	168	228	252	279	175	183	137	158	215	164	250	167	179	153	278	107	117	163	182	183	204	182	373	190	178	231	209	162	221	213	189	174	107	295	112	117	204	64	174	143	208	163	174	305	143	130	288	165	152	210	254	153	258	178	125	143	100	292	116	205	225	133	213	121	135	170	191	200	141	247	135	177	172	293	246	115	222	259	234	114	145	191	185	157	117	125	153	228	47	178	159	237	136	293	153	92	124	102	110	245	96	264	159	147	171	173	247	162	165	80	140	145	112	75	144	611	103	169	126	94	74	116	108	246	153	204	172	157	100	185	120	118	110	143	224	136	165	222	75	175	81	105	145	146	47	126	44	201	235	127	121	133	112	181	182	104	154	66	51	206	108	107	112	176	114	130	85	186	82	184	122	134	108	113	228	124	93	206	75	45	192	153	149	87	142	109	120	209	125	107	166	117	209	150	68	68	140	158	79	181	175	138	155	218	165	169	285	246	212	51	102	161	130	90	151	80	82	109	90	170	98	88	87	51	98	138	59	112	60	510	57	106	50	186	108	57	87	90	75	138	187	66	110	60	100	168	138	108	138	268	51	64	139	197	81	176	119	116	200	88	130	55	52	130	100	89	65	105	120	64	120	51	151	135	123	190	106	77	93	60	58	56	44	116	67	106	51	78	137	119	257	118	129	222	159	122	131	54	86	99	73	102	112	42	69	94	132	81	99	96	98	99	56	63	93	104	108	43	174	41	101	171	188	55	44	50	38	65	68	66	95	99	33	40	34	134	105	29	130	82	106	34	38	96	69	86	106	47	68	64	93	41	69	48	68	66	50	556	63	94	93	80	70	82	69	44	31	96	59	46	79	45	103	97	114	15	62	42	103	82	56	84	83	29	68	86	88	98	57	78	56	32	67	53	40	49	103	94	37	55	158	20	41	69	55	68	26	82	61	52	110	77	55	42	34	25	17	66	93	96	29	53	46	77	68	92	58	32	47	40	22	57	31	26	18	55	44	76	59	74	27	21	36	73	41	61	35	53	42	27	52	73	21	15	140	55	17	53	45	38	29	29	61	6	35	66	51	17	53	25	66	27	61	37	38	18	52	42	32	7	109	24	15	8	40	66	12	32	82	43	35	37	22	38	13	57	49	17	12	13	50	74	56	9	35	29	24	14	22	33	32	178	8	49	42	20	28	48	17	24	51	11	26	25	14	40	15	8	8	22	11	105	16	15	9	12	34	23	5	48	17	26	42	17	6	11	8	11	7	159	26	14	38	20	4	10	7	16	12	7	4	10	14	59	27	37	53	10	8	34	14	5	8	4	51	8	10	16	3	8	28	16	8	10	2	10	4	7	3	6	7	4	1	4	1	4	0	0	3	5	9	8	1	6	0	72	2	3	2	1	0
ne0329	3735	3830	2784	2322	1851	2056	1745	1615	1514	1958	1452	1492	1280	1152	1294	1177	1274	1434	1312	1251	1381	1229	1376	1164	1140	1231	1180	1082	1195	1328	915	1126	879	961	981	1097	989	1052	1160	890	1160	958	995	1078	875	754	738	793	1005	845	678	875	874	1114	878	862	959	981	936	908	724	675	674	795	762	914	704	691	897	857	1120	808	989	754	640	881	909	826	803	772	759	766	562	815	765	595	612	741	733	826	669	632	606	709	702	764	482	693	759	723	591	591	819	594	733	542	639	516	548	659	769	663	495	484	534	975	462	588	704	451	719	556	696	710	706	637	586	690	401	482	581	546	717	623	655	568	638	634	460	575	576	588	604	530	512	430	592	605	571	662	516	583	453	654	771	707	517	556	399	682	602	542	551	561	660	507	484	542	655	475	535	544	532	562	411	620	499	392	594	539	694	579	543	522	562	718	481	545	514	521	545	360	551	463	579	453	511	348	515	403	482	425	571	581	573	470	585	424	439	465	359	467	523	434	686	490	559	391	471	531	451	478	389	461	472	401	401	687	499	461	409	475	383	404	513	591	432	460	467	494	473	487	514	482	476	387	286	511	499	438	405	500	556	663	433	301	431	512	496	363	384	419	530	346	410	398	380	498	468	401	362	498	447	489	481	355	395	386	475	449	402	462	420	427	505	480	350	405	316	386	334	391	374	372	372	545	387	447	478	385	355	488	360	352	427	435	364	445	321	428	373	415	358	372	350	371	429	353	357	498	400	452	407	449	349	343	436	384	281	417	343	292	314	361	361	378	321	486	440	341	359	373	550	490	347	402	355	354	332	353	365	327	374	335	339	314	392	344	291	406	310	405	297	316	420	385	394	378	333	387	353	340	321	328	318	288	417	269	261	313	516	277	301	250	391	322	356	295	288	313	507	395	332	413	293	334	270	398	370	370	318	323	258	268	292	264	299	399	243	262	297	367	320	223	377	256	305	266	322	335	335	273	394	416	307	158	285	338	310	262	215	234	280	254	252	367	213	311	291	258	178	318	238	364	246	269	289	275	304	268	262	246	273	293	267	297	379	321	286	224	347	291	259	243	301	292	268	335	225	266	426	195	221	363	398	249	254	241	235	299	275	275	246	326	302	249	245	223	222	252	383	285	253	212	250	234	237	248	272	220	249	257	252	199	197	238	276	216	220	238	202	282	313	277	235	213	236	232	262	205	241	196	274	325	242	230	233	268	255	277	259	266	245	250	267	258	307	264	278	269	215	216	212	291	199	213	240	304	325	271	256	296	204	239	227	282	271	212	191	227	272	210	216	306	239	224	225	232	219	287	208	205	219	232	234	198	167	251	240	153	200	276	207	225	278	240	258	204	202	214	186	153	239	210	237	249	212	266	164	184	275	314	196	257	219	256	192	188	190	266	266	379	204	219	183	191	234	223	209	178	214	209	161	189	299	234	176	211	193	225	238	282	207	202	201	216	185	201	225	277	192	184	152	187	238	208	344	218	218	186	216	189	180	214	236	191	189	159	223	150	198	193	194	173	187	195	176	220	196	188	241	181	172	144	184	235	246	201	156	181	214	223	297	182	256	140	207	252	103	175	166	197	130	181	216	185	169	234	123	151	213	193	164	190	162	211	119	165	223	203	166	183	197	137	150	202	176	140	267	181	185	171	176	159	232	189	141	171	168	213	197	150	174	200	168	157	137	151	179	163	155	224	207	142	203	138	116	155	145	182	148	163	188	159	210	187	215	138	152	192	245	312	111	172	182	138	176	148	141	214	136	192	122	173	140	150	191	119	121	191	185	177	185	148	226	218	128	124	167	163	136	123	164	150	205	104	165	160	173	121	83	192	187	161	101	149	178	108	170	164	133	126	196	142	153	185	159	147	100	129	182	134	125	117	123	241	162	100	171	210	141	173	150	180	131	131	118	138	110	109	127	136	100	148	253	169	203	203	169	104	163	172	121	137	118	151	181	142	135	218	136	151	101	136	154	111	133	147	116	124	134	122	159	107	139	112	148	131	138	162	204	103	135	213	103	154	160	130	127	102	129	124	162	150	134	114	115	105	128	146	155	122	123	110	128	133	192	130	104	104	87	119	139	177	107	101	104	100	111	174	220	104	126	127	96	103	101	121	111	87	100	120	195	166	147	133	103	75	134	111	154	115	153	98	116	86	127	112	114	102	117	176	56	117	134	156	141	116	131	107	103	101	121	130	95	137	94	120	92	184	114	103	135	101	139	150	120	65	192	94	102	82	107	61	132	103	70	92	118	106	144	81	133	124	131	101	137	126	109	79	135	101	92	107	127	142	109	105	99	105	113	89	85	115	131	128	76	101	75	71	109	129	108	140	149	114	98	77	80	104	81	79	72	109	83	105	75	87	144	83	172	104	128	148	85	87	87	184	109	98	164	125	128	86	91	185	147	134	127	121	78	101	83	75	89	98	109	118	97	71	76	91	74	61	55	168	73	95	82	84	115	93	116	79	71	65	55	108	74	71	90	90	110	99	81	126	73	92	98	71	85	104	107	127	101	111	105	77	82	91	100	79	80	87	96	85	81	50	80	113	61	77	97	69	81	67	136	99	105	117	74	99	121	114	85	96	168	86	75	72	70	79	120	60	111	116	63	73	118	73	78	75	104	78	93	84	98	122	115	73	80	72	73	92	89	110	74	63	80	65	60	98	78	43	63	71	82	90	70	95	48	83	82	104	68	75	78	94	108	73	71	100	74	61	76	65	98	117	61	93	108	86	98	81	60	88	106	54	62	70	92	46	84	74	74	76	90	88	86	68	67	43	69	117	97	92	65	61	59	50	62	55	33	67	79	61	44	48	82	92	65	58	70	63	97	88	88	85	104	72	74	88	55	57	82	44	87	68	71	75	61	53	73	62	142	68	49	69	58	103	64	61	50	43	96	61	69	73	45	100	86	41	60	50	68	95	51	50	50	53	72	122	112	98	52	51	45	123	96	88	89	39	58	57	69	73	36	61	56	80	53	140	60	52	74	64	111	90	74	74	52	33	51	70	47	56	35	52	46	91	63	30	64	39	59	70	79	54	63	35	82	65	51	46	68	61	57	39	60	72	47	64	86	57	52	44	143	42	38	40	40	65	50	74	96	44	64	57	51	58	52	37	42	39	30	79	65	62	31	45	146	39	38	43	77	48	53	52	46	30	58	84	76	126	37	45	46	53	39	51	38	38	39	31	58	53	74	33	54	74	71	64	31	61	34	84	45	78	35	31	22	93	51	59	41	56	60	46	64	72	59	40	47	41	38	46	27	40	52	53	56	58	44	38	44	52	29	45	93	38	98	56	30	39	17	55	48	51	47	78	35	19	52	28	68	29	42	27	38	23	42	47	47	59	43	29	52	31	36	45	41	29	45	16	33	25	27	45	24	37	49	42	51	63	57	53	26	64	27	17	60	21	37	26	29	37	21	25	60	38	20	38	53	43	22	43	19	47	41	32	41	33	31	33	52	28	34	37	32	35	26	35	24	41	61	36	45	26	46	48	43	39	44	12	44	40	24	25	98	42	30	28	41	47	33	29	25	45	27	27	30	40	22	18	27	13	21	26	54	17	14	30	31	29	37	24	36	19	15	42	46	25	19	28	28	27	16	28	34	29	17	42	50	27	33	22	37	23	17	30	23	21	45	29	25	46	29	38	22	23	40	56	16	31	23	32	32	60	35	25	26	21	22	13	26	25	18	30	32	27	28	45	24	27	18	19	33	32	9	15	27	20	20	13	39	21	19	32	36	30	16	14	20	31	21	28	25	7	14	34	22	17	15	19	23	15	9	11	8	15	25	17	25	24	11	11	17	14	12	27	25	6	14	14	7	16	31	12	12	21	14	18	14	21	7	37	16	24	21	12	17	7	17	33	17	14	10	9	7	11	6	10	10	22	10	13	22	24	23	17	10	11	6	4	8	10	9	14	14	12	27	24	17	19	25	9	48	22	10	32	14	8	10	13	9	6	20	9	13	16	16	11	11	14	8	6	8	4	8	7	4	8	6	57	7	18	27	13	8	14	6	10	4	7	5	13	4	4	2	10	5	4	5	12	6	5	6	6	1	5	30	2	3	2	13	7	3	3	4	3	5	4	7	6	7	6	1	4	2	0	2	0	1	2	0	3	1	6	5	2	8	0	0	0	1	1	0	0
ne0330	3949	2393	2110	1942	2840	2329	1832	1880	1559	1764	1369	1378	1171	1212	884	1541	1175	1567	1846	1163	1127	1091	1257	1492	1330	931	844	1093	1062	673	712	1142	1019	939	714	809	668	962	1028	611	1011	935	844	1181	1189	688	908	942	658	810	909	895	1154	767	1370	566	754	733	818	1056	819	913	470	863	896	906	677	931	877	941	707	830	770	532	546	511	545	866	846	884	526	669	957	789	525	579	1002	683	971	719	713	492	549	566	770	820	694	848	955	874	591	786	625	609	684	660	627	491	557	901	593	806	520	489	558	820	564	437	635	656	538	627	516	740	593	354	466	719	537	551	481	701	471	388	396	424	503	493	546	413	454	484	758	510	477	445	430	513	507	527	532	610	494	569	661	455	563	690	419	567	560	500	305	422	374	574	454	401	446	743	262	529	431	318	396	390	502	415	417	509	313	325	514	625	608	352	592	395	514	477	494	429	324	390	500	767	343	371	450	530	661	570	489	486	340	530	590	504	389	447	365	277	372	610	548	344	639	330	526	423	299	526	528	486	261	319	458	387	557	700	393	435	463	336	425	255	298	391	386	411	199	396	580	209	340	506	348	550	528	346	577	397	342	301	291	337	565	385	362	477	663	331	387	348	496	423	377	420	414	319	317	341	482	421	256	262	452	300	338	361	345	389	474	325	385	208	366	377	336	374	405	367	438	368	243	467	627	354	426	263	330	265	369	405	420	353	270	236	400	373	326	323	380	312	309	315	416	157	407	335	331	379	247	201	267	567	299	360	485	294	585	236	457	286	484	348	259	220	310	412	415	364	215	213	434	299	441	244	419	413	375	431	338	220	320	348	278	344	200	425	310	304	511	334	258	305	469	197	311	343	317	432	339	455	263	218	548	271	293	262	284	274	286	222	88	212	456	260	317	373	234	179	269	116	282	262	297	384	200	368	254	159	271	286	215	402	305	275	341	242	303	370	328	202	216	354	270	227	197	437	444	281	268	325	188	156	288	331	217	234	574	218	302	322	352	359	219	244	241	156	275	363	488	342	205	203	220	339	169	230	174	233	511	197	190	342	194	261	206	264	404	266	187	402	392	304	339	176	144	203	152	274	241	156	109	275	170	286	262	157	197	154	234	212	253	245	325	228	459	110	287	255	247	200	203	173	310	276	304	222	289	228	375	426	459	165	214	274	186	344	343	150	236	356	151	118	175	111	319	327	176	229	130	305	318	160	355	222	153	408	166	139	179	293	221	297	312	271	197	125	249	232	140	277	209	207	161	164	180	242	153	153	164	283	168	76	273	185	182	125	193	128	226	246	226	350	135	259	289	212	298	251	246	258	141	462	280	227	78	167	172	327	198	201	252	233	216	221	277	159	256	171	126	149	368	175	284	319	248	286	290	263	90	159	136	229	184	267	198	130	231	206	184	152	108	256	211	142	113	227	123	155	197	74	111	147	189	199	128	205	299	215	206	126	137	192	291	275	128	146	172	75	79	189	149	195	148	158	115	225	152	413	201	176	204	144	183	431	124	251	126	190	204	217	153	71	221	91	171	153	264	108	160	428	240	199	224	184	307	126	199	140	308	179	203	98	84	137	110	248	164	155	96	181	145	175	314	157	194	271	152	170	214	186	168	155	94	128	154	110	184	69	125	124	157	145	172	122	203	61	170	109	192	148	113	172	175	143	105	129	65	132	69	175	185	269	87	147	152	118	110	133	202	140	133	155	141	111	122	115	42	109	116	137	105	171	154	209	109	118	189	225	119	125	150	127	100	59	265	194	76	141	160	131	258	193	190	60	118	144	109	131	159	128	227	204	255	160	204	223	139	158	108	201	89	214	137	85	140	90	96	226	97	127	157	146	145	164	152	141	103	69	159	459	263	93	222	184	134	125	107	118	42	216	158	132	100	183	169	92	128	164	135	42	213	154	140	132	85	140	120	56	402	205	124	65	23	102	84	111	130	214	181	48	111	101	52	111	106	177	128	119	187	78	80	335	99	66	124	64	88	76	78	85	36	51	157	58	214	106	82	134	75	62	148	54	53	94	178	104	161	75	151	107	58	124	106	109	109	104	60	405	103	290	95	153	72	108	268	73	145	118	62	54	125	66	134	110	104	160	43	55	131	141	230	72	85	40	118	123	92	100	112	169	107	81	41	94	94	50	65	105	101	126	169	112	89	117	99	68	146	53	63	163	85	83	99	24	98	135	56	103	47	88	88	182	134	110	156	138	107	91	40	46	44	183	154	103	64	37	66	88	75	82	75	125	125	78	139	48	117	84	103	81	116	195	119	109	102	80	162	108	77	44	122	82	104	54	53	144	132	93	118	45	57	70	78	86	101	50	70	66	131	68	70	192	237	59	107	70	101	110	58	75	98	86	67	100	74	101	67	67	26	39	104	73	33	61	67	113	128	46	66	72	156	41	92	113	128	120	94	111	108	71	77	55	159	118	80	122	109	61	43	126	94	68	50	143	117	52	49	68	40	80	94	106	67	32	75	48	97	129	54	80	108	135	92	68	132	91	97	97	35	85	88	60	57	60	80	137	32	91	63	26	103	612	46	50	106	54	86	81	72	61	105	57	96	83	37	40	132	72	40	178	115	118	48	74	73	79	24	62	27	80	61	73	107	47	97	43	70	146	151	64	150	43	92	102	79	121	90	93	81	61	67	91	80	29	113	49	246	47	111	76	53	28	58	34	66	107	131	74	92	22	124	70	33	54	44	77	68	49	84	44	81	37	57	44	43	21	102	48	42	58	29	91	103	24	53	40	63	136	33	159	74	187	42	41	14	75	29	54	45	100	47	73	67	45	32	48	42	78	39	80	64	106	25	152	68	42	67	39	113	73	38	67	89	92	46	41	45	65	30	29	65	43	53	76	42	29	53	45	105	85	52	76	50	82	85	70	25	71	58	65	51	89	108	35	80	33	52	54	57	22	72	40	51	113	50	74	74	143	43	34	71	88	112	41	67	49	34	38	71	63	66	59	54	60	15	30	14	51	26	116	26	44	24	41	44	26	54	56	52	103	68	47	43	38	14	41	22	39	60	72	48	98	56	60	22	51	28	52	54	68	28	46	55	69	82	90	147	62	53	33	59	21	28	45	15	84	32	51	29	21	21	69	55	32	41	15	10	23	20	30	122	62	29	41	57	40	52	37	17	30	60	49	55	85	32	57	5	22	20	14	64	41	19	29	38	64	32	15	15	36	59	36	33	103	28	14	66	33	16	38	45	36	21	33	15	47	40	21	41	9	25	32	24	9	47	64	23	56	23	19	28	19	50	26	53	8	53	51	3	42	42	81	36	24	40	23	4	29	18	49	29	22	23	41	16	44	53	43	45	30	17	41	80	3	19	39	49	31	23	30	15	41	41	14	43	22	16	18	7	34	66	10	26	21	64	26	15	33	17	6	18	34	21	57	16	17	22	20	19	7	31	33	39	36	27	19	42	10	18	23	36	19	23	24	23	42	40	45	20	22	8	60	65	31	23	36	9	15	42	20	19	51	18	32	46	2	24	40	46	33	13	28	39	44	36	65	2	54	21	24	4	7	10	17	13	18	16	12	31	35	29	30	8	13	64	26	19	24	30	15	11	26	20	15	31	35	12	19	14	18	35	17	14	26	36	22	38	21	55	4	24	23	29	16	77	39	12	6	20	25	29	16	39	39	14	23	12	25	12	45	13	13	26	28	4	21	11	28	14	15	7	20	40	15	23	13	12	9	14	9	21	11	5	34	2	20	14	10	56	19	9	18	54	14	16	16	3	5	26	27	12	11	5	9	10	25	27	52	27	15	26	15	28	65	17	19	11	10	21	52	20	24	18	6	7	11	6	7	7	8	4	19	23	20	67	1	17	14	25	5	14	10	7	1	14	19	5	4	0	16	8	20	2	10	39	1	5	6	14	7	2	9	2	4	3	0	2	12	3	18	3	2	3	14	1	14	5	7	10	11	5	41	7	2	6	1	15	4	6	11	9	1	10	2	2	3	0	3	5	33	11	3	6	3	4	6	11	2	18	0	0	3	10	18	3	5	0	1	0	8	6	2	3	5	1	3	1	0	1	2	0	2	1	6	2	9	13	2	0	2	6	3	0	1	2	1	7	2	1	0	3	0	48	1	0	1	0	0	0	3	0	0	0	11	0	0	4	0	0	0	0	0	0	0
ne0331	2733	2773	1755	1430	1333	1333	1363	1117	1047	1196	960	1022	949	904	955	972	976	861	847	852	847	755	826	919	824	765	859	901	714	904	669	793	749	644	776	676	724	700	644	724	676	628	510	659	630	590	603	742	756	619	572	602	607	564	510	759	541	591	559	619	467	567	508	578	519	552	556	592	579	518	552	566	575	560	519	646	568	463	585	545	544	487	431	479	466	443	414	505	423	536	482	553	422	499	496	526	377	332	577	499	446	459	488	404	520	459	489	391	453	379	414	492	429	384	365	534	404	459	370	407	453	406	434	486	404	410	397	395	368	371	373	495	367	454	326	293	405	373	322	361	406	501	416	375	374	444	396	319	349	418	363	347	475	437	396	317	390	392	327	444	371	394	352	398	460	385	379	419	274	398	438	357	343	346	295	409	394	303	319	412	307	328	382	382	373	335	370	335	322	321	371	396	274	315	292	338	295	297	369	327	294	286	241	339	303	397	330	367	483	342	277	328	287	379	422	316	307	315	325	316	378	359	336	355	356	337	376	381	276	310	251	333	349	260	311	373	283	346	375	302	313	320	326	273	271	321	293	269	252	308	335	249	326	256	304	240	288	305	252	313	294	282	335	343	220	293	280	284	357	271	338	323	290	315	266	263	264	253	332	258	362	263	277	295	205	161	386	305	237	285	320	319	296	261	219	241	276	295	283	303	290	344	223	304	285	262	230	298	323	278	222	246	294	253	258	229	259	241	298	290	263	357	280	209	214	223	255	239	261	167	182	262	250	286	273	249	269	259	246	325	250	239	308	264	265	280	249	262	194	278	265	230	229	238	216	268	272	226	188	221	244	206	169	194	212	207	231	247	281	227	193	194	274	207	248	203	280	238	210	231	201	218	259	233	291	209	207	232	225	223	237	146	230	183	242	212	230	174	178	229	263	151	221	261	253	229	211	193	208	260	201	228	193	258	214	232	198	232	200	196	203	173	173	315	229	167	229	187	165	204	235	275	162	220	222	267	180	149	206	215	220	149	201	200	199	209	133	249	226	160	208	194	166	221	190	197	247	187	138	220	165	149	158	189	178	204	233	251	190	159	199	233	176	203	152	199	177	184	141	120	143	172	173	154	212	149	238	205	214	218	138	166	151	131	141	203	209	179	183	212	163	163	199	132	184	175	140	142	208	213	202	206	179	127	196	205	196	120	150	198	176	163	169	183	132	152	141	164	169	224	176	221	133	146	156	199	132	208	142	136	151	135	161	157	127	108	181	150	147	163	128	148	196	175	179	143	189	138	116	188	137	169	131	134	158	189	144	160	132	125	191	203	113	122	184	157	156	171	144	159	177	157	177	134	170	129	182	156	148	163	129	198	151	130	105	97	157	124	181	160	139	155	122	144	151	131	144	164	136	83	143	181	137	115	156	140	97	168	132	140	130	156	168	139	129	104	181	151	131	178	151	139	132	149	125	136	130	125	102	120	134	60	145	149	94	113	190	133	123	125	129	113	144	102	115	146	134	120	135	82	122	161	144	116	140	135	134	133	196	142	38	121	100	148	125	123	149	138	158	151	132	119	106	138	120	111	85	63	149	119	103	128	87	124	112	103	154	110	120	142	92	155	100	113	131	108	132	88	111	101	126	127	139	99	138	107	126	133	94	131	103	135	155	127	120	146	120	125	124	77	183	112	112	134	90	81	96	119	94	109	98	79	129	113	124	78	85	113	98	96	96	131	151	118	113	87	107	140	80	89	125	131	145	128	112	80	79	95	102	123	94	110	148	99	147	117	144	90	122	100	130	100	160	106	96	93	95	118	90	107	136	122	121	103	75	86	83	134	110	92	102	92	132	102	123	97	85	120	91	141	137	97	103	77	124	114	107	138	117	131	125	78	87	78	64	129	114	90	101	97	41	92	122	64	90	81	95	94	92	89	90	95	96	93	136	112	88	94	98	93	69	77	76	80	116	114	148	89	81	73	122	65	80	129	86	107	99	104	92	93	85	90	63	119	86	57	96	117	74	72	90	97	103	117	64	99	62	86	69	84	84	79	77	90	91	95	114	99	100	99	92	88	121	118	99	96	95	85	71	89	71	94	69	79	61	73	94	98	101	76	100	74	79	76	68	84	80	101	80	76	49	62	71	86	69	54	83	102	69	78	59	78	46	88	123	64	105	106	98	88	89	63	85	110	91	80	57	59	96	53	70	126	56	87	68	85	84	77	73	62	91	85	60	55	75	68	81	70	64	97	109	96	58	59	60	116	87	56	100	71	70	54	64	44	82	82	80	70	71	75	71	64	69	61	81	71	84	67	41	83	73	67	85	56	74	76	42	65	84	99	63	89	78	54	62	111	103	90	101	53	57	75	93	80	63	65	58	106	92	106	55	80	45	64	59	42	73	56	78	108	46	47	118	73	75	42	106	47	58	77	89	43	86	80	78	95	55	57	66	54	71	59	111	46	61	80	54	57	64	78	53	45	40	49	59	71	39	67	61	30	67	56	61	62	89	55	43	49	69	35	77	51	63	83	67	68	64	83	52	67	63	41	41	69	74	59	66	52	45	82	67	68	56	53	93	52	51	56	72	80	57	74	50	39	56	85	60	44	51	69	48	27	37	86	56	53	97	53	51	51	53	57	74	41	82	50	59	84	47	89	65	63	47	28	50	56	77	37	48	85	64	55	46	69	70	46	53	47	27	39	98	62	77	52	57	23	44	43	41	90	53	50	57	79	66	71	52	103	36	62	93	54	39	36	45	53	40	45	24	72	39	91	33	44	45	64	28	33	40	87	45	43	63	22	38	56	41	63	52	45	43	64	58	64	37	73	44	29	68	32	65	32	63	64	34	42	48	34	22	59	60	33	37	46	48	60	67	46	32	22	62	56	60	48	16	17	70	46	59	39	47	46	54	37	31	36	63	62	38	37	66	30	40	61	37	36	55	61	35	44	79	49	35	24	56	32	69	70	45	61	40	62	48	40	46	28	55	49	50	43	47	13	20	25	57	42	29	18	49	50	36	64	52	47	29	34	47	49	51	62	32	58	31	32	39	36	47	36	21	52	24	45	38	43	38	23	37	34	15	27	49	26	68	87	32	38	12	46	31	37	59	41	28	30	49	50	46	48	44	40	52	32	23	34	34	25	39	54	51	53	31	23	48	29	25	41	40	26	40	31	88	22	20	25	64	50	25	32	38	37	32	53	43	20	35	32	46	52	29	30	38	43	27	23	35	23	26	27	52	20	54	31	31	31	39	22	9	40	40	47	30	38	47	46	30	27	32	34	17	27	22	41	17	26	32	28	20	34	13	28	10	38	31	38	35	13	26	15	24	20	17	33	23	15	36	25	35	24	35	27	51	44	36	35	33	32	23	23	13	22	31	29	40	16	34	20	25	19	27	25	18	24	19	17	13	32	23	8	19	24	28	19	33	10	13	34	28	25	17	29	27	27	26	26	25	33	20	27	24	40	17	24	33	29	9	21	41	22	39	20	21	24	32	24	12	41	18	26	9	22	36	19	15	17	44	14	21	18	52	27	38	6	12	37	6	20	10	31	10	12	21	32	16	20	17	13	23	36	19	44	18	34	21	14	8	30	21	16	19	18	19	22	13	25	21	27	20	14	22	31	28	15	2	20	17	21	21	24	21	11	10	17	35	14	19	58	17	11	20	17	14	13	21	6	22	13	4	27	5	20	25	23	22	12	17	12	16	21	5	11	4	11	7	7	12	15	22	10	17	14	17	14	22	19	22	6	28	10	8	21	7	9	15	30	24	11	13	2	10	9	21	16	16	6	31	17	11	3	10	7	5	11	7	1	12	8	5	4	7	6	1	7	11	21	10	7	7	20	7	15	11	14	13	8	13	9	4	5	2	2	16	13	24	2	10	10	17	15	16	3	7	6	10	12	10	13	5	13	5	12	2	7	4	3	6	11	3	6	9	4	3	5	7	10	4	5	11	5	1	4	8	5	6	5	8	5	10	5	7	4	2	2	3	12	9	3	3	4	5	11	9	1	5	3	0	2	15	2	7	4	3	12	2	5	7	3	7	1	4	5	3	8	4	2	3	3	5	7	11	13	2	5	1	1	2	4	0	0	0	0	0	1	1	1	1	2	2	4	4	0	1	0	2	2	0	1	0	0	0	2	0	2	1	1	0	0	0	0
ne0332	1765	1126	985	271	608	494	453	308	418	672	424	440	373	451	443	355	318	430	358	332	336	403	343	314	425	348	418	477	411	418	376	393	411	332	435	402	431	252	419	192	434	402	168	344	199	141	233	409	445	356	157	296	231	184	293	282	212	196	520	255	203	273	207	156	287	391	188	220	341	263	397	215	309	154	198	155	249	297	459	288	333	423	104	205	193	196	283	274	235	430	150	231	104	267	244	186	99	173	192	148	250	187	109	108	238	234	220	184	191	241	209	289	176	121	99	174	112	226	175	97	171	107	154	320	295	181	305	145	101	132	216	261	178	258	242	138	175	226	84	179	169	209	101	167	189	177	219	147	289	244	198	202	191	223	178	133	188	128	83	68	171	219	249	210	191	164	230	182	128	91	254	180	210	118	73	199	148	82	160	194	66	143	148	80	160	145	139	215	201	152	76	178	60	173	154	75	143	88	202	144	140	132	142	206	78	180	200	197	236	285	73	177	128	203	181	178	183	134	184	128	120	129	189	268	140	119	155	224	254	195	154	299	139	88	157	183	105	151	101	169	97	100	132	85	72	146	122	157	190	139	170	93	145	122	156	59	144	184	169	124	124	117	196	132	97	216	181	69	205	157	177	152	102	154	98	142	108	125	168	189	153	159	132	72	89	67	159	152	150	142	118	155	132	163	62	139	73	82	173	167	140	101	151	90	253	87	120	199	89	125	69	138	132	71	168	42	227	66	135	130	181	244	179	49	54	54	153	159	131	52	79	157	135	71	79	221	141	54	94	95	169	236	137	72	175	140	275	96	80	126	128	86	81	78	118	95	105	87	59	125	112	97	29	91	128	69	137	108	106	215	93	80	136	117	146	58	64	71	115	111	42	121	116	177	74	99	91	129	158	144	73	39	74	57	100	140	122	142	54	105	122	30	139	119	85	61	90	82	83	89	109	118	119	148	60	37	102	98	156	93	99	72	121	112	108	44	125	121	74	84	49	86	106	115	119	189	81	84	102	132	61	52	172	190	117	122	77	58	104	40	74	80	67	111	71	99	108	124	79	177	60	128	53	83	73	66	79	91	94	49	32	90	74	146	20	91	94	93	61	44	59	81	100	89	80	111	73	53	39	75	44	123	102	63	60	95	61	82	71	121	113	62	97	7	20	81	49	233	75	119	46	83	100	79	102	79	107	54	135	73	104	70	63	75	74	106	83	94	85	39	99	87	105	86	56	82	84	92	69	53	196	49	75	75	46	29	68	41	123	107	34	99	74	58	146	87	90	75	71	83	82	45	101	75	51	77	82	63	80	105	71	41	46	77	108	34	50	84	45	42	46	47	62	45	85	34	52	50	69	55	57	52	71	53	55	45	61	104	123	70	71	51	58	40	87	50	56	56	49	43	32	59	63	51	79	52	27	95	27	62	37	50	65	53	26	75	74	84	58	70	83	68	65	65	62	58	51	44	38	78	80	40	52	46	40	29	49	64	60	73	126	62	65	73	76	70	50	21	87	37	71	58	53	68	51	58	66	39	55	43	27	51	78	20	43	43	90	33	28	37	54	71	80	62	23	29	64	47	33	37	69	95	64	66	37	39	44	131	83	64	55	60	74	48	72	24	41	52	61	65	51	55	47	63	67	55	37	53	35	56	49	48	80	39	21	44	54	68	92	34	66	64	34	28	50	27	38	53	75	47	41	51	78	59	52	65	19	41	55	31	21	85	22	54	15	71	52	85	22	41	50	42	47	59	47	31	13	52	87	135	36	58	95	65	46	81	49	22	41	53	58	32	43	40	25	43	44	33	24	37	64	30	42	38	34	64	58	58	61	54	54	34	37	71	34	43	58	50	39	47	29	25	49	28	33	17	61	42	31	37	16	37	10	58	37	63	37	57	40	79	13	48	65	4	31	52	50	67	67	33	69	61	5	55	45	17	14	52	38	47	44	101	29	31	35	46	67	71	25	15	25	37	49	40	49	27	39	48	15	30	53	45	21	50	15	18	32	46	47	67	72	49	38	31	25	16	34	34	31	35	46	53	17	43	47	47	28	39	50	58	47	66	36	32	63	32	36	61	42	26	37	23	29	22	27	30	44	47	56	37	40	64	18	29	46	25	68	40	33	29	25	40	55	26	8	22	42	54	38	56	29	34	18	33	23	48	54	33	23	26	40	18	35	34	44	29	17	18	54	28	45	32	28	23	27	38	35	49	29	17	46	45	17	17	38	22	40	39	20	19	42	34	25	25	29	30	21	20	43	34	30	31	16	31	12	39	19	59	25	30	33	53	24	22	46	46	35	35	31	24	47	33	14	22	48	33	22	36	16	41	46	13	28	23	34	38	10	19	40	29	30	35	47	30	61	63	65	19	17	35	22	45	24	29	13	18	48	28	45	53	7	16	33	37	20	11	32	24	25	31	31	22	27	26	8	23	55	36	34	42	22	33	22	22	19	39	41	14	29	42	16	22	22	19	34	43	9	25	27	16	34	62	43	29	28	8	22	21	15	29	33	30	29	32	18	44	30	32	28	18	19	14	21	13	21	76	29	26	18	7	64	26	16	24	23	31	32	48	19	37	32	20	20	16	22	17	27	12	31	29	22	3	17	11	29	13	41	50	9	24	29	27	32	29	23	27	43	29	27	41	21	32	18	19	24	26	11	14	42	47	19	50	24	26	18	19	25	17	19	14	25	23	26	19	23	23	23	34	11	37	23	8	16	21	31	18	40	28	32	45	13	47	32	19	18	21	15	21	22	22	30	11	11	21	30	22	15	7	17	30	20	20	18	7	15	19	15	28	25	32	24	40	45	14	29	20	15	15	11	10	16	21	35	19	21	36	13	40	21	23	22	11	40	25	11	10	18	33	24	13	31	22	33	14	10	25	33	38	24	14	11	17	23	14	28	6	11	17	16	31	16	11	13	11	15	16	23	25	12	22	17	17	2	18	33	14	22	19	8	18	23	33	29	30	20	13	22	18	19	22	3	5	9	18	16	16	19	18	19	18	23	25	13	19	21	15	13	18	15	16	17	26	20	17	9	5	4	23	23	6	2	19	20	10	11	14	9	10	13	16	17	10	27	14	31	6	4	18	9	17	16	14	24	8	18	24	13	24	23	12	13	22	11	6	17	18	8	24	22	14	23	12	14	21	74	27	23	11	12	14	14	10	5	13	13	11	4	15	18	18	13	16	11	6	7	10	27	25	23	10	15	21	8	12	24	20	10	13	3	11	14	7	12	4	15	4	4	2	17	6	11	21	17	19	4	14	5	4	9	6	18	17	30	9	31	22	18	38	4	13	7	14	10	29	15	10	11	16	20	18	4	4	0	9	12	12	22	6	21	27	17	10	23	35	20	7	8	20	8	14	21	21	5	12	8	6	13	5	17	5	1	15	11	4	3	13	12	2	14	23	8	4	8	2	1	28	22	9	4	20	5	9	8	4	11	17	18	12	13	7	18	8	18	8	4	19	11	13	14	21	5	6	14	10	9	12	3	9	9	8	14	18	6	5	6	11	3	14	17	3	6	4	4	16	2	15	13	8	5	16	4	1	19	19	14	8	10	15	6	6	6	10	12	5	4	8	10	5	10	6	9	10	20	4	17	1	3	8	2	5	2	4	3	8	6	3	15	5	18	28	19	2	4	7	12	5	5	13	6	21	12	14	20	0	4	8	3	16	4	5	6	7	8	2	6	7	8	5	8	1	0	2	5	2	4	5	23	4	6	8	6	6	7	2	5	1	14	7	3	16	8	5	8	5	5	0	8	1	3	6	15	8	6	1	3	4	5	1	3	4	1	5	6	1	9	2	16	8	1	4	3	3	10	3	3	5	3	3	9	12	11	4	1	7	10	5	2	0	2	10	3	9	4	1	6	0	14	10	6	1	0	9	5	1	6	4	1	9	0	0	4	2	7	4	0	5	2	4	8	1	0	4	4	8	0	0	2	1	2	1	5	1	3	1	6	0	4	0	1	0	0	1	2	0	1	0	2	2	0	0	7	2	2	4	0	1	1	0	4	0	3	0	1	1	3	2	1	2	0	0	2	2	0	2	0	1	5	0	4	0	1	1	2	2	2	2	3	2	5	1	0	0	0	4	2	3	0	1	0	0	1	0	1	0	0	3	0	0	0	1	0	0	0	2	0	0	0	0
ne0333	217	538	229	186	360	98	110	77	157	103	240	70	88	58	86	159	58	128	136	73	96	90	176	54	108	94	123	84	103	93	117	91	62	57	100	92	51	155	94	100	68	60	159	49	49	30	51	71	94	99	21	68	119	56	56	84	150	98	80	100	57	69	177	127	77	55	51	70	57	104	67	123	120	77	147	192	27	120	65	104	38	92	28	78	153	32	76	78	97	60	47	61	21	55	110	131	38	51	80	45	37	70	46	31	41	29	52	25	22	30	54	80	25	25	16	51	11	61	86	14	55	18	73	52	84	39	48	89	10	30	42	51	62	92	54	105	117	72	23	47	22	33	47	51	109	45	38	95	40	41	33	41	26	31	40	95	22	108	13	16	48	102	38	26	48	49	46	33	75	23	43	52	40	34	12	39	45	23	54	82	25	50	46	14	87	87	63	48	64	68	36	28	51	35	64	22	23	14	22	22	49	60	67	33	71	23	40	30	68	55	8	47	83	18	50	40	30	79	36	53	102	37	58	27	38	34	33	41	45	21	84	27	45	73	35	43	88	59	56	18	19	59	58	37	81	33	32	37	22	57	35	50	44	93	31	7	41	21	46	56	41	38	34	24	96	31	27	49	64	41	36	13	19	33	20	29	44	28	32	54	73	40	61	81	48	80	39	23	99	39	31	19	52	33	17	20	33	12	30	22	45	21	32	21	24	66	35	30	19	82	67	23	51	56	79	59	24	34	12	31	45	40	24	68	21	28	25	70	36	100	26	20	36	14	27	27	24	34	17	16	35	22	26	21	17	52	35	30	46	88	27	33	35	35	44	22	21	64	71	53	21	60	8	50	48	37	35	44	34	21	54	73	40	24	19	48	18	20	31	18	15	35	17	15	36	32	35	59	16	36	41	25	13	27	26	21	59	12	46	26	45	20	15	24	22	49	56	39	15	39	42	55	39	12	54	11	23	39	23	12	23	43	19	16	31	17	23	25	52	31	8	39	34	27	34	21	36	47	50	20	8	53	76	27	29	23	36	25	24	18	23	24	33	21	30	43	36	48	39	43	22	23	44	36	27	28	17	22	55	42	12	3	33	22	14	37	20	51	43	30	22	30	13	35	12	29	10	8	23	38	30	29	57	15	40	19	20	38	36	16	39	17	6	4	13	27	42	40	29	15	15	32	21	54	25	30	13	28	14	14	29	27	34	44	13	17	32	21	25	17	32	28	16	26	36	28	35	21	35	30	31	41	43	42	59	47	35	15	18	30	31	37	11	22	17	26	13	29	27	9	24	14	29	55	56	18	17	17	29	30	17	16	30	28	13	5	12	7	14	15	20	13	32	29	20	5	23	18	28	17	42	18	13	33	12	35	3	16	4	18	7	31	25	17	15	46	41	26	31	13	10	21	35	36	26	51	13	7	12	25	43	23	24	24	11	15	34	26	9	22	13	22	36	9	32	30	34	23	23	21	24	25	12	19	49	11	26	15	26	21	25	32	22	21	7	20	21	8	18	22	23	14	39	18	30	17	19	18	17	11	34	58	26	6	23	12	24	34	19	18	46	15	8	28	6	4	16	22	23	58	36	22	9	30	24	8	7	18	22	17	10	28	17	7	19	9	13	18	12	27	38	14	6	6	14	16	1	25	12	9	10	33	18	26	12	25	14	10	8	11	26	37	19	12	33	40	23	6	17	57	19	16	20	16	5	13	29	10	27	14	18	14	17	22	33	20	11	21	11	23	24	6	15	21	32	27	44	9	43	27	32	30	7	12	31	10	3	22	6	21	7	11	14	16	9	34	19	1	16	19	11	11	9	19	17	11	5	8	11	45	6	28	44	19	1	23	13	12	19	15	15	6	8	17	17	2	14	17	7	6	3	12	4	12	8	12	4	21	43	19	9	32	8	31	23	17	19	17	26	15	14	22	0	12	15	10	3	35	11	22	22	26	6	13	38	22	10	19	21	11	29	19	9	19	9	20	39	9	23	36	15	10	19	2	7	22	10	9	25	15	15	8	19	6	2	13	8	17	21	11	10	16	21	15	14	10	6	14	24	7	22	24	28	4	24	29	9	6	19	12	21	7	11	10	16	7	31	11	17	10	5	9	13	16	14	16	15	23	18	4	28	11	4	18	6	14	19	4	27	15	23	9	15	3	7	12	11	11	6	6	26	20	15	11	11	17	11	18	11	32	1	14	12	8	14	12	12	15	19	13	10	19	9	2	7	10	9	14	15	3	16	11	13	12	17	10	6	24	12	2	6	3	22	15	17	17	10	9	3	14	22	4	30	14	18	13	14	6	15	14	4	7	12	17	6	17	17	15	10	7	15	13	12	38	14	18	6	6	13	9	11	24	12	5	25	8	12	6	11	21	6	12	4	3	26	17	17	16	11	10	2	10	8	18	11	43	8	25	12	15	9	15	10	4	4	8	22	18	14	1	9	12	11	7	13	8	5	18	18	11	18	8	13	6	9	3	15	2	6	6	21	27	26	17	2	9	11	14	12	15	8	7	13	3	37	23	10	29	9	7	14	13	11	5	6	29	7	11	16	6	7	23	14	6	8	7	4	9	8	2	8	9	14	10	5	12	9	6	9	14	8	13	12	3	9	8	11	12	10	27	13	11	11	18	13	4	4	1	11	2	5	20	34	23	19	30	5	4	28	13	20	22	16	10	29	4	11	8	22	7	3	10	8	13	9	13	6	15	2	8	3	9	12	4	13	9	10	2	7	9	4	20	27	3	10	15	11	15	22	23	11	2	18	2	21	7	13	9	4	11	5	10	1	5	13	25	28	7	16	6	26	16	20	5	0	9	7	12	25	3	16	7	15	21	8	9	9	9	6	16	9	20	3	4	18	16	9	2	18	11	9	20	11	7	4	11	15	9	15	6	10	8	0	10	6	9	7	10	14	17	7	3	10	19	0	4	8	24	19	8	4	10	4	11	2	14	6	3	17	12	12	8	10	8	28	17	5	11	4	10	10	5	10	19	6	24	19	16	5	13	41	2	12	13	15	4	14	18	7	8	8	10	7	7	7	5	31	12	12	4	3	6	5	1	3	11	6	14	7	22	12	4	2	23	7	7	14	11	7	2	1	8	1	7	6	12	14	9	12	15	1	0	3	6	4	9	5	4	13	10	4	15	7	11	11	11	9	14	4	3	3	2	8	4	3	6	7	5	9	6	6	6	5	4	0	2	18	10	9	5	14	5	6	11	4	6	5	5	8	3	2	6	3	2	13	3	6	0	5	5	9	4	9	2	3	8	7	6	5	4	5	6	5	6	7	10	6	10	1	10	8	15	4	3	13	5	3	2	10	10	6	11	5	0	6	5	1	7	13	8	12	8	7	10	3	3	1	8	6	3	1	14	0	13	12	3	16	5	6	1	2	5	8	2	0	2	11	0	4	10	6	5	5	1	6	5	6	4	1	5	2	9	2	6	9	12	5	5	5	2	8	4	3	1	6	6	14	2	3	17	1	0	6	8	11	5	2	10	3	1	1	15	3	5	3	9	7	3	0	3	8	0	3	12	3	4	3	13	7	8	2	1	3	3	14	2	4	6	3	8	11	0	1	4	0	8	6	2	0	3	4	6	10	19	6	3	11	2	2	1	5	12	10	0	5	10	1	0	10	4	6	10	3	7	3	3	5	1	5	4	2	8	3	9	0	1	6	1	1	8	2	10	4	1	4	5	4	2	5	3	10	3	11	7	4	2	2	3	2	3	4	2	5	4	3	1	7	3	0	1	2	9	1	4	3	2	3	3	1	4	5	3	3	4	5	1	3	3	0	4	8	0	7	29	2	0	2	2	4	0	7	0	0	8	4	0	3	0	10	0	2	0	4	2	1	6	4	2	1	4	0	0	2	2	2	2	5	2	0	3	1	7	1	1	0	4	6	6	1	3	4	1	0	0	3	3	6	1	0	2	2	2	0	5	2	1	1	2	0	2	1	0	1	1	2	1	0	1	2	0	0	2	1	0	1	0	0	2	0	0	5	1	4	7	0	4	2	1	1	1	1	1	3	7	1	2	1	3	0	3	1	0	0	1	0	0	2	0	0	0	2	1	4	1	0	2	0	0	0	1	3	0	1	1	0	2	0	3	2	0	0	0	0	0	0	0	1	0	0	0	2	0	0	0	0	0	0	0
ne0334	173	262	148	64	150	69	54	34	79	93	102	61	39	30	41	52	39	61	48	35	59	21	67	40	54	52	66	46	33	34	73	31	36	38	50	38	41	55	58	37	51	29	21	17	25	23	23	31	31	35	17	39	50	24	32	45	55	44	38	45	32	38	77	35	19	21	26	29	48	47	57	77	50	28	67	79	30	44	28	51	25	38	16	19	80	24	31	36	26	29	19	29	10	28	54	47	16	28	37	10	18	32	43	11	25	20	27	12	18	22	34	35	15	12	8	24	11	31	45	8	43	11	30	22	31	18	30	34	13	10	21	19	43	64	27	55	22	25	10	26	13	18	16	32	27	12	25	30	21	28	15	29	13	22	16	29	21	33	12	16	19	39	22	14	27	39	29	14	28	16	12	35	14	24	6	32	27	15	34	29	12	18	11	4	16	34	14	17	39	18	18	17	14	13	41	14	25	7	9	10	22	20	20	29	36	17	26	17	14	20	6	11	13	13	17	19	19	48	14	37	54	25	36	19	8	16	21	14	18	20	26	22	21	27	17	19	27	45	39	15	14	28	14	12	32	21	6	15	14	13	33	24	28	35	15	5	22	16	14	21	28	20	25	11	30	18	13	23	45	24	16	19	12	19	14	22	22	12	14	28	47	21	32	28	36	28	8	7	21	25	27	20	48	18	11	17	19	13	14	23	27	25	19	13	12	25	15	15	20	30	44	28	49	17	24	22	17	13	2	21	15	17	24	28	10	7	24	27	15	45	17	24	23	5	15	18	11	12	10	17	15	13	15	6	13	23	18	15	23	39	20	12	24	19	19	13	12	17	13	24	20	24	6	22	20	15	17	30	9	12	21	37	13	9	20	14	10	14	18	15	11	7	19	12	16	6	6	30	13	26	20	9	5	12	6	18	20	16	28	11	21	3	10	12	20	13	37	16	6	22	19	20	19	10	17	3	9	17	16	5	8	46	12	5	8	3	8	17	21	12	10	24	31	11	8	14	9	8	17	14	14	30	16	11	16	10	16	6	6	11	15	4	16	19	23	26	17	23	19	11	4	5	22	25	15	8	12	33	20	10	3	9	5	16	13	8	20	25	12	17	18	27	2	12	7	12	6	4	8	8	19	23	26	6	21	18	11	12	9	4	22	5	7	5	5	12	17	11	11	7	8	11	8	8	22	13	12	8	10	5	14	15	26	12	11	12	18	12	3	15	11	9	6	11	7	7	14	5	9	13	14	13	24	16	28	7	14	9	8	13	22	11	2	5	3	6	6	18	6	10	6	15	10	21	17	14	11	4	15	19	4	7	7	18	15	5	5	2	12	7	19	7	16	11	8	17	4	19	9	11	8	7	11	31	4	3	3	5	3	19	4	13	9	8	16	16	18	10	12	8	13	15	15	29	15	17	4	10	14	16	21	28	8	11	3	8	14	17	7	10	3	11	23	6	24	21	18	9	6	13	15	13	9	9	18	3	10	8	23	8	15	18	12	8	13	10	6	6	12	8	10	3	13	5	16	13	5	5	17	5	18	10	11	4	9	7	22	11	3	6	23	7	5	8	6	0	6	12	5	17	13	11	3	11	15	5	0	9	3	19	4	14	11	4	8	5	3	9	3	5	8	4	8	3	9	5	5	12	5	4	2	17	7	18	6	15	5	7	12	8	11	9	5	16	6	14	3	5	9	6	6	8	15	4	7	11	5	10	3	8	6	17	7	4	17	11	6	11	6	8	3	5	2	12	12	20	3	2	20	7	12	5	4	6	11	6	2	4	4	6	2	6	4	6	2	14	5	5	8	7	2	0	5	7	12	1	1	4	3	10	7	17	15	5	6	2	10	8	7	7	8	2	5	12	10	8	17	6	3	4	11	2	2	6	1	4	4	12	14	19	6	3	14	7	6	9	14	6	5	4	5	20	4	13	2	11	6	16	12	12	7	9	3	9	12	16	1	16	14	10	3	5	3	17	2	3	10	8	7	14	6	2	6	2	6	7	6	8	11	4	12	9	2	5	2	17	2	15	3	1	3	7	9	9	0	7	11	5	14	11	12	9	9	1	5	6	2	4	14	9	14	10	9	2	6	1	9	2	8	5	4	3	7	4	4	9	15	2	5	3	5	2	2	4	4	3	4	3	4	8	5	2	2	2	6	5	8	5	18	5	8	13	4	4	7	12	8	8	5	17	1	3	6	4	11	6	3	6	8	3	7	12	3	2	7	4	6	1	6	2	2	2	2	2	5	6	5	11	14	2	9	4	13	14	11	6	3	6	17	8	8	3	20	11	8	6	11	13	10	0	5	5	13	5	6	6	9	7	8	6	6	5	2	12	2	5	3	3	5	2	2	4	5	4	6	2	8	4	5	6	1	2	2	2	17	11	6	8	5	4	3	6	0	4	6	11	4	4	3	12	1	10	5	3	1	4	1	10	5	3	4	6	1	3	5	5	1	9	4	5	7	1	4	1	2	6	2	3	4	4	6	12	13	10	2	4	5	5	6	2	1	2	4	0	16	12	4	6	2	1	5	3	12	0	3	9	7	7	10	6	3	0	6	3	2	3	2	6	9	2	1	9	5	3	3	10	5	8	3	1	5	4	6	4	1	0	5	8	4	8	8	7	7	9	2	1	7	3	4	2	2	6	6	6	8	9	4	0	12	7	4	5	12	6	8	4	3	2	8	2	1	1	11	4	2	13	4	4	1	2	4	0	4	13	1	0	4	4	3	2	1	4	10	0	4	6	4	3	9	3	7	5	8	1	5	4	5	3	3	4	2	3	8	2	2	11	7	5	6	3	13	1	8	4	1	5	3	5	4	0	3	2	2	8	4	5	1	2	12	11	2	0	0	1	15	3	10	3	4	0	3	12	4	2	7	5	0	2	2	0	2	1	2	5	1	2	4	4	5	6	10	3	2	2	2	9	1	12	2	6	1	7	0	1	1	4	0	1	7	3	0	4	4	3	10	12	0	2	0	8	1	3	3	14	8	5	4	10	0	4	8	1	3	0	4	2	9	2	3	1	4	10	0	0	1	3	7	4	7	7	1	0	7	2	5	1	0	1	5	5	3	3	1	1	4	2	1	5	1	2	1	5	2	4	5	1	4	7	5	3	0	1	0	0	0	5	1	4	3	3	3	5	6	7	6	4	5	4	3	1	0	2	5	1	4	0	3	1	6	3	1	4	1	3	0	1	2	4	2	0	2	4	7	1	1	0	0	1	3	4	3	2	3	1	2	1	2	2	4	0	1	1	4	2	1	2	0	4	3	1	3	3	0	6	4	3	0	9	0	2	8	6	3	4	5	1	2	0	6	1	1	3	1	1	4	0	1	7	8	1	2	4	1	9	4	0	1	0	1	2	3	22	1	3	2	1	5	1	3	0	2	0	3	5	2	0	7	1	2	7	0	0	1	2	1	1	2	0	3	4	0	2	1	5	2	3	1	1	0	0	3	2	0	4	2	3	4	1	4	0	0	1	1	0	7	0	1	3	1	1	1	3	3	1	7	1	4	5	3	0	4	4	3	3	2	0	2	3	9	4	0	6	0	2	4	2	2	3	3	4	0	0	1	1	0	4	3	2	1	1	0	1	7	4	0	5	0	0	3	2	3	3	2	0	2	4	0	2	9	1	0	4	3	1	1	1	3	1	2	0	1	0	1	1	0	0	4	2	1	3	0	5	2	0	0	0	3	1	0	0	3	0	1	1	1	0	1	1	1	2	2	0	0	1	0	0	2	2	0	0	0	1	1	3	0	0	1	0	0	0	2	2	2	0	2	1	0	0	1	2	2	0	1	2	0	0	2	0	4	1	1	0	1	3	6	0	0	1	2	0	0	0	1	0	1	1	2	0	0	1	0	0	0	0	1	0	2	0	4	1	0	1	0	0	0	0	0	0	1	0	1	0	0	3	7	1	4	0	0	0	0	2	0	2	0	1	0	4	0	0	0	0	4	0	3	2	0	0	0	0	0	0	0	3	1	0	0	1	0	0	0	0	0	1	2	3	1	0	2	0	0	0	2	0	0	1	0	0	0	2	0	0	0	0	0	0	0	0	0	1	0	0	0	0	0	0	0	0	0	0	0	0	0	0	0	0	0	1	1	0	0	1	0	0	0	0	0	0	0	0	0	0	0	1	0	0	0	0
ne0335	1578	1572	943	529	672	906	649	794	557	637	501	676	616	644	484	544	527	475	531	647	555	532	484	356	475	301	439	514	498	470	320	416	421	377	446	423	328	365	375	338	373	358	339	289	328	395	375	371	465	371	428	355	282	281	306	340	344	407	305	280	393	204	275	356	323	338	356	219	302	377	306	287	343	274	199	427	243	347	367	319	257	382	283	268	273	282	304	341	215	278	236	357	260	297	246	249	293	178	228	246	202	280	178	279	208	277	213	264	239	209	260	221	302	277	274	293	268	261	225	335	276	268	328	328	235	213	244	285	255	277	225	275	205	247	198	165	258	213	255	197	235	233	186	193	212	244	148	188	208	259	238	186	271	242	200	150	260	194	258	175	213	212	189	191	319	146	168	219	192	150	236	189	222	244	211	219	242	222	143	229	152	151	194	229	205	197	199	210	234	221	270	205	175	184	154	160	167	244	230	159	193	241	184	195	173	172	176	215	242	196	208	176	209	257	233	167	159	190	165	190	285	120	203	187	222	167	281	174	163	180	182	184	202	136	194	164	134	181	224	141	137	235	218	166	134	194	125	159	168	205	154	142	212	135	128	187	179	149	165	186	193	135	177	178	103	168	172	121	227	174	143	133	168	165	122	143	244	133	247	149	181	151	148	121	98	117	212	143	95	151	212	223	186	165	166	183	107	147	152	133	126	177	127	196	148	104	112	132	218	160	150	149	171	102	156	158	158	117	134	168	118	160	149	66	119	134	182	129	158	81	139	163	174	88	105	138	124	116	77	160	163	139	158	148	137	153	129	143	113	158	112	162	151	140	112	184	132	148	151	148	118	134	67	130	141	135	194	136	177	135	113	89	189	139	106	71	166	156	133	138	100	114	161	105	172	137	110	136	107	127	112	97	111	91	96	100	130	110	107	121	201	56	106	163	175	106	78	126	111	167	113	151	112	103	205	134	101	136	98	127	126	86	132	108	120	33	167	110	69	140	89	163	84	153	110	177	85	100	111	76	112	91	113	103	88	107	66	146	128	87	105	107	75	99	146	106	160	136	107	144	122	103	93	85	106	106	84	90	110	75	84	118	110	88	153	122	129	70	90	78	101	77	69	88	92	80	110	84	91	133	96	128	77	70	97	79	121	107	126	104	86	103	148	62	56	88	81	147	114	103	98	116	91	101	109	100	86	88	106	76	92	111	122	96	83	78	84	89	147	117	72	111	81	83	55	106	107	137	146	124	143	75	118	87	48	102	100	116	108	106	69	100	113	97	92	121	120	78	86	80	84	56	91	53	85	115	65	88	48	90	86	150	64	85	101	69	47	90	63	57	103	82	99	81	113	43	72	99	83	151	88	84	61	94	43	82	60	70	96	113	91	82	55	58	62	68	62	81	106	47	58	119	86	52	77	84	53	72	57	105	67	76	100	105	79	78	88	76	44	121	69	48	68	61	56	100	33	110	43	73	76	47	84	78	61	83	81	78	92	66	69	80	82	63	52	76	123	46	90	81	112	41	70	69	65	62	111	54	94	97	16	94	79	47	76	48	92	101	50	73	66	78	48	87	50	74	58	34	27	57	63	75	44	100	50	87	70	63	101	54	43	97	62	65	90	59	42	63	43	83	49	61	89	57	66	55	77	75	87	57	104	96	60	91	93	59	47	86	57	64	122	57	43	48	68	33	41	53	63	70	98	55	89	40	73	61	99	43	77	58	54	73	55	63	67	68	52	63	31	36	78	79	76	59	62	42	20	92	48	94	30	61	80	90	39	58	71	41	45	43	38	48	66	37	76	61	49	65	61	39	108	104	111	52	48	79	52	67	62	68	43	70	39	46	57	67	58	55	48	84	73	47	32	47	60	97	70	79	50	71	103	38	46	32	50	46	38	48	57	41	19	77	76	52	55	39	77	42	55	32	74	61	32	60	57	53	69	40	46	53	35	119	56	39	57	48	74	66	71	41	37	44	51	86	40	35	59	84	54	89	29	50	34	50	30	29	59	82	47	67	46	48	57	42	77	46	26	72	39	67	65	49	69	27	55	44	94	43	60	55	58	57	68	94	75	59	42	39	22	34	35	39	27	29	41	47	50	60	47	58	34	34	56	58	56	35	43	34	61	27	63	71	42	47	61	49	26	59	43	31	34	34	20	34	50	48	39	48	32	54	62	46	42	59	68	43	21	35	78	12	38	37	35	49	24	47	43	36	35	41	44	68	53	43	59	53	45	41	56	53	41	53	49	48	34	55	62	33	61	27	33	23	28	25	43	31	34	23	23	82	26	40	38	29	44	38	21	26	24	50	58	32	39	25	20	36	20	30	41	31	64	45	41	18	25	67	29	41	33	17	32	56	62	70	40	44	40	57	44	61	21	44	21	34	31	14	42	18	45	87	28	20	46	40	37	20	43	30	29	33	45	11	30	33	57	35	22	19	44	17	21	33	34	26	49	32	49	57	30	39	23	12	32	24	35	24	42	29	39	9	28	33	24	41	30	54	47	27	37	4	47	25	24	33	41	42	43	39	31	27	33	49	18	13	42	57	47	29	27	47	27	37	36	37	53	36	31	40	21	20	39	24	20	25	31	32	39	16	24	49	36	9	10	23	18	33	60	46	51	24	41	38	34	15	49	46	36	46	27	35	18	18	27	19	52	21	42	9	20	47	34	21	36	27	50	14	38	28	16	36	18	50	55	25	35	12	16	25	21	20	35	23	24	22	58	47	25	46	17	22	43	59	23	11	23	15	25	10	22	39	18	33	27	42	48	33	17	18	14	57	38	33	47	19	30	37	31	51	35	17	30	34	22	27	10	36	14	25	36	12	35	43	45	39	13	28	16	31	12	21	46	21	28	20	19	27	15	21	28	22	22	50	60	21	16	5	57	43	27	23	23	31	21	28	14	21	45	44	32	31	21	18	32	20	26	7	29	17	18	26	68	46	11	18	19	18	10	32	40	11	24	26	22	32	29	9	45	31	25	21	21	14	18	5	14	23	39	20	26	35	32	32	18	32	15	26	6	31	8	24	5	35	8	25	7	41	16	10	11	11	32	15	28	32	13	6	5	22	20	12	17	7	25	36	29	10	16	15	11	35	25	23	23	11	34	34	21	26	30	32	19	15	23	21	52	9	16	16	23	17	16	10	24	11	50	12	9	8	11	28	26	29	12	9	11	32	12	11	31	23	15	22	10	17	16	7	18	54	15	21	24	10	5	14	20	16	23	27	16	4	9	9	13	20	31	20	18	27	13	18	34	16	19	19	13	20	22	19	28	24	10	9	27	8	15	6	6	15	20	10	7	13	9	41	27	6	7	19	8	11	6	13	12	14	30	11	22	3	29	24	30	16	19	15	33	6	4	18	8	17	36	21	11	10	19	15	5	11	13	18	13	5	28	9	2	22	25	6	10	8	18	4	17	2	4	19	22	49	6	15	12	16	9	16	7	21	3	16	12	15	4	5	19	29	12	21	13	10	18	14	6	12	27	8	1	14	5	13	8	7	18	8	7	23	20	13	9	9	52	5	0	18	8	33	2	10	4	10	2	16	2	18	11	14	7	4	12	14	5	20	4	22	11	3	7	10	5	9	19	5	11	14	9	11	9	3	1	8	1	8	31	22	1	13	8	3	8	9	15	19	4	7	6	12	16	12	6	4	3	17	5	8	13	0	7	11	5	26	5	11	5	16	19	5	2	4	5	10	4	10	1	2	10	6	5	16	11	2	5	3	16	8	11	2	8	1	3	10	6	9	8	4	11	11	10	5	2	1	9	1	11	7	10	5	12	2	4	0	7	3	1	25	8	5	4	3	5	0	2	2	0	3	5	8	2	16	5	11	2	9	3	4	4	5	4	13	1	4	0	8	11	7	4	1	5	2	4	8	9	4	4	2	6	5	1	4	2	17	4	5	2	3	3	2	2	5	8	7	10	1	0	3	4	12	0	6	5	2	0	0	2	1	2	1	0	2	5	0	6	1	4	4	0	6	2	2	0	0	2	5	0	1	0	0	3	0	6	1	0	1	1	4	1	2	3	1	1	0	0	2	2	6	1	1	1	0	3	3	5	1	0	2	1	0	0	1	2	0	1	2	2	0	1	2	0	0	0	0	0	0	0	2	0	0	1	0	0	0	0	0	0	0	0	0	1	0	0	0
ne0336	2952	2466	1675	1599	1814	1770	1518	1549	1136	1184	1187	1163	1054	1001	1153	1058	1000	990	994	973	860	973	797	806	891	614	779	764	812	766	649	661	636	733	634	641	578	809	805	854	742	629	615	779	656	758	734	690	546	568	706	575	653	548	598	494	752	681	545	615	656	495	546	628	526	567	632	573	569	566	666	733	533	570	594	718	544	569	560	587	404	470	557	511	611	513	643	479	639	443	444	469	512	559	508	520	503	473	519	434	321	536	432	569	463	448	407	527	476	440	449	492	526	499	479	527	559	349	455	580	451	499	423	397	397	370	375	363	478	476	378	418	374	324	353	422	358	422	441	288	383	348	448	311	422	367	438	393	295	388	372	377	367	436	479	446	438	397	443	392	368	392	294	381	418	416	408	443	329	332	314	385	329	512	409	415	276	406	398	391	167	393	263	481	337	421	322	297	392	435	338	254	234	314	412	380	242	413	378	330	343	351	310	352	305	288	338	297	330	269	359	315	277	327	415	249	338	336	295	331	326	314	337	306	358	194	338	291	327	310	332	263	346	294	294	284	351	402	381	311	213	305	310	194	362	328	230	292	250	285	337	344	336	291	264	344	306	309	298	339	257	304	386	213	324	324	301	270	308	310	243	275	322	304	270	255	356	251	276	351	260	366	298	282	246	298	359	310	269	365	242	242	262	271	180	242	282	311	346	263	256	190	298	249	216	370	348	202	258	291	248	258	274	213	244	355	246	241	205	246	234	219	354	169	238	327	247	268	332	302	309	228	355	260	278	214	201	306	285	303	245	204	276	195	198	272	222	403	239	243	224	213	275	234	261	202	149	255	217	278	208	235	230	270	195	243	265	261	187	179	208	282	216	257	184	250	310	406	218	187	124	200	243	190	173	257	293	239	230	201	186	197	228	183	143	224	210	188	240	191	196	346	173	255	227	230	208	300	177	213	305	220	191	172	250	276	215	185	185	256	179	231	214	226	200	310	276	199	224	175	231	159	201	217	283	239	154	190	240	179	209	194	172	202	183	152	179	261	177	160	160	112	321	165	178	217	199	196	202	184	206	225	209	219	216	236	193	163	175	147	111	110	229	150	126	211	147	239	224	131	181	156	154	218	205	151	147	150	212	158	176	254	240	223	171	199	138	191	173	192	158	153	189	157	218	212	177	173	141	231	183	120	212	196	161	105	120	196	163	211	163	153	152	173	194	160	199	161	142	230	143	170	166	225	186	147	203	184	163	123	188	187	139	147	242	143	121	131	142	190	164	162	185	177	122	131	220	210	139	139	207	173	203	151	168	159	151	173	247	222	114	196	127	202	199	206	148	117	129	107	121	162	116	152	151	147	178	99	258	163	160	168	91	176	179	136	172	150	158	142	155	207	130	95	121	171	137	188	159	93	128	148	173	165	120	138	182	140	96	146	133	188	149	231	93	145	187	189	186	252	229	167	141	108	152	147	176	155	260	214	183	158	97	157	121	105	104	143	135	181	121	195	142	129	125	203	137	159	134	99	109	115	189	135	113	116	130	119	92	87	145	160	131	166	134	118	173	107	109	114	137	135	150	125	72	143	87	105	227	162	173	129	81	131	113	165	128	103	109	112	142	134	148	146	111	93	57	132	144	257	109	62	123	93	118	132	124	91	132	102	118	98	126	119	131	128	84	140	99	110	59	157	156	131	145	157	77	104	129	108	82	195	138	108	92	149	80	145	125	76	72	89	139	110	135	113	111	172	131	149	105	111	81	89	134	109	118	55	213	154	85	149	94	83	141	103	109	79	112	148	104	114	92	139	110	180	194	106	134	107	96	134	136	128	108	107	180	59	104	104	65	128	103	96	118	91	110	87	126	77	44	65	137	148	120	114	126	104	78	102	176	118	59	103	120	96	129	129	128	83	112	129	80	67	140	74	99	105	75	73	108	102	137	94	100	72	33	98	91	80	87	109	149	64	75	98	74	82	93	97	119	599	115	81	89	126	119	161	120	87	99	80	96	59	81	77	81	139	156	73	83	154	91	98	184	104	37	88	110	99	99	105	100	92	74	89	94	126	67	115	67	82	75	101	68	110	141	120	168	74	109	43	43	75	121	79	82	74	51	93	78	60	78	97	98	92	89	49	73	73	86	68	76	95	73	77	47	73	84	76	120	69	130	73	82	63	74	62	90	91	71	84	55	80	143	87	76	61	52	133	56	68	67	100	96	85	71	92	106	43	89	72	71	130	81	79	74	114	36	40	46	66	130	49	64	67	63	97	67	57	79	56	83	110	91	76	71	60	86	64	76	118	80	46	81	106	57	97	161	92	73	59	94	65	56	94	66	69	45	51	66	42	65	63	72	48	70	45	93	70	88	84	43	78	81	78	71	46	54	68	65	38	59	94	72	67	87	79	56	61	107	65	63	62	77	66	89	43	105	64	106	130	46	67	145	80	86	77	82	61	59	63	36	73	96	79	30	61	69	62	80	116	98	66	83	78	92	53	66	69	56	88	86	58	67	62	34	50	82	67	65	46	36	77	69	67	69	50	54	63	53	61	88	50	40	110	84	77	70	35	45	47	52	46	30	70	85	76	43	54	66	57	49	36	60	105	90	76	78	49	56	74	56	20	80	50	63	58	70	56	57	73	75	52	63	77	78	84	62	47	76	50	52	77	99	84	24	47	89	68	91	61	78	48	64	39	41	75	55	73	48	34	63	49	66	80	41	30	52	42	59	60	58	44	24	25	50	74	44	46	39	38	62	49	63	73	82	54	75	58	64	35	58	55	72	61	68	53	66	46	51	34	32	58	47	51	98	42	35	32	49	53	49	44	59	56	61	53	66	32	77	58	74	44	64	35	55	59	99	59	21	44	51	38	63	61	58	62	59	24	43	52	51	52	33	69	50	54	31	52	580	31	54	68	43	50	38	36	41	35	70	57	51	75	28	33	42	66	38	51	58	70	38	18	52	54	42	38	47	35	29	39	55	33	61	74	24	34	38	56	148	25	43	103	48	54	42	39	71	24	60	55	46	71	33	26	52	35	35	34	23	37	48	68	38	42	100	61	56	32	13	25	25	59	27	68	35	54	37	60	30	52	68	52	37	34	39	43	55	41	42	42	28	19	20	34	42	43	56	61	20	25	37	40	41	24	26	32	28	59	41	52	29	37	45	36	37	63	35	41	13	46	45	28	60	45	15	44	51	52	21	36	27	47	35	28	41	57	24	28	63	36	50	41	31	50	26	29	14	23	58	30	39	25	15	54	15	16	32	25	47	32	32	17	49	51	24	18	18	27	26	58	33	24	36	31	38	36	15	29	22	33	20	31	31	24	29	18	65	60	57	48	41	13	27	43	42	28	23	18	27	13	24	31	12	32	39	25	18	18	13	36	15	50	20	51	36	20	25	48	26	33	28	29	49	32	18	35	38	32	9	37	36	39	47	28	56	11	21	32	15	28	49	19	25	44	13	38	26	21	38	39	25	39	11	45	22	18	16	26	36	15	55	25	19	16	20	22	29	11	40	49	16	27	13	29	18	21	22	45	26	50	36	33	21	19	14	32	15	18	69	14	25	25	25	23	31	16	48	20	47	21	14	44	19	12	37	37	34	12	25	18	14	44	20	55	31	13	25	44	17	17	34	36	28	12	21	15	43	27	23	31	15	43	23	27	47	23	23	23	6	19	15	25	10	13	22	20	15	23	30	19	23	9	4	8	22	17	33	16	20	14	12	12	12	18	11	28	7	28	14	8	6	28	11	30	16	10	4	9	29	22	22	17	22	17	4	68	17	10	14	16	5	13	21	14	8	24	20	13	11	4	14	14	9	25	20	14	7	26	13	13	20	20	11	8	12	1	40	3	14	9	13	14	13	12	15	5	16	14	1	1	13	4	14	9	14	8	16	7	6	6	6	15	6	12	9	27	10	8	8	12	5	20	7	8	9	3	5	15	1	15	5	19	5	44	14	8	2	0	21	2	23	4	11	16	19	4	3	14	18	14	6	11	7	3	1	2	15	2	20	1	14	7	4	15	10	0	9	2	2	4	22	9	5	7	4	17	0	6	6	3	3	9	5	3	12	0	2	3	24	0	3	5	4	1	0	0	6	1	2	13	15	2	2	3	1	4	1	0	2	1	0	3	1	1	0	1	1	4	1	0	0	0	1	0	0	2
ne0337	4127	3424	2396	2336	2380	2211	1789	1969	1600	1859	1446	1494	1541	1293	1334	1277	1389	1385	1342	1256	1120	1230	1088	1155	1285	951	1207	1067	1163	1125	826	896	880	1110	738	840	905	1099	1286	1073	1065	818	811	1066	875	995	942	985	782	719	842	703	890	801	964	762	925	938	782	842	814	699	611	850	685	828	881	768	759	840	936	828	715	711	712	900	729	764	696	745	688	674	739	785	679	675	838	574	895	618	620	581	653	765	608	640	672	616	685	608	488	696	602	699	665	556	670	650	720	751	594	695	688	665	646	678	682	603	565	689	527	654	580	541	580	535	616	396	612	628	568	552	486	449	513	704	546	509	580	462	471	562	554	509	471	474	500	430	435	508	483	543	478	582	589	545	555	532	550	498	542	524	395	461	552	517	519	559	494	461	513	516	416	597	512	519	402	534	566	470	241	545	456	547	462	495	424	457	544	564	459	372	367	375	562	453	417	521	501	470	487	431	390	514	323	482	527	376	479	421	484	520	457	502	398	471	553	360	399	433	429	434	425	387	464	387	397	403	425	465	357	411	436	420	397	400	450	497	389	430	347	504	420	370	510	356	356	460	436	377	444	519	410	414	385	444	422	432	531	406	329	407	429	283	441	440	438	345	463	436	352	426	389	383	383	423	471	351	369	444	310	466	436	318	328	324	470	424	297	545	338	429	352	388	253	402	383	365	456	385	321	332	389	303	330	452	615	322	354	335	298	331	365	324	327	440	332	500	339	369	288	297	423	211	412	380	433	407	411	368	429	358	518	461	396	281	357	343	385	356	367	291	366	227	365	297	290	449	250	322	337	379	292	277	293	293	289	326	279	331	303	299	299	338	295	352	345	308	267	294	327	343	306	353	338	296	385	405	324	266	197	274	376	318	251	352	401	289	381	310	286	248	303	420	217	293	267	255	279	290	243	407	303	288	304	357	323	372	236	270	403	340	274	270	261	350	310	263	255	343	227	300	295	320	286	369	377	283	246	297	290	195	274	308	320	336	248	300	364	303	280	226	251	321	234	236	251	334	242	190	226	158	369	244	251	290	260	327	270	252	298	282	267	312	253	320	285	201	182	228	177	197	306	175	163	313	228	268	258	181	218	296	215	337	295	206	245	219	288	198	200	283	336	301	219	269	252	323	271	281	227	218	265	214	246	318	245	274	227	235	189	241	312	273	255	226	188	442	278	265	204	219	210	235	315	249	282	231	229	266	231	226	254	289	207	183	259	270	271	239	228	245	172	231	233	161	209	219	206	319	198	220	245	246	154	177	315	235	223	217	292	249	257	193	214	212	191	335	346	322	174	221	208	233	217	301	221	189	174	251	155	225	176	197	209	214	261	205	323	203	217	167	146	196	217	147	208	232	220	221	188	266	165	165	198	196	200	292	215	150	184	243	192	208	186	188	220	202	154	161	193	265	207	271	139	205	220	189	245	216	247	267	211	185	244	202	221	190	243	292	224	241	126	162	155	155	140	179	165	178	127	235	201	220	185	194	220	179	186	166	165	158	222	157	188	173	207	156	110	155	156	240	191	196	195	171	228	175	217	131	168	211	216	131	100	244	115	122	272	208	184	183	178	208	181	232	189	160	141	117	191	148	184	193	179	140	122	214	255	313	180	100	149	133	137	191	119	124	155	142	172	119	218	150	206	162	172	221	164	161	104	197	184	212	120	155	118	124	201	183	153	239	134	134	160	174	102	222	187	158	118	140	179	164	206	146	163	217	216	164	239	230	97	128	133	106	151	116	221	230	104	139	149	138	161	144	123	133	107	240	173	148	93	157	161	222	179	105	167	131	127	160	155	179	128	201	232	123	169	168	139	215	150	164	112	141	164	116	155	135	68	87	146	184	137	130	158	148	94	134	183	161	82	144	177	115	146	124	157	87	120	173	110	85	161	120	128	160	109	111	156	134	139	94	117	73	97	129	131	96	185	165	185	112	106	139	115	112	120	106	157	125	188	128	128	194	157	151	127	132	160	105	108	108	135	124	138	123	145	121	98	188	226	167	174	146	85	104	113	111	110	124	114	142	119	131	126	141	114	148	91	151	80	128	108	142	155	170	283	103	134	101	98	92	134	116	139	109	86	148	92	113	103	153	111	127	137	68	114	76	98	108	117	78	113	88	66	79	101	97	132	108	194	116	136	114	105	102	140	122	92	111	87	117	148	99	84	120	79	164	90	76	115	111	126	96	103	114	119	61	130	118	117	125	109	110	117	121	55	72	72	76	162	63	91	83	104	121	85	75	98	94	84	122	108	84	62	101	102	93	109	190	110	65	115	161	110	128	158	111	102	98	125	78	106	104	111	104	95	82	123	102	87	115	104	70	130	59	105	86	121	113	64	94	102	127	108	55	120	57	63	89	98	127	88	291	112	113	85	82	147	105	79	86	96	91	110	106	102	113	108	167	83	72	148	80	161	104	128	86	91	78	57	89	122	106	71	85	75	104	83	87	113	81	90	108	144	79	85	116	101	134	112	85	108	90	69	67	80	81	91	88	61	111	72	98	99	83	90	81	62	94	84	71	81	192	114	101	84	94	54	61	78	84	58	68	124	105	90	74	120	77	73	77	115	98	151	104	116	64	72	87	100	42	118	57	76	78	99	76	99	90	92	67	107	88	68	107	83	105	80	52	57	111	167	103	43	86	108	67	82	78	63	73	78	78	80	103	95	75	81	62	86	47	103	87	72	43	94	76	105	105	72	64	55	51	57	83	81	73	57	53	113	87	69	89	85	73	53	81	71	67	42	140	60	87	80	52	100	77	48	78	55	69	62	62	119	56	72	70	49	60	76	73	89	75	60	105	77	50	68	60	94	76	76	54	79	71	126	44	40	77	91	56	79	65	70	108	74	60	76	73	58	61	40	102	36	116	51	46	64	55	79	60	30	56	63	46	64	51	83	58	62	104	57	45	59	99	85	60	80	57	47	39	62	57	75	41	55	54	60	55	61	79	53	70	48	43	38	76	165	36	31	111	59	69	88	66	79	51	62	50	51	76	72	48	49	56	40	53	37	47	53	92	54	86	118	96	77	46	25	68	65	84	63	76	33	58	57	85	71	63	127	55	91	41	31	52	79	58	44	47	63	28	70	36	46	53	87	61	62	35	55	90	76	44	27	45	54	62	94	44	33	54	70	57	36	45	52	55	28	68	48	64	80	55	16	48	62	98	45	44	33	50	88	39	56	67	63	46	51	48	89	74	40	54	42	37	23	37	68	56	35	24	30	31	31	57	46	28	64	51	28	41	37	69	46	28	59	34	46	60	40	38	29	42	51	45	27	42	41	64	42	53	30	49	29	111	65	89	46	59	48	31	46	50	51	33	25	34	24	20	30	50	27	51	45	50	37	18	43	38	30	42	40	40	25	13	32	47	32	52	48	25	258	25	26	45	32	56	34	28	34	29	43	16	83	26	41	52	27	44	52	27	45	31	21	48	41	32	55	34	26	52	21	38	33	28	21	39	66	36	37	44	27	27	32	31	23	31	39	50	29	28	24	65	20	23	21	57	28	38	37	21	35	33	24	32	28	19	66	28	32	35	29	31	26	22	64	16	31	26	29	42	6	17	44	31	35	27	27	23	22	47	42	28	29	22	31	56	19	12	16	25	28	37	19	18	31	46	19	18	27	13	34	21	41	39	13	17	39	21	20	25	11	18	24	29	12	28	34	30	29	17	16	16	48	13	48	34	22	15	10	12	16	6	12	31	13	26	28	21	19	26	30	15	7	10	26	14	29	18	9	23	22	20	14	102	12	23	17	10	14	34	21	22	22	43	17	17	12	15	22	19	11	34	25	36	10	30	2	25	17	27	41	21	27	5	62	7	17	21	30	13	10	14	22	18	24	12	6	14	20	8	16	20	18	22	15	9	9	6	11	10	26	12	16	46	13	9	6	26	13	11	10	14	10	11	6	21	28	15	14	16	30	42	8	21	8	5	39	8	25	25	11	11	4	6	5	4	7	8	8	27	5	17	6	3	18	4	20	7	12	7	8	11	7	9	9	4	4	8	10	8	13	5	4	8	4	1	1	5	11	17	10	2	19	2	1	7	34	6	7	2	3	7	0	0	12	5	4	14	23	4	10	3	2	5	8	3	0	0	0	1	5	2	4	6	1	4	1	2	1	5	2	0	0	12
ne0338	3638	3258	2159	2241	2009	1967	1528	1673	1229	1405	1124	1339	1081	1152	976	1298	1131	1078	1548	1115	1454	1144	1001	841	1107	716	941	922	1203	1252	681	897	613	845	890	1203	714	770	1044	820	913	717	887	779	800	693	780	829	851	632	748	488	1029	670	905	658	760	749	731	1006	712	540	591	704	450	756	661	586	677	674	855	887	604	784	789	600	607	671	682	752	532	565	639	673	551	551	803	421	779	506	668	586	526	600	530	622	646	540	555	501	343	667	609	654	503	337	598	566	633	661	466	535	546	554	533	707	557	566	584	538	959	620	532	584	600	533	510	425	521	525	356	479	373	433	901	389	592	481	513	362	413	472	623	344	365	434	416	442	387	446	389	409	342	472	505	391	493	512	446	468	443	458	338	329	538	364	464	535	342	348	441	404	334	326	404	501	282	415	389	394	325	448	426	519	439	375	451	449	462	448	455	271	719	258	444	377	358	412	402	326	415	332	403	429	395	354	423	363	500	384	384	415	453	374	528	801	452	349	382	291	334	317	399	348	353	271	435	381	396	354	364	381	308	511	351	278	317	328	402	322	236	347	428	739	333	283	280	304	401	356	311	413	429	305	338	347	434	295	429	304	335	367	478	243	273	406	371	334	444	321	272	311	326	297	345	251	493	362	305	466	289	392	399	292	296	402	406	378	287	458	227	317	250	345	797	312	305	341	383	264	271	209	361	244	295	300	352	319	353	289	249	336	275	277	356	336	280	238	185	740	260	340	364	248	213	341	316	321	331	263	376	318	346	193	248	287	302	286	254	274	330	276	264	374	256	290	302	290	239	319	254	454	262	289	285	271	168	355	236	307	179	357	308	242	248	259	323	292	652	268	232	211	313	315	240	343	362	339	260	280	232	174	314	255	203	351	271	269	275	224	255	783	218	322	169	221	265	293	352	205	259	248	262	260	343	287	262	292	176	193	266	281	231	221	290	362	270	177	216	338	332	226	310	264	266	191	362	219	272	205	258	168	241	274	206	303	214	275	269	183	266	166	298	250	214	196	183	300	285	182	208	166	457	205	191	296	263	303	241	260	251	308	225	292	265	207	203	118	252	207	347	162	213	199	617	228	279	180	182	268	294	169	176	264	223	302	212	145	194	183	185	305	239	183	228	167	234	287	218	203	210	161	233	346	191	202	233	236	205	211	186	164	272	285	180	218	141	212	260	170	174	151	201	275	248	234	189	222	188	264	210	220	198	215	183	125	321	251	289	170	262	220	167	192	179	388	144	180	195	283	190	217	191	178	149	184	320	193	328	140	191	163	296	132	170	188	157	247	277	256	121	227	194	198	222	245	133	133	123	129	129	220	167	262	172	135	185	183	190	200	230	183	123	181	139	176	166	221	166	154	194	202	134	176	127	140	174	190	156	288	123	211	153	172	205	129	189	143	195	159	302	153	206	173	168	223	194	189	177	283	276	168	176	134	194	143	150	184	195	215	223	213	123	190	163	109	143	257	159	163	134	223	148	159	108	211	188	172	127	126	172	153	143	114	109	153	185	197	88	145	142	149	145	158	144	120	169	136	133	168	121	177	199	168	69	149	529	98	138	132	164	148	112	164	168	173	207	157	206	92	122	145	146	196	159	132	92	156	155	162	136	70	144	86	110	143	192	84	123	139	162	153	167	139	190	170	122	160	111	111	127	195	182	147	143	111	117	112	194	168	146	231	151	148	138	162	376	170	179	109	130	95	156	142	134	148	147	177	124	135	165	187	110	125	101	88	126	109	264	157	197	140	110	124	127	101	111	86	94	146	104	125	95	157	130	147	245	161	143	132	133	185	153	155	80	192	219	109	148	122	90	173	153	108	138	163	124	72	117	112	77	162	106	184	94	91	147	135	72	106	108	155	137	154	153	139	101	110	106	94	79	130	73	491	153	126	101	123	139	83	102	127	137	122	98	81	63	107	108	86	99	176	201	64	57	119	82	88	91	99	87	110	144	145	110	129	162	173	91	136	115	98	165	77	79	79	146	149	117	107	83	156	120	139	173	91	55	88	207	112	108	120	91	87	74	114	144	110	79	147	62	131	82	83	90	117	95	190	260	131	121	60	82	61	107	177	92	107	73	112	78	107	174	210	94	66	108	131	84	86	116	86	86	119	88	114	94	98	125	95	81	91	101	77	95	162	92	100	88	79	66	106	82	106	161	104	84	113	106	153	82	87	91	120	71	113	89	102	86	46	125	139	95	139	67	86	76	108	66	74	98	106	86	70	71	101	87	98	66	87	87	79	103	72	104	74	76	89	72	75	88	139	69	47	99	120	68	63	77	81	101	63	104	56	72	72	86	85	66	64	120	65	75	77	79	62	94	53	127	73	92	93	80	65	97	68	78	44	82	78	71	58	64	132	86	71	122	104	85	86	106	137	85	91	63	78	101	96	57	71	107	158	55	69	133	73	108	52	136	62	61	67	50	89	76	83	53	67	65	89	69	237	74	72	90	93	146	64	76	60	62	123	92	65	66	73	74	82	64	63	109	65	59	58	60	86	145	53	65	60	57	173	55	71	64	160	65	62	62	62	54	58	118	61	38	66	80	137	64	52	96	100	54	69	54	87	116	59	60	75	76	59	53	64	59	78	96	110	76	91	63	48	74	60	64	63	80	78	93	40	58	53	72	75	103	60	40	50	105	60	80	70	85	69	46	57	84	79	40	73	59	53	89	151	75	43	47	45	155	45	81	76	48	54	50	48	83	78	34	68	67	52	58	45	66	58	90	58	62	87	59	52	44	92	47	60	73	100	47	74	73	37	61	60	88	45	95	49	62	54	44	55	51	27	58	41	47	47	76	41	42	46	69	72	88	51	34	92	85	148	88	82	52	54	43	31	101	86	43	34	56	43	62	73	23	141	48	74	37	59	30	39	83	50	44	85	46	38	45	49	105	51	66	59	72	40	92	115	69	45	107	54	39	70	37	141	62	51	58	37	43	71	45	48	61	44	90	32	48	56	54	24	82	142	87	103	60	41	66	29	69	57	55	68	74	46	50	47	43	44	36	54	52	56	39	49	52	74	57	26	73	47	66	74	32	56	36	52	77	67	36	41	44	29	58	50	70	33	31	77	43	58	51	76	52	43	35	70	48	44	46	26	55	51	42	43	29	37	51	43	50	55	29	38	54	47	45	31	43	42	27	50	45	41	29	46	63	47	66	64	49	35	57	42	59	31	45	71	48	33	84	55	41	47	50	73	54	37	28	35	58	61	57	27	33	55	52	66	38	59	42	32	33	22	69	72	81	34	86	34	25	25	24	32	40	31	53	46	31	54	29	51	15	46	34	77	57	41	41	41	30	63	70	39	32	49	37	16	38	43	33	22	66	26	30	51	27	44	30	26	51	43	24	47	23	31	28	21	30	50	56	35	37	103	23	37	39	20	26	24	27	30	47	31	30	27	76	45	24	44	27	34	18	25	21	32	17	62	25	26	33	36	40	34	5	42	18	27	28	40	16	22	31	36	12	119	19	32	51	18	43	37	14	34	38	29	11	31	21	31	28	66	25	23	30	35	25	52	18	18	25	55	30	35	15	34	28	24	56	23	18	32	12	21	34	18	28	30	34	12	25	35	18	31	42	26	27	19	19	41	23	101	17	20	40	17	33	14	61	27	19	35	10	47	52	48	151	11	16	15	29	18	14	26	13	14	21	31	15	53	13	27	19	23	10	20	44	11	28	38	53	16	23	17	35	21	13	19	13	12	13	12	7	21	18	16	20	13	10	18	17	15	19	10	25	32	17	13	16	6	17	13	10	11	19	19	24	33	17	28	13	33	25	10	13	21	35	21	14	7	4	14	20	15	13	12	19	11	74	6	18	14	7	8	12	27	10	23	20	8	11	6	8	7	9	8	19	15	10	4	11	39	19	8	8	13	11	30	4	10	17	8	11	12	14	10	15	8	6	9	4	23	10	12	5	25	15	25	14	2	12	14	12	10	6	7	8	13	6	14	12	6	6	11	6	13	6	6	10	6	7	6	5	3	55	11	9	7	10	15	0	5	5	11	11	2	8	15	6	5	47	3	8	13	2	12	14	4	6	7	65	0	6	4	2	2	5	0	4	4	3	1	10	1	14	5	4	3	5	3	3	1	1	3	1	5	1	0	7	2	2	2	21	2	0	1	0	0
ne0340	2004	3626	1373	1758	1209	1155	1180	932	882	1314	763	807	932	762	1126	709	871	728	1144	781	936	797	739	698	728	675	772	798	982	1005	658	676	503	514	1068	758	557	554	575	694	599	592	586	548	592	502	403	646	884	544	449	504	544	561	424	617	510	607	502	476	527	500	551	595	526	547	454	458	393	561	484	441	488	726	446	403	555	402	461	542	471	530	389	474	431	303	468	417	403	439	582	540	353	541	314	371	359	341	382	355	471	539	484	338	440	320	423	322	428	393	450	382	315	299	340	367	271	446	512	289	490	290	578	415	365	401	451	295	256	342	320	338	323	371	460	529	547	303	286	348	385	423	357	304	391	571	289	424	336	511	324	249	427	248	315	324	389	296	267	575	344	411	284	415	515	316	383	411	347	299	670	265	305	477	194	334	365	272	282	235	541	425	288	298	253	397	275	349	311	329	370	369	379	229	288	392	280	236	389	325	301	279	394	288	397	359	290	255	362	471	213	376	526	274	334	455	241	315	325	280	326	347	390	267	488	335	369	376	299	231	403	189	340	309	330	331	281	292	258	213	346	366	292	412	206	260	353	236	268	356	140	230	355	272	203	169	193	346	536	321	261	290	209	286	251	317	256	305	220	338	174	211	238	161	201	251	260	276	413	262	219	307	260	368	292	459	353	284	220	294	268	283	252	296	299	266	262	400	247	177	342	529	273	316	259	278	215	441	236	259	278	224	240	207	282	253	205	285	181	288	245	306	167	249	188	282	191	221	267	168	254	276	217	227	265	207	351	330	283	169	233	176	290	334	251	222	180	249	292	215	159	301	244	234	224	291	248	203	231	252	222	265	241	250	385	192	239	322	237	157	249	128	210	138	131	254	259	229	254	343	257	195	175	231	381	276	184	201	164	165	250	279	237	243	177	97	258	192	262	130	266	282	189	252	261	245	198	263	245	249	208	188	159	254	177	186	189	196	182	217	177	223	276	253	215	208	223	235	251	222	225	241	284	322	128	190	215	232	235	104	156	251	182	169	238	145	169	163	228	171	200	185	153	97	188	146	189	227	254	178	178	238	239	191	146	169	130	343	272	175	173	182	169	110	231	185	219	236	173	201	168	402	154	150	158	207	198	222	213	266	186	185	209	233	136	97	191	169	198	141	171	194	198	160	198	144	178	181	239	218	152	207	187	167	91	258	151	125	139	120	103	176	190	190	155	91	199	219	250	158	202	214	171	171	134	170	134	208	209	211	154	181	133	112	116	146	139	334	206	152	198	192	201	128	231	249	151	147	170	64	125	183	157	154	138	169	106	159	186	147	128	180	164	145	48	171	148	124	151	162	157	121	141	121	186	126	130	198	162	198	163	100	202	141	115	124	145	100	139	154	146	113	155	274	58	108	108	105	79	124	137	137	122	138	191	74	162	60	151	129	146	119	184	204	167	121	136	211	120	112	111	125	108	175	133	184	93	153	126	133	189	237	141	144	100	143	151	152	149	130	147	87	141	137	34	110	153	139	169	162	117	129	82	82	183	170	126	153	109	174	90	118	153	145	90	83	101	145	129	158	122	114	169	115	179	168	141	160	146	49	137	132	116	107	141	94	84	152	127	131	90	96	131	103	163	120	129	135	143	171	102	153	193	94	182	113	116	159	119	116	131	152	177	135	154	112	130	130	38	124	161	113	199	68	93	95	87	116	134	85	140	87	126	141	116	116	130	94	130	102	110	37	134	140	157	116	109	97	88	103	107	112	159	142	71	149	142	157	93	98	62	141	117	166	87	80	180	184	141	98	102	130	149	135	92	66	84	91	107	92	137	126	109	96	155	137	128	169	149	121	94	97	114	131	76	102	94	113	102	125	85	117	78	80	63	102	73	95	92	84	109	87	119	64	108	105	85	92	54	65	81	91	93	111	53	96	127	106	97	108	104	124	95	87	72	323	114	58	100	113	110	80	88	87	113	83	182	133	91	107	141	85	93	97	114	79	71	48	56	141	83	164	178	81	143	77	97	78	59	105	106	70	73	131	82	108	77	97	80	81	130	107	121	99	109	49	119	76	108	110	135	75	93	95	141	52	118	80	145	99	50	120	87	91	113	64	70	121	123	73	124	84	69	88	92	83	72	113	63	117	129	73	85	72	82	119	60	115	78	92	175	94	99	80	42	108	126	108	53	86	86	89	110	84	57	121	101	115	121	78	88	76	89	141	101	121	72	54	54	84	77	139	94	71	79	65	52	101	95	113	123	69	166	128	110	98	69	67	94	92	74	76	98	67	42	100	92	60	32	72	72	71	61	101	63	70	58	92	61	64	84	67	59	64	129	57	59	72	74	71	94	57	111	59	69	94	68	87	82	63	76	68	96	80	77	85	67	57	65	74	53	112	87	150	47	97	85	82	87	143	57	57	95	93	37	35	98	43	44	69	54	55	59	58	60	79	43	34	113	65	73	76	77	98	51	49	75	87	49	71	55	48	56	54	62	78	60	77	70	70	56	74	41	84	77	63	73	52	30	47	102	68	91	103	32	66	78	55	46	54	73	76	69	56	88	69	73	42	41	62	88	48	54	65	52	64	44	85	101	82	43	44	52	75	44	44	51	92	45	93	120	71	79	89	24	41	92	85	71	39	78	53	43	69	52	87	63	65	72	51	34	52	56	43	63	70	59	83	59	41	39	40	63	71	55	67	63	78	74	47	65	51	73	83	33	58	40	74	62	78	51	49	70	54	95	71	91	87	73	64	66	55	49	44	72	72	63	65	67	26	52	62	54	77	81	77	40	58	50	102	105	80	58	53	18	18	34	69	62	52	62	65	52	48	65	38	51	42	28	54	31	89	71	63	75	80	47	55	38	68	71	35	55	69	46	25	37	42	40	50	38	52	42	70	75	79	73	100	39	34	80	58	31	52	58	111	47	66	35	87	39	67	27	42	61	70	86	34	55	25	47	73	42	36	57	40	68	51	70	39	71	77	22	35	58	36	64	31	50	35	70	59	36	52	33	36	81	40	40	64	57	59	32	50	38	41	37	49	47	38	38	29	44	28	34	37	11	50	65	34	78	53	62	39	44	21	58	48	44	38	21	51	67	15	89	26	25	28	41	53	34	26	36	43	67	48	29	51	42	22	74	48	30	37	49	31	28	53	61	48	66	35	53	33	13	28	60	15	33	27	47	39	29	55	30	19	32	35	63	33	48	55	22	53	53	16	47	51	34	59	19	32	43	30	49	31	46	52	61	39	27	85	21	53	27	40	37	51	48	8	29	22	50	54	40	37	16	30	46	49	22	13	52	52	32	45	33	24	16	10	56	36	46	38	69	22	20	39	38	20	60	54	37	37	33	63	66	46	15	48	27	48	54	41	47	27	21	44	29	22	25	51	17	36	18	25	19	41	31	35	29	13	54	42	28	36	32	18	35	13	46	35	40	33	26	33	31	55	43	28	20	41	12	66	15	36	32	36	32	35	18	31	42	21	29	37	15	55	34	23	29	33	28	13	29	40	13	36	18	28	25	22	17	35	21	21	18	21	45	21	20	26	21	46	80	51	33	14	29	19	18	20	29	35	17	20	18	42	9	19	16	28	34	43	18	31	24	27	17	11	14	23	24	17	27	16	32	15	11	6	10	27	9	14	12	18	27	26	26	62	19	31	26	28	20	21	30	13	21	17	31	21	32	23	40	16	26	24	46	15	5	11	23	21	20	33	40	33	20	8	7	26	15	29	18	26	31	7	26	12	6	21	8	8	3	15	12	12	15	22	32	6	4	10	8	17	20	33	36	6	20	13	29	17	10	9	17	43	7	8	3	24	14	9	16	13	19	17	26	8	12	17	8	10	16	14	16	12	11	25	21	9	3	8	8	27	1	14	13	19	3	24	10	9	14	20	22	14	6	9	17	7	14	12	10	3	17	11	33	29	9	6	7	3	12	28	16	7	34	10	5	13	7	15	5	4	8	4	3	8	6	10	13	12	7	14	7	14	13	11	12	7	10	5	8	3	5	3	16	13	14	6	1	13	2	9	16	14	2	8	8	6	7	7	3	2	4	4	23	6	3	9	4	22	4	7	7	7	8	1	5	11	2	1	4	1	5	2	5	9	4	12	6	4	4	6	0	1	1	1	0	0	1	6	1	1	1	2	3	1	3	0	0	2	2	0	0	0
ne0341	1107	1723	582	933	687	657	653	604	479	642	415	438	446	366	540	382	453	371	572	394	464	439	335	385	400	329	418	420	594	472	369	449	284	254	456	338	289	288	288	314	295	306	393	317	320	239	251	329	375	248	233	277	269	299	242	259	241	296	271	248	264	241	355	293	279	319	255	256	223	273	224	258	258	276	242	221	218	177	264	265	246	246	179	268	251	179	259	228	197	219	307	234	193	209	168	240	178	190	195	226	245	253	248	198	234	178	188	181	218	245	241	224	161	160	182	209	156	244	401	169	209	178	240	236	181	204	225	172	143	187	181	171	171	176	183	198	271	162	175	191	189	237	217	160	204	253	153	202	192	231	197	150	190	148	138	164	177	142	145	227	178	212	149	218	219	170	179	210	295	158	313	145	170	208	112	140	168	141	135	140	280	198	161	161	135	321	142	160	149	202	188	173	216	128	166	178	170	122	194	176	142	146	210	142	157	162	164	149	163	191	126	218	220	124	184	246	125	169	152	167	145	169	194	150	200	199	197	143	161	115	198	131	211	177	185	144	157	139	138	126	228	144	148	171	106	123	153	103	135	138	79	98	148	112	94	92	114	128	181	197	125	127	92	155	159	122	154	139	131	144	102	86	133	94	131	138	128	137	172	120	106	123	123	143	144	200	145	139	117	131	132	154	128	142	175	127	117	151	125	110	188	210	117	149	149	108	138	234	141	159	126	123	117	125	131	118	122	189	101	122	117	136	91	109	148	140	120	115	135	110	140	132	111	97	134	125	173	157	108	83	110	103	131	138	111	130	104	125	142	74	100	162	154	100	100	157	114	111	113	127	86	122	91	128	201	98	103	152	151	111	112	58	113	80	85	114	131	148	100	96	187	81	101	112	161	137	90	113	83	101	132	144	141	113	90	53	119	91	112	79	130	104	104	150	117	108	93	116	134	139	98	96	92	120	101	111	94	98	90	107	107	151	101	110	91	70	110	105	111	129	92	118	65	135	70	90	93	130	113	74	84	124	80	93	96	71	82	104	88	89	112	103	71	59	105	70	90	109	167	79	108	94	115	101	84	95	69	101	144	93	96	96	97	56	143	87	121	111	71	79	80	189	61	104	89	97	131	131	90	101	115	68	111	114	82	68	88	74	100	72	84	106	93	83	88	85	78	87	117	121	86	90	107	82	56	145	100	118	81	68	62	105	100	99	74	57	105	99	131	103	99	99	88	78	68	70	81	102	86	122	58	74	71	67	94	120	79	126	94	70	101	104	131	74	108	121	70	69	128	52	70	75	75	63	96	126	76	90	122	75	70	111	77	71	37	84	95	63	59	101	78	50	62	55	112	53	76	95	83	102	94	58	85	78	54	90	76	53	72	82	82	54	78	90	38	37	68	45	59	71	69	48	59	91	94	36	62	44	73	78	69	58	96	91	84	59	67	83	77	80	56	41	70	72	66	88	69	82	73	64	88	109	81	76	59	87	60	68	72	50	55	46	76	83	34	58	75	62	72	84	57	65	51	45	74	97	73	78	56	87	70	70	75	48	54	61	62	92	65	74	46	70	87	56	57	107	88	102	51	42	60	67	57	59	71	57	51	64	67	105	51	37	63	69	89	61	59	61	66	67	65	103	70	30	83	68	66	74	54	47	73	100	85	65	77	65	64	71	31	73	71	50	92	32	57	37	57	62	52	59	59	60	66	67	55	51	70	52	62	48	57	25	53	75	60	51	66	49	70	96	70	63	92	75	30	125	97	72	66	48	41	48	41	84	41	44	86	96	80	59	42	49	81	63	54	23	59	53	56	51	70	73	63	50	55	52	64	62	75	69	38	58	52	52	40	45	27	54	59	69	36	52	51	53	16	57	32	58	42	37	55	41	57	26	51	38	42	55	33	36	49	65	60	60	34	59	62	52	40	43	72	61	39	32	44	118	24	35	36	50	45	35	55	48	41	52	75	54	54	52	49	42	41	38	73	39	31	42	38	59	50	93	80	41	74	52	71	35	45	68	55	31	44	63	54	60	36	52	51	38	39	67	93	47	66	32	50	34	65	49	73	47	41	41	68	36	54	44	57	44	34	55	73	46	49	29	59	57	54	42	48	37	57	45	45	34	43	40	45	52	66	56	56	38	58	62	44	44	46	68	119	54	46	51	25	37	63	29	27	44	42	50	69	38	27	61	69	59	62	31	54	36	40	67	44	55	47	35	27	33	50	49	51	52	52	46	31	28	43	54	44	43	70	76	59	49	37	40	31	47	45	38	39	73	39	41	44	40	10	38	51	37	44	53	39	39	26	38	71	46	51	37	19	29	28	36	43	48	35	44	39	35	50	37	44	46	56	30	42	33	43	28	54	36	36	48	40	23	20	41	35	55	70	29	40	31	51	30	58	55	39	25	43	38	19	14	46	19	26	40	39	44	32	26	41	35	21	19	54	27	40	36	51	44	26	32	41	81	29	35	22	28	46	33	31	35	44	34	37	29	21	37	33	32	48	35	49	24	18	34	35	33	35	39	14	41	36	24	29	30	35	44	59	31	54	39	49	22	19	30	38	22	30	40	18	32	18	31	37	39	25	23	36	42	23	18	21	29	20	56	37	22	27	44	25	39	50	44	46	24	42	23	13	37	29	37	35	26	42	32	15	14	21	22	47	28	13	59	29	36	27	13	17	39	31	46	26	44	31	17	35	27	38	43	23	46	29	42	19	32	24	38	31	24	48	43	44	35	41	41	42	37	18	27	18	30	39	36	42	18	27	24	68	33	46	26	34	25	26	45	41	40	44	26	18	11	11	28	27	35	50	29	22	15	22	30	30	27	28	21	19	52	32	32	65	33	32	37	28	34	36	16	31	46	35	29	13	15	22	33	24	19	24	29	34	33	27	40	26	18	38	15	22	35	26	41	35	18	12	38	14	26	17	21	28	16	30	19	21	24	20	26	37	25	25	27	36	19	22	25	32	27	13	18	31	24	23	18	38	28	20	26	29	64	14	14	37	26	17	34	39	28	21	18	25	16	12	25	17	18	25	13	17	10	12	36	6	33	49	68	37	35	24	25	24	10	24	12	24	17	3	23	33	15	39	50	21	16	28	34	26	14	26	22	53	16	11	26	16	19	31	29	21	25	19	23	21	44	32	33	29	17	24	27	4	21	19	12	17	26	16	22	15	25	7	16	21	30	22	40	16	27	18	24	30	15	29	22	13	34	16	20	30	16	19	14	25	28	33	16	15	27	25	38	13	22	13	20	17	13	18	13	14	25	7	21	12	8	14	16	8	7	41	21	14	16	12	13	9	8	11	21	24	21	30	10	10	37	11	17	14	21	38	26	9	30	14	21	9	26	9	14	25	21	30	7	47	21	25	7	22	23	9	29	10	7	12	16	13	13	17	6	31	21	18	26	9	11	22	9	18	18	15	15	17	16	11	28	19	15	7	22	15	24	12	31	17	15	18	10	5	16	21	18	38	14	8	31	19	8	22	23	12	12	16	10	16	20	18	16	10	10	7	5	13	18	15	18	17	11	16	6	14	27	20	22	21	10	9	16	9	17	23	16	9	9	13	14	11	8	2	10	24	13	7	11	12	8	21	4	16	17	10	5	16	10	6	5	12	0	7	14	18	14	11	10	13	13	11	23	8	13	15	14	12	11	15	10	13	17	10	7	9	3	12	6	4	10	50	7	1	7	14	6	7	18	10	7	16	4	2	9	8	9	8	3	19	7	11	7	7	16	0	4	5	12	9	2	3	8	11	3	6	6	13	4	7	7	16	3	12	7	10	13	6	1	9	28	11	4	3	18	5	2	11	6	15	3	3	11	6	15	7	6	12	9	4	9	7	7	11	4	3	3	8	15	1	14	5	21	3	6	5	8	5	13	10	7	4	6	9	5	13	7	7	2	5	4	18	12	10	6	4	4	5	16	6	8	18	3	10	1	7	7	11	1	5	5	11	9	1	3	5	4	0	5	10	9	7	3	6	9	4	2	5	1	0	1	3	1	3	4	4	6	3	3	4	11	3	4	5	3	0	4	4	1	3	5	0	3	2	3	10	5	1	1	2	1	2	1	3	6	1	2	2	1	0	1	1	7	2	1	4	0	1	1	3	0	9	0	0	0	2	3	2	1	0	1	0	0	3	0	0	1	1	0	0	0
ne0342	1243	2108	796	1096	800	727	724	667	576	809	475	541	540	449	573	479	533	467	706	463	597	463	442	432	426	458	443	461	542	570	442	413	311	342	596	393	327	368	316	399	352	352	398	393	405	297	262	366	501	286	291	312	391	348	268	335	396	356	281	378	275	271	406	389	310	345	287	277	260	327	334	307	309	470	285	238	306	244	263	354	282	288	231	338	244	211	278	225	271	241	379	314	214	349	232	234	243	205	248	228	298	310	243	227	261	192	263	212	281	238	267	214	195	207	229	229	186	309	249	175	255	185	308	243	206	221	259	291	169	215	230	194	208	257	289	362	259	205	186	201	253	285	221	174	274	320	194	293	211	319	217	155	213	135	196	268	228	197	175	336	210	260	167	243	265	193	188	247	221	217	324	196	178	252	133	171	218	162	195	168	226	249	222	197	222	239	218	221	210	229	222	196	300	155	202	212	188	143	234	198	150	201	290	190	253	243	174	161	191	197	137	231	253	147	228	264	161	210	216	201	186	271	214	140	245	227	231	196	204	159	222	114	191	175	185	147	157	170	159	141	213	213	152	211	217	162	184	153	181	213	97	137	176	205	120	112	128	199	220	175	162	194	134	146	162	191	125	205	167	170	135	116	162	95	152	125	159	164	222	151	117	157	180	263	234	214	167	147	142	184	163	202	153	175	199	154	173	219	124	116	201	294	121	131	137	178	164	236	147	186	201	145	150	140	158	171	109	155	131	195	145	156	90	173	116	162	125	145	143	132	174	196	148	155	116	123	211	175	128	116	140	95	148	165	164	115	108	151	200	138	110	166	154	115	112	178	146	166	129	172	80	132	127	146	207	151	156	180	182	83	153	83	150	108	100	132	151	136	133	104	153	82	99	154	196	134	135	139	82	129	148	167	158	144	142	65	144	112	151	129	164	169	137	136	151	122	126	142	149	192	111	87	96	158	95	124	98	97	113	146	125	127	163	128	138	136	131	145	192	137	121	154	85	159	107	97	123	122	114	90	106	149	100	89	140	76	102	111	103	90	137	152	88	54	93	108	104	126	140	93	103	121	122	146	106	108	83	198	163	126	105	98	109	68	138	113	173	136	102	119	98	191	62	103	102	101	117	146	136	129	152	108	131	158	81	61	110	104	108	84	112	137	129	113	117	103	114	89	124	94	86	133	103	87	64	152	106	99	94	93	66	105	100	157	98	56	111	123	188	99	124	112	116	99	105	116	78	130	137	103	90	100	89	66	79	165	122	205	126	79	121	124	147	72	119	161	82	70	187	53	98	91	97	77	93	137	79	94	95	99	95	118	88	75	25	121	71	85	79	102	84	57	66	72	117	86	78	119	116	123	85	54	116	80	72	73	87	53	73	97	98	52	77	163	34	63	84	62	67	115	104	87	70	76	123	73	84	35	98	65	76	83	115	107	76	84	89	94	88	73	85	66	92	61	89	121	70	88	96	64	107	158	97	76	65	103	85	70	86	66	82	60	103	97	34	75	93	90	100	86	77	73	70	63	91	128	99	89	81	95	82	142	101	86	91	43	70	117	88	100	80	100	83	48	91	124	108	114	115	41	79	82	85	84	72	67	63	89	88	107	70	45	80	83	94	63	72	63	87	82	68	106	104	32	85	83	79	108	62	60	86	70	113	58	89	92	90	77	24	90	70	67	129	41	65	83	49	72	72	55	72	123	81	88	65	52	116	83	85	57	53	22	79	80	95	81	64	62	59	62	85	72	89	87	51	108	86	83	65	80	68	93	60	74	52	62	91	103	80	54	56	58	92	76	57	37	70	65	70	68	80	81	74	69	110	78	76	67	89	88	68	42	63	86	45	58	49	85	70	49	63	55	58	42	48	52	58	76	60	56	66	63	48	51	70	60	48	64	45	46	70	75	55	73	49	60	80	57	75	66	76	65	57	52	37	183	38	34	68	64	92	40	53	51	57	75	102	87	51	86	75	66	53	56	63	43	47	37	34	76	67	104	94	79	91	45	59	43	58	56	63	39	49	81	60	79	53	48	47	49	76	68	79	61	76	44	82	54	80	58	78	46	48	36	85	38	64	55	60	40	30	48	61	72	57	51	57	69	48	53	57	40	54	51	37	46	43	64	49	67	51	50	59	46	58	109	50	55	47	83	44	85	54	44	29	63	80	53	41	53	67	58	69	51	27	82	113	71	67	39	47	37	58	96	73	73	41	37	45	75	57	63	61	60	47	57	33	63	56	67	65	59	69	71	52	50	52	80	59	47	59	41	61	23	26	47	56	31	25	52	28	48	38	67	36	46	57	62	35	41	50	28	40	37	46	36	48	48	50	45	68	35	58	48	46	34	54	46	47	34	46	45	62	50	38	53	39	40	26	48	34	72	66	59	29	62	59	75	47	44	43	30	46	56	29	46	45	35	31	47	50	55	43	37	50	42	39	24	61	57	36	44	66	60	32	28	49	67	31	51	39	44	53	25	53	56	67	49	50	49	36	59	41	49	34	37	39	36	16	33	61	30	48	52	12	43	23	20	30	44	34	37	54	28	62	36	41	37	37	48	46	47	30	54	32	43	24	43	48	37	28	29	34	49	24	21	25	49	26	66	60	53	20	41	22	57	55	59	45	27	36	44	48	36	32	47	41	26	32	30	16	25	37	27	49	33	26	76	49	28	43	34	46	24	26	20	48	57	52	37	30	37	57	40	27	27	28	47	30	28	32	30	30	24	59	35	59	33	39	53	43	36	38	26	23	24	49	53	50	23	38	32	42	32	56	50	23	30	31	50	64	45	61	45	17	11	22	29	30	48	48	34	42	28	37	42	37	22	16	27	19	47	33	25	42	33	23	37	45	40	41	38	34	55	24	13	20	32	28	48	25	42	21	35	71	70	29	45	35	29	60	40	33	35	36	49	32	53	27	33	19	54	16	18	30	39	39	29	23	21	34	32	21	31	23	69	44	21	35	22	47	47	26	16	25	20	25	65	37	34	33	57	30	32	20	21	36	22	17	57	48	34	26	28	30	16	28	36	21	26	31	14	24	22	25	42	16	20	31	23	36	26	45	23	27	12	28	33	37	29	19	21	29	15	37	17	30	7	25	25	22	17	25	32	42	31	23	35	25	18	30	28	31	24	26	24	30	35	20	21	34	16	31	23	6	18	25	10	20	24	20	21	29	39	15	13	18	25	32	21	29	35	18	46	27	7	18	29	20	40	24	22	29	12	20	22	27	42	34	23	19	30	20	34	26	49	32	32	19	28	22	12	30	28	24	26	16	26	13	16	13	9	33	22	17	24	22	23	11	11	17	22	13	18	33	11	16	27	24	14	25	26	39	18	15	31	13	25	12	25	17	37	25	16	39	8	10	23	21	17	20	32	10	19	14	22	11	35	16	17	25	13	24	29	14	18	14	14	16	13	34	29	14	25	32	12	21	33	19	11	8	19	17	37	23	11	27	22	16	14	16	20	29	12	27	23	19	33	30	13	23	22	26	13	15	27	7	19	9	18	10	19	5	27	16	15	10	17	41	12	24	22	18	21	50	27	11	9	14	17	21	28	17	14	13	18	17	24	9	8	7	15	23	26	14	35	17	17	25	9	12	14	11	13	19	7	10	7	12	4	10	15	10	11	12	18	10	19	12	27	10	20	20	22	10	8	11	5	24	9	10	8	8	6	15	11	5	8	15	12	4	5	18	12	15	15	26	17	30	4	5	20	15	18	15	17	19	6	9	7	1	10	10	8	12	13	10	9	6	5	14	4	4	12	10	7	8	31	30	9	7	7	8	13	7	3	7	16	6	10	2	29	4	13	10	10	11	9	4	1	8	10	9	6	10	13	14	9	11	10	8	2	3	10	4	26	6	24	9	12	9	17	5	7	6	9	12	10	4	10	16	11	6	9	5	5	3	9	28	8	5	5	8	1	3	18	7	6	25	6	8	3	2	13	9	4	6	1	1	3	6	3	13	2	3	6	5	5	19	2	9	4	19	2	4	0	0	4	14	4	8	4	2	4	3	13	3	9	2	3	3	5	2	7	3	2	6	6	12	6	5	5	5	1	3	1	2	3	7	1	4	6	1	1	1	1	3	0	1	4	2	2	2	1	3	1	0	0	2	0	0	0	0	4	1	0	2	1	2	0	1	0	0	1	2	1	0	0
ne0343	2550	4679	2074	1990	1745	2119	1498	1719	1306	1708	1234	1442	1575	1501	1933	1228	1349	1218	1446	1342	1371	1130	1114	935	1006	1008	1232	1265	1140	1759	945	861	925	1015	1378	1222	849	877	807	829	899	994	699	748	822	883	745	1020	1289	932	981	888	771	921	561	1001	770	1074	738	645	919	675	776	606	835	678	811	718	683	823	742	645	751	656	670	822	555	660	667	696	751	663	645	675	688	632	693	734	536	700	788	787	670	529	466	516	642	458	552	513	827	680	749	625	652	613	607	620	557	429	622	420	678	595	695	519	592	690	922	629	507	595	936	467	496	625	583	338	498	619	609	564	722	696	655	648	479	475	507	518	369	583	448	491	520	871	499	537	417	694	494	372	675	375	412	455	551	387	512	608	435	582	494	722	653	516	529	761	852	448	714	391	448	916	462	464	710	534	438	451	756	585	406	362	361	1080	396	477	533	563	419	581	297	380	451	564	429	504	482	551	593	446	487	435	552	591	443	530	542	371	463	531	433	510	456	807	444	564	491	489	581	391	690	327	916	609	532	566	508	400	576	257	596	534	475	566	539	523	441	393	339	641	328	459	216	494	551	349	400	439	212	307	409	371	344	399	251	510	516	578	409	520	310	513	314	465	389	592	351	417	346	316	384	289	374	340	331	330	586	370	382	425	309	440	460	602	514	360	353	338	511	472	431	369	427	420	408	274	424	281	637	394	535	516	282	360	329	859	313	462	454	335	374	290	359	220	236	461	243	505	382	488	247	498	265	444	213	319	425	251	252	368	340	283	333	224	513	668	397	367	284	192	490	393	391	381	222	458	290	261	253	445	447	339	290	470	280	284	467	332	453	363	328	432	472	247	362	496	441	179	339	215	353	224	252	403	317	383	313	287	466	426	253	373	572	313	302	378	236	242	502	307	370	312	238	236	393	310	385	193	498	555	314	472	285	299	247	274	404	412	335	268	191	333	245	153	364	219	295	283	321	354	432	392	320	257	266	336	327	354	310	372	197	429	264	224	277	261	239	182	258	389	210	277	258	244	191	149	350	246	356	236	178	147	355	237	293	342	371	247	261	288	354	308	256	291	164	292	419	224	265	290	274	189	370	230	292	296	258	212	232	265	310	280	220	284	219	363	359	413	340	295	302	285	238	143	251	195	218	257	209	368	275	223	291	185	284	208	359	261	153	391	246	165	198	502	224	142	206	188	161	281	362	200	203	123	275	237	449	236	252	352	189	288	280	320	143	265	379	338	210	250	278	182	141	144	210	309	424	128	283	306	295	162	415	393	197	224	116	149	166	323	161	93	169	196	232	220	204	244	172	172	167	219	114	331	139	143	184	234	302	165	178	215	250	136	172	298	325	241	179	173	271	276	163	190	193	181	246	255	180	225	219	230	118	189	173	178	184	179	341	212	235	203	348	120	190	86	172	252	152	170	279	417	278	173	248	351	204	153	166	180	166	259	168	365	117	199	168	161	243	117	380	153	156	272	211	166	253	190	263	128	233	210	78	151	248	175	249	196	147	194	114	152	306	200	225	229	177	244	97	144	155	171	191	105	199	284	120	283	191	125	308	216	383	160	250	369	135	109	193	164	129	124	156	184	117	305	158	233	135	149	224	212	225	142	171	165	196	324	190	250	254	230	271	196	147	226	172	172	173	291	174	241	262	141	189	219	91	184	210	103	276	102	126	200	104	140	238	134	211	121	155	124	139	167	144	143	171	178	127	99	137	144	131	215	145	113	169	147	156	216	320	204	130	188	127	171	144	172	92	206	231	170	128	161	220	265	164	102	190	162	283	159	161	98	82	120	129	114	230	193	199	151	321	164	104	237	159	156	117	136	139	117	136	107	153	243	101	163	181	136	142	92	103	160	69	141	245	144	142	124	132	93	93	194	137	162	146	128	104	147	75	133	100	137	231	129	182	118	174	133	127	126	148	193	106	80	117	229	154	79	120	89	162	161	230	228	199	257	177	126	155	170	144	129	96	103	123	205	123	255	165	110	179	152	142	115	89	136	137	101	103	214	140	237	99	219	78	94	126	170	171	122	203	58	118	141	130	117	229	160	177	199	249	86	161	111	76	128	92	139	105	123	91	127	153	174	154	124	182	103	64	91	156	118	74	168	153	182	94	112	153	157	123	151	129	114	124	125	335	105	83	120	85	122	178	125	84	106	122	134	149	102	74	205	144	137	223	105	96	130	97	214	82	149	125	88	91	277	118	172	128	183	122	138	71	95	141	136	140	57	123	194	168	224	102	98	95	101	91	131	73	132	72	168	173	70	64	117	130	75	106	118	107	109	116	114	101	84	90	72	67	46	102	68	100	122	116	123	148	89	89	104	116	151	47	171	74	97	88	94	131	85	80	119	67	87	93	99	68	129	117	78	63	131	100	90	96	194	87	63	141	113	79	89	99	90	77	82	138	72	108	88	196	139	98	71	99	85	117	148	113	110	75	96	74	135	99	103	53	58	44	71	102	101	111	75	73	82	79	80	81	109	80	89	116	73	41	97	132	74	91	175	67	105	79	71	83	116	77	108	87	76	110	109	153	68	77	135	157	91	84	69	65	80	54	101	120	148	58	83	52	93	80	73	51	59	36	187	134	123	58	141	76	57	118	112	111	81	111	48	57	68	91	114	93	69	49	88	65	60	71	59	98	49	55	110	77	116	44	81	66	76	69	134	109	146	55	43	68	80	96	56	62	97	85	106	55	110	52	86	119	98	217	122	146	75	91	74	130	155	58	68	49	79	86	108	84	53	62	69	71	67	103	90	107	63	106	154	155	138	82	45	35	65	44	96	89	59	70	100	92	91	94	66	49	62	54	79	66	129	67	77	86	87	54	87	48	73	74	58	71	81	74	49	63	40	111	68	51	103	52	80	239	73	104	115	73	63	88	61	28	77	76	130	76	95	54	113	53	64	65	54	79	72	120	59	77	45	81	52	85	75	89	18	37	75	81	44	99	83	60	39	117	84	93	73	44	72	155	230	89	67	53	72	110	73	44	148	68	86	115	41	42	53	55	92	95	70	62	43	49	24	48	59	44	65	146	93	45	64	74	81	91	42	45	54	55	50	33	98	95	65	123	109	36	47	39	93	38	33	53	58	150	57	55	58	52	59	124	58	68	52	75	36	50	91	80	55	96	41	139	31	16	40	86	23	57	24	65	24	42	61	60	24	40	32	31	31	56	64	37	61	35	49	82	79	49	42	33	67	60	23	51	57	60	144	89	40	50	63	44	58	67	32	74	52	50	37	50	59	51	77	19	56	35	46	36	21	24	17	92	47	33	46	38	38	49	14	66	50	63	37	90	24	28	48	50	44	21	37	23	65	57	43	51	47	24	76	56	37	44	69	106	35	58	44	31	29	23	42	14	62	26	17	27	67	38	30	79	37	71	22	33	30	62	29	35	29	75	54	55	105	39	56	87	30	84	36	22	48	32	66	26	67	55	85	44	40	29	41	56	24	40	30	36	32	128	24	23	40	48	38	40	37	30	26	27	29	14	33	24	44	47	20	16	20	29	28	26	22	28	68	87	50	56	23	20	30	22	26	41	37	19	23	36	40	17	18	34	31	75	26	58	16	51	16	20	21	25	23	44	45	27	16	63	37	22	13	12	34	20	20	34	50	41	23	26	77	24	42	29	17	25	32	24	30	15	37	29	34	46	40	48	14	19	26	43	23	4	13	28	48	14	39	31	40	19	19	16	21	23	31	13	43	63	1	49	21	19	26	20	15	11	21	17	5	47	8	32	12	15	9	13	14	18	38	59	11	29	6	22	24	22	12	35	27	13	11	9	20	21	6	7	19	32	13	26	23	8	23	11	11	30	3	30	25	23	29	13	14	17	9	12	24	4	9	12	49	2	46	15	5	14	21	24	10	8	8	18	8	7	9	24	9	21	21	68	48	8	11	10	4	14	56	12	10	20	10	10	4	23	38	10	1	23	12	1	5	9	12	22	9	8	3	7	15	16	16	14	3	13	4	4	5	8	14	18	11	7	5	2	17	2	4	12	13	1	1	17	5	6	13	2	5	0	7	0	6	4	8	0	12	6	12	9	3	4	5	6	5	2	2	3	4	6	5	4	20	6	2	9	14	6	1	0	7	3	2	2	1	0	4	0	4	1	1	0	0	0	0	1	1	2	11	0	0
ne0345	2004	1778	1158	1068	876	1106	996	992	746	873	614	838	713	689	726	532	636	612	690	613	696	614	430	586	514	448	509	570	593	569	383	561	486	493	485	503	479	491	435	574	553	454	398	439	457	416	407	605	477	363	435	380	369	407	559	464	421	411	470	369	408	327	305	453	404	540	385	315	348	380	378	400	417	431	286	427	332	377	503	361	365	498	362	313	267	298	428	360	270	468	368	320	286	380	274	319	332	232	315	332	322	309	393	341	293	320	339	293	306	438	316	393	276	288	296	290	291	309	281	307	346	321	332	404	420	295	294	340	278	273	242	287	233	212	250	212	227	274	237	286	250	354	265	278	204	297	213	223	343	355	254	231	316	294	256	201	298	231	270	426	250	277	211	310	291	237	214	288	180	279	288	224	246	310	240	250	231	239	207	267	245	190	196	275	214	249	232	194	250	260	242	320	175	189	187	286	175	220	288	244	303	228	211	239	199	279	234	300	215	317	221	250	168	258	182	298	210	214	210	214	234	244	235	353	284	289	266	160	244	192	194	343	275	197	284	170	145	218	242	193	276	187	154	148	193	266	230	171	180	150	158	192	226	209	162	182	184	204	211	262	311	190	238	274	202	184	279	206	242	204	168	172	183	175	197	145	242	205	205	244	178	249	235	125	145	133	245	205	110	186	195	224	160	219	170	147	229	160	183	182	216	244	203	226	287	165	166	256	228	170	173	152	162	140	193	166	287	211	142	159	141	202	209	131	187	245	204	164	141	175	178	231	229	159	159	269	153	176	177	178	143	295	151	148	223	172	256	215	173	146	140	156	176	163	142	242	145	142	105	190	190	113	187	167	169	134	160	163	172	269	153	125	167	138	138	110	192	222	145	152	138	190	157	208	153	167	127	138	187	124	163	133	146	106	139	155	163	132	118	129	117	380	169	185	186	144	122	120	195	174	163	143	87	176	139	193	177	144	175	165	161	127	155	140	152	247	183	178	109	170	177	135	158	164	136	133	125	103	140	124	161	100	114	138	116	126	104	169	120	153	117	114	111	134	150	152	130	159	119	95	122	124	89	124	134	144	101	140	112	99	78	173	115	92	93	116	155	124	107	80	152	132	128	127	123	106	137	124	147	111	119	151	99	95	96	91	132	98	127	106	129	120	125	155	144	112	110	114	143	168	118	103	125	117	89	145	124	103	115	71	96	131	115	78	117	105	131	95	101	104	148	122	108	105	70	149	128	112	123	153	133	66	98	101	68	83	66	180	119	109	83	125	115	88	130	112	149	108	96	95	91	101	110	64	111	127	75	116	103	103	113	139	73	129	117	216	57	107	92	103	95	121	75	105	113	73	70	132	135	145	84	105	93	97	74	104	115	97	88	135	127	97	102	112	88	91	64	90	74	74	104	93	94	113	102	77	79	98	71	90	61	104	100	88	125	75	109	109	103	137	95	108	84	66	76	90	80	61	79	90	78	92	116	88	86	89	60	67	91	100	76	99	119	68	72	105	120	135	85	112	83	69	83	60	102	101	96	70	93	128	55	66	80	208	82	93	76	66	50	68	88	88	111	49	92	122	109	83	141	74	87	88	97	88	57	78	82	91	90	80	60	107	87	88	122	71	73	72	81	88	96	118	64	92	93	79	95	62	59	73	115	57	78	81	106	83	68	98	70	85	64	72	58	59	71	43	59	62	103	56	68	73	114	75	71	68	86	69	62	73	71	69	88	109	72	63	100	61	64	60	76	71	122	81	69	60	72	107	75	99	65	89	77	51	55	93	79	53	65	78	78	82	85	66	75	79	77	79	66	51	79	97	81	55	98	107	55	79	90	53	68	84	59	61	72	43	71	65	73	77	63	76	75	86	49	62	71	77	50	63	85	68	69	34	68	56	71	58	66	50	43	78	65	37	54	82	108	63	52	63	83	57	119	75	74	56	55	51	70	59	41	63	88	64	57	67	75	59	67	72	53	62	83	62	87	56	62	99	49	34	53	76	36	74	44	47	100	89	75	87	53	90	53	66	83	98	44	59	38	87	77	41	52	58	75	47	94	44	71	70	89	63	61	77	73	74	122	52	74	52	45	44	62	56	51	41	69	52	58	51	59	55	51	58	60	59	73	57	51	40	35	70	46	77	52	55	57	63	45	63	48	51	35	58	41	41	57	53	56	66	50	51	51	76	68	65	63	28	53	41	85	30	63	43	52	54	89	37	45	50	55	65	65	66	64	41	37	63	70	61	56	54	125	70	34	46	65	63	43	31	45	43	40	38	32	54	72	69	34	63	40	48	39	62	57	67	37	36	41	65	37	63	64	24	38	55	43	47	58	49	80	45	51	41	55	39	25	35	41	54	34	49	44	62	39	66	39	37	34	63	32	57	72	43	42	29	83	44	42	46	60	32	56	39	41	33	62	41	28	46	64	52	46	72	63	39	36	24	28	30	38	68	42	33	44	41	60	30	27	42	33	28	39	34	38	44	47	44	45	39	42	51	48	47	55	42	30	35	30	41	55	50	62	56	58	43	52	59	46	36	43	62	28	46	58	37	68	55	39	42	30	42	50	40	29	33	36	45	45	51	34	51	24	59	33	40	47	33	50	38	28	31	21	39	51	24	45	37	30	48	33	36	44	20	22	75	53	37	23	28	28	35	27	31	96	48	20	57	53	30	40	40	25	33	59	29	26	59	20	37	28	60	51	16	26	36	24	37	43	68	61	46	47	37	64	69	43	53	28	40	52	35	29	25	31	25	45	23	32	54	31	32	37	46	46	63	34	25	55	32	40	37	41	26	30	40	45	44	32	32	32	40	32	43	23	35	41	68	35	22	44	46	59	33	19	46	29	32	39	16	34	31	26	28	32	58	51	32	44	40	42	25	28	40	41	45	59	45	23	40	21	31	18	29	17	34	28	23	34	44	31	27	39	24	21	14	41	15	29	40	31	30	31	17	39	22	26	24	39	31	36	20	14	34	29	42	25	33	20	30	45	40	18	37	33	12	32	18	37	30	34	40	13	23	18	32	17	22	29	21	9	22	42	37	26	22	39	32	22	32	12	16	38	45	14	26	17	17	28	43	22	22	21	40	34	14	6	20	23	40	30	27	25	17	45	37	21	22	44	18	28	22	42	23	22	23	26	22	43	39	16	13	45	14	31	20	26	18	21	37	24	19	24	29	20	19	14	30	33	21	23	21	22	22	19	19	16	28	29	51	30	22	22	27	29	17	21	26	22	31	28	16	35	22	20	20	9	16	21	15	18	38	19	33	16	22	30	20	11	15	27	24	14	30	13	16	19	24	16	15	29	30	30	13	26	9	20	19	18	22	39	26	28	15	30	21	26	20	20	29	37	13	28	21	43	18	21	31	19	10	23	14	11	14	8	17	7	10	10	23	14	17	27	15	11	16	12	10	8	25	16	14	20	5	14	16	36	15	11	23	21	14	23	19	7	22	17	28	19	20	14	9	15	31	14	18	11	19	43	17	16	19	14	19	9	12	7	16	35	6	30	31	40	18	17	16	14	7	22	15	8	30	12	18	5	12	8	21	10	6	9	11	22	15	8	8	7	25	18	15	12	23	16	14	7	9	18	8	25	9	21	8	9	10	18	15	11	20	18	15	12	15	8	24	18	13	8	7	12	15	4	7	19	6	9	12	17	8	7	13	10	21	9	4	13	10	14	2	6	9	13	12	12	10	0	6	13	12	6	8	9	1	1	9	5	6	12	15	8	11	8	6	6	10	7	2	4	6	19	17	8	4	4	8	16	12	2	21	19	5	16	3	13	7	15	4	13	23	13	7	7	9	8	7	4	18	7	2	4	7	2	12	1	7	6	11	7	10	14	9	9	9	16	12	12	2	7	2	10	7	2	9	3	4	9	4	3	11	6	2	4	1	5	9	15	4	6	14	3	6	2	7	2	7	2	6	6	5	3	1	6	1	5	9	6	15	5	2	3	7	4	4	5	4	3	3	4	0	7	3	4	4	3	5	2	3	1	5	17	1	8	1	3	2	1	4	9	1	3	4	1	8	1	4	2	1	1	2	3	6	2	2	11	2	1	1	0	1	0	5	8	3	0	1	3	3	4	0	1	4	1	0	6	5	2	1	0	0	0	0	0	0	0	0	0	0	0	0	1	6	0	0	11	1	0	0	0	0
ne0346	845	907	537	392	483	381	370	363	367	414	354	293	298	269	285	242	284	285	235	234	233	214	232	193	252	256	257	265	262	201	224	221	226	195	265	211	184	200	184	226	200	170	142	231	171	168	139	226	200	145	149	160	167	116	181	193	216	181	200	143	148	207	227	246	187	205	144	181	166	184	195	175	178	181	191	232	165	148	191	190	126	216	138	146	121	108	181	134	153	198	163	147	90	166	138	130	110	172	161	146	171	187	175	118	145	147	133	108	112	143	169	168	84	108	96	120	101	123	205	118	155	98	156	159	142	88	141	84	92	103	102	126	126	126	121	136	129	116	85	93	115	144	137	84	125	133	76	114	114	132	92	85	164	120	124	100	120	113	104	150	120	98	89	128	117	117	115	129	128	101	124	83	82	112	85	133	107	91	87	117	34	108	79	130	90	180	88	106	90	120	132	110	68	89	77	117	115	73	136	126	120	127	53	103	105	87	137	137	106	130	81	95	114	100	63	108	78	106	100	92	118	78	128	124	122	92	75	119	99	85	88	123	115	155	90	131	80	100	98	75	79	76	110	68	114	127	106	79	83	100	75	122	87	92	81	65	104	88	116	120	137	71	93	98	132	80	104	79	96	105	73	93	72	85	57	95	93	84	90	97	132	96	76	78	85	172	85	98	58	123	83	92	91	87	51	79	79	97	108	85	70	131	103	115	99	112	64	80	121	59	78	71	79	55	96	115	89	44	72	85	84	121	71	60	74	94	92	63	77	65	72	81	102	51	102	93	88	38	66	90	69	84	120	33	89	94	81	72	76	95	72	89	70	94	81	98	50	89	81	70	83	70	86	87	80	109	68	94	77	83	83	120	93	73	58	98	104	47	89	55	10	65	76	56	52	60	61	79	77	61	43	49	66	50	24	55	76	53	95	44	66	41	49	96	77	69	66	46	83	68	78	53	67	64	58	94	58	61	68	46	76	101	51	91	63	44	63	71	66	69	94	59	86	83	60	72	73	98	79	54	47	61	44	76	60	51	47	92	71	52	73	22	47	68	64	62	64	82	52	49	44	64	74	55	50	62	52	54	65	55	24	55	46	44	38	55	82	62	70	40	42	67	45	43	47	63	53	45	82	49	54	48	60	64	48	41	57	61	60	32	43	50	48	62	80	47	60	44	35	83	54	51	83	26	51	56	41	43	55	52	47	64	54	56	50	48	51	46	56	55	49	49	51	53	33	83	40	50	54	65	73	51	45	33	78	39	40	67	40	56	71	59	48	40	64	48	70	51	39	39	67	63	49	42	36	48	43	70	50	35	25	79	39	50	35	53	111	31	41	33	28	48	50	44	51	44	42	68	32	64	46	31	45	52	66	52	58	53	30	85	68	47	47	31	31	51	41	61	35	17	42	38	26	59	55	46	41	35	34	38	37	45	55	30	50	33	51	52	41	56	39	46	32	55	41	42	45	51	35	46	45	34	36	56	23	30	78	48	38	51	44	52	69	39	42	41	64	43	41	49	34	40	22	19	53	47	33	38	29	67	49	67	42	52	42	55	31	46	53	25	25	51	42	17	19	49	28	34	34	74	35	44	38	44	51	27	24	38	38	46	43	34	27	27	44	40	36	49	15	25	60	31	36	33	26	33	31	29	32	43	47	48	62	44	50	33	54	42	27	31	25	41	59	37	29	40	31	37	30	42	29	42	36	22	45	40	41	48	28	45	13	30	52	40	37	26	32	26	21	29	42	46	48	48	22	35	19	25	44	35	30	42	16	27	29	24	30	17	34	37	24	38	44	35	29	42	26	26	33	49	35	48	30	40	34	43	30	40	45	27	26	34	20	23	24	26	21	33	25	55	26	16	20	48	52	44	52	37	39	30	44	32	14	37	29	73	31	55	25	23	34	29	27	13	37	25	40	23	30	16	29	30	40	33	55	22	35	37	36	71	28	24	44	15	27	27	23	30	20	27	32	29	34	41	31	45	31	30	40	25	32	40	23	25	26	24	42	21	49	21	25	46	45	24	25	27	18	18	19	23	29	23	23	32	23	36	30	35	28	44	37	30	39	33	22	36	34	30	41	37	25	27	10	23	23	19	24	24	21	25	42	24	19	17	28	30	28	31	26	44	21	23	21	46	24	8	19	30	29	29	90	33	27	26	31	26	26	22	30	26	33	26	32	25	28	23	13	5	17	20	21	18	27	18	30	26	30	16	19	16	30	33	25	21	29	19	14	24	19	9	34	20	60	26	24	49	18	26	21	17	38	17	23	22	27	29	32	37	16	32	33	30	26	12	25	23	24	28	22	19	18	28	25	34	14	28	23	25	24	27	37	24	28	18	22	28	36	27	30	26	44	15	16	26	14	13	17	25	23	27	33	21	22	29	28	11	26	26	21	22	10	31	36	17	20	20	27	29	19	20	27	48	13	16	20	21	23	20	28	9	24	14	24	31	29	23	17	15	18	23	16	6	14	21	18	37	27	20	25	17	14	43	14	20	30	20	25	9	14	18	28	14	10	30	17	18	32	26	23	20	35	19	9	22	27	11	30	13	24	24	37	21	19	25	22	19	29	13	37	11	7	26	17	21	29	29	27	21	22	25	14	26	9	17	16	8	18	23	19	22	19	25	19	26	11	24	22	11	14	25	20	11	13	25	33	18	16	11	12	17	31	22	32	23	25	32	23	16	18	16	21	21	26	17	18	22	12	14	17	24	27	26	20	15	26	17	19	16	11	18	22	11	20	13	16	9	20	14	24	24	9	14	17	22	15	15	14	10	6	23	9	9	14	13	9	11	24	20	29	19	18	23	14	16	10	16	6	29	21	3	18	18	41	13	9	30	11	14	18	14	15	16	10	11	23	15	26	27	18	12	29	24	10	6	17	24	21	15	14	16	16	12	19	12	6	13	6	11	11	17	32	12	10	28	15	13	18	15	18	14	18	20	12	6	16	15	16	15	17	15	9	11	7	12	18	49	14	10	10	12	5	2	11	18	16	18	33	8	12	14	15	18	8	14	6	19	13	11	13	6	7	16	8	27	15	10	18	18	35	12	4	9	17	13	6	1	9	17	15	7	28	16	8	22	13	16	3	9	12	19	11	18	11	6	4	25	11	16	18	5	10	7	11	10	14	9	7	22	27	21	15	17	7	8	9	9	15	11	11	11	7	7	12	8	15	18	6	13	13	10	6	15	11	8	10	7	14	14	8	8	7	28	5	10	5	14	3	14	10	5	12	14	6	15	10	9	5	11	30	4	12	19	11	22	22	9	9	13	2	7	6	14	10	13	6	13	5	8	3	16	10	7	19	11	14	3	3	8	12	9	14	13	9	14	7	11	7	4	15	14	14	6	11	27	9	1	12	6	8	3	10	13	6	19	12	8	12	3	8	4	6	6	14	5	6	5	9	10	5	8	4	11	8	4	12	5	17	10	5	8	3	9	8	7	15	13	11	14	8	8	5	4	5	11	4	13	12	13	5	2	5	9	14	4	5	9	7	8	8	5	6	3	10	7	10	10	8	7	5	5	10	8	3	13	2	4	6	8	6	1	14	4	10	8	3	5	2	9	16	3	5	7	10	12	2	3	7	6	5	1	6	3	10	19	4	4	19	6	6	5	7	18	8	1	9	4	3	9	5	5	3	4	11	6	7	1	19	11	9	5	4	5	4	4	2	12	13	2	11	5	3	8	10	1	4	2	9	6	5	2	6	2	3	3	2	1	1	5	7	3	5	3	6	4	5	5	3	2	1	2	3	2	4	2	6	7	1	3	4	6	6	13	2	3	2	3	9	9	5	5	2	7	5	14	2	2	12	3	3	2	2	1	1	2	3	2	6	1	10	3	6	4	4	4	4	6	2	0	8	2	11	3	5	1	2	4	4	3	6	1	3	3	4	8	3	4	1	7	0	4	0	1	0	7	1	8	2	1	0	5	4	10	1	4	4	11	1	4	1	1	2	0	2	2	2	5	2	3	2	1	0	3	1	7	5	1	0	0	1	0	0	0	0	3	1	0	7	1	0	1	0	4	5	3	0	1	1	1	0	2	1	0	1	0	0	0	1	0	0	4	1	0	7	0	0	1	0	0	0	0	0	1	2	0	0	0	0	0	1	0	0	0	1	0	0	0	0	1	0	2	0	2	0	0	0	0	0	0
ne0347	822	796	544	401	443	384	280	367	317	450	275	307	273	271	274	223	220	332	257	247	241	236	271	207	301	253	281	254	229	287	213	185	200	164	285	253	188	221	211	139	195	199	123	191	111	152	134	206	202	175	132	215	167	173	169	184	159	220	173	156	155	145	156	175	179	186	145	135	145	204	209	179	155	123	123	247	128	180	179	163	142	180	92	133	170	105	193	175	97	168	152	159	70	96	134	126	97	242	106	108	135	111	99	79	118	132	141	86	114	114	95	142	86	86	88	198	95	120	128	84	115	79	182	136	174	105	120	120	78	104	136	86	135	105	152	107	112	113	74	111	94	139	92	118	93	132	114	131	140	122	114	101	145	122	128	125	109	117	93	73	157	144	90	127	150	132	134	85	112	79	117	123	99	139	80	123	121	60	101	103	67	96	108	125	66	123	95	105	113	114	123	89	69	107	115	82	85	61	96	91	90	101	96	126	76	87	87	95	96	112	66	87	87	69	58	80	115	119	88	115	144	89	131	100	113	78	140	145	104	109	94	112	93	75	102	138	80	145	117	81	96	128	46	58	78	110	92	114	91	68	92	108	104	105	78	46	78	99	116	96	84	93	107	75	241	66	80	91	133	100	81	99	76	114	75	79	148	60	126	103	71	145	92	68	165	45	101	65	79	67	96	116	106	93	55	85	83	62	62	81	97	80	63	72	94	103	77	77	68	65	103	103	97	67	69	46	91	67	68	88	81	104	86	73	88	52	82	67	81	84	70	81	97	68	90	83	116	58	107	86	47	86	92	33	131	63	85	87	102	93	58	95	84	106	82	78	81	65	50	70	56	54	43	73	95	72	58	115	62	71	76	135	70	65	65	40	79	76	132	100	55	49	81	63	72	70	98	79	72	66	56	62	48	43	57	53	80	58	36	78	79	41	63	70	78	46	57	75	72	81	87	85	52	74	67	62	53	61	74	44	72	112	71	63	59	43	54	83	45	71	44	69	43	108	52	71	97	96	61	54	55	59	49	67	51	60	50	62	77	39	61	54	58	57	69	62	87	79	46	39	56	53	47	55	70	66	56	37	59	28	20	55	52	43	62	49	46	38	63	35	58	41	56	51	43	43	42	46	33	61	61	63	87	60	52	55	59	30	79	47	57	56	41	29	70	55	53	41	50	72	43	69	62	56	60	54	45	29	47	51	52	55	56	69	46	53	53	44	71	31	48	68	69	49	29	54	49	37	108	47	54	30	51	45	35	29	38	85	82	47	33	52	43	67	46	62	67	64	26	57	47	70	43	87	49	49	40	63	25	56	56	38	53	79	40	65	29	47	46	31	52	61	49	44	53	37	60	58	57	70	22	28	48	48	96	91	36	49	37	71	33	58	46	27	41	67	37	56	34	29	49	77	56	33	44	45	42	40	40	49	24	59	38	61	40	24	46	46	57	36	29	63	41	54	41	56	48	38	34	46	36	24	40	36	49	33	72	39	42	57	44	38	59	49	90	39	38	29	43	26	42	26	43	39	55	28	39	39	38	63	125	41	58	35	45	23	47	65	16	42	44	47	43	55	39	31	35	34	24	89	50	52	60	47	18	43	37	45	15	51	45	44	38	43	40	26	42	40	20	36	37	41	47	23	55	37	38	34	40	38	39	33	42	49	87	46	27	50	35	43	52	36	21	44	34	29	27	32	38	20	74	33	40	44	28	56	30	35	25	22	18	33	50	26	36	33	37	30	14	21	53	32	32	31	39	28	17	43	26	39	10	30	34	48	27	38	21	21	28	26	43	31	20	24	51	55	25	35	49	24	33	31	26	46	40	41	22	41	32	25	30	34	33	19	33	13	30	28	22	24	21	29	23	60	51	51	42	34	23	38	44	24	19	20	30	38	17	31	45	23	36	55	29	14	36	43	38	25	37	23	55	30	21	33	51	16	20	26	30	75	91	29	33	40	41	33	35	18	39	41	42	17	38	40	27	28	25	25	25	14	35	34	21	24	57	25	32	29	43	35	25	26	17	51	23	49	18	34	7	31	37	32	39	39	31	27	38	12	22	26	36	34	38	12	49	31	22	15	13	26	16	23	13	21	31	32	30	25	31	31	25	19	26	27	49	60	31	22	29	26	18	29	25	27	32	20	25	15	29	27	21	24	30	19	33	42	15	28	26	41	30	14	20	34	13	31	15	14	47	10	20	23	15	22	23	24	38	24	15	36	29	16	26	19	26	44	33	28	33	13	35	22	29	13	18	65	21	26	33	25	13	19	23	16	19	22	28	22	19	37	19	17	14	15	26	30	19	28	13	25	15	21	25	15	25	25	46	11	39	29	24	9	13	28	15	19	14	18	25	15	30	31	29	35	17	24	27	23	22	20	16	18	22	25	17	12	35	20	25	13	15	14	16	16	31	12	28	19	27	33	20	34	19	19	17	32	30	36	7	24	15	37	19	73	26	21	25	17	16	14	11	11	10	10	11	19	22	11	19	9	18	18	24	19	14	28	21	9	31	19	51	12	13	20	31	19	13	11	19	25	23	37	10	16	18	18	25	11	57	12	20	24	12	17	18	23	22	25	37	21	16	20	13	20	9	42	27	19	12	25	23	11	6	7	11	6	35	9	35	19	27	17	15	20	22	23	28	15	19	19	17	11	22	16	21	9	19	33	11	10	14	10	39	10	12	22	24	22	39	23	9	30	18	6	23	11	20	15	20	20	28	19	9	23	17	37	21	20	19	11	14	23	20	7	8	15	25	15	14	8	13	11	16	17	18	18	11	6	20	12	11	13	8	15	4	24	23	23	18	15	19	16	13	17	11	22	13	12	8	25	17	11	37	19	5	21	12	16	13	6	20	9	16	7	10	6	15	23	15	11	18	11	26	10	22	19	29	20	18	17	8	4	9	19	10	11	15	16	21	14	17	14	13	18	37	10	14	9	9	16	12	19	20	9	18	3	9	28	23	7	11	15	19	13	10	10	7	15	22	18	15	22	13	7	13	6	22	9	11	20	13	7	15	8	13	16	12	9	19	18	6	11	22	21	10	12	8	14	9	13	11	9	12	14	3	6	6	23	9	14	43	26	17	7	26	21	9	7	10	15	5	18	9	9	23	14	4	19	15	10	8	11	19	11	10	11	13	9	18	22	9	8	13	4	12	9	16	11	11	6	21	9	10	11	8	14	1	16	11	4	5	12	8	11	10	12	7	26	8	17	9	11	8	3	10	5	31	16	17	9	10	6	13	25	13	9	10	13	9	2	17	11	12	21	15	10	15	7	3	4	7	7	12	6	9	8	14	7	3	3	4	13	18	1	13	7	7	2	6	11	12	8	2	5	14	11	5	3	4	18	8	12	5	13	8	5	6	12	21	9	13	16	8	25	10	6	3	8	5	8	15	7	20	2	7	7	5	11	2	8	10	7	2	2	6	10	11	10	14	5	1	9	7	19	4	14	11	15	6	10	2	7	4	13	5	8	8	10	5	3	3	7	17	9	7	7	9	10	13	5	10	10	1	6	7	12	16	9	5	4	2	6	4	10	7	5	4	7	9	9	2	7	7	9	17	3	3	10	50	9	4	8	7	4	1	10	7	10	8	3	12	4	8	9	6	10	9	3	11	5	7	7	7	8	6	9	2	9	4	9	5	3	9	5	11	8	9	1	5	18	2	4	5	5	1	11	4	0	0	5	2	5	10	7	2	5	7	3	2	4	2	0	5	1	0	3	4	7	3	2	1	6	5	4	1	4	5	5	4	2	2	1	1	2	3	2	1	12	1	3	7	3	3	4	10	1	2	3	3	5	6	6	4	46	2	5	4	4	0	0	3	2	1	8	3	6	1	6	3	3	1	4	6	5	5	1	9	7	1	4	0	3	3	0	6	1	3	0	5	7	10	3	3	3	1	7	1	3	4	4	2	3	1	1	5	5	1	1	2	2	0	1	5	7	0	11	6	4	2	2	19	0	2	1	1	4	2	0	4	1	2	1	0	4	2	2	3	1	1	1	1	0	2	0	1	0	1	2	1	0	0	4	3	1	16	2	2	0	0	0	1	2	3	2	0	0	1	0	0	1	1	0	1	1	0	1	0	1	1	2	1	0	9	2	0	3	2	0	0	2	0	0	0	0	1	1	1	1	0	5	2	0	1	0	0	0	0	0
ne0348	2997	2997	1611	1454	1352	1359	1402	1255	1094	1295	877	1050	956	899	1011	801	923	751	976	854	925	787	733	733	794	658	796	851	989	879	559	1031	585	632	902	738	624	686	571	803	645	606	653	661	663	565	487	788	673	523	509	522	592	609	826	644	594	568	695	557	521	563	505	757	548	756	523	623	515	470	527	530	652	617	459	609	548	497	690	489	460	682	435	501	444	369	534	444	474	684	645	499	373	539	458	453	396	571	539	527	477	542	604	424	498	377	422	351	387	625	481	600	303	368	334	424	346	476	411	370	518	355	453	621	607	392	415	385	336	363	324	391	314	383	394	426	454	347	303	350	402	489	576	309	337	513	292	412	448	475	356	281	387	362	471	329	378	333	351	492	374	449	254	433	416	345	345	540	259	400	393	304	292	401	260	455	398	279	319	326	246	363	337	458	309	311	382	366	334	377	491	342	406	265	343	382	379	261	452	328	384	367	321	331	383	368	346	433	311	478	265	356	370	294	334	398	246	311	299	316	360	289	339	439	520	359	368	340	361	236	296	427	425	347	348	427	328	314	378	265	378	248	286	250	405	329	301	239	259	238	221	255	312	359	277	211	274	286	307	418	385	284	293	288	348	297	341	281	315	371	262	289	260	236	258	268	329	235	381	266	275	314	253	336	223	302	289	331	245	283	262	309	263	301	284	230	341	336	293	241	257	313	257	348	420	285	237	349	384	221	278	200	262	228	325	323	376	286	282	275	226	287	235	199	214	345	250	208	206	282	236	290	291	273	261	345	263	217	234	221	203	362	324	226	265	260	347	234	224	240	208	271	281	262	246	299	231	242	255	202	207	230	285	220	287	253	220	315	260	346	263	205	239	186	145	288	335	220	231	243	199	211	204	221	217	223	229	201	224	174	219	209	281	269	139	154	198	159	251	214	218	175	217	287	271	246	211	186	234	241	213	224	177	245	211	331	208	257	202	184	185	163	174	243	209	176	195	279	203	202	268	190	225	276	181	148	213	193	222	176	171	201	126	198	195	172	204	322	262	196	243	161	185	184	201	189	195	250	170	153	135	191	146	179	183	190	204	144	167	176	133	190	159	164	179	169	224	175	150	204	183	150	166	174	139	181	280	270	232	168	210	162	171	158	144	104	263	201	209	105	147	186	168	247	185	164	159	129	204	228	194	167	199	122	139	193	158	119	153	125	139	160	179	201	167	153	143	162	193	170	190	174	165	159	160	222	150	139	174	195	199	178	160	131	188	242	173	211	207	177	186	185	206	175	200	158	246	147	151	158	153	184	161	101	184	187	114	193	105	129	147	262	87	178	108	232	277	167	143	150	155	189	164	142	208	204	187	207	166	196	103	153	156	157	148	190	155	119	109	223	168	122	121	132	96	101	127	155	111	174	93	141	135	132	158	133	137	99	118	138	172	136	178	155	190	116	173	152	126	172	147	198	131	173	138	134	142	184	154	108	161	98	176	170	147	93	135	173	142	143	114	114	180	97	121	129	203	185	184	146	123	144	93	78	179	148	119	142	141	238	124	131	148	174	119	142	104	115	165	75	136	141	119	85	119	103	122	64	143	107	113	155	154	113	161	88	107	146	131	105	128	158	113	103	156	125	173	107	116	104	133	140	153	103	105	95	129	114	114	155	170	85	158	143	150	122	108	134	80	123	93	127	161	149	109	125	101	118	89	130	116	98	124	115	107	116	171	104	114	111	77	80	134	148	117	84	131	124	179	79	120	84	153	152	108	92	165	139	105	111	60	173	63	78	60	108	161	79	164	98	92	151	126	113	92	85	145	115	101	147	104	163	119	99	89	160	90	162	111	89	57	118	125	93	98	94	103	116	88	123	86	91	107	99	106	118	110	145	116	96	98	103	60	67	108	121	115	98	124	97	119	123	80	83	80	107	139	112	57	54	135	112	123	86	135	81	88	96	83	145	70	117	134	75	86	90	83	77	95	86	58	108	129	105	110	107	75	77	100	67	91	109	102	108	103	110	152	77	111	127	84	97	79	156	90	133	58	98	108	127	92	49	74	123	83	61	120	89	101	83	115	91	120	70	87	101	136	149	96	119	90	74	71	92	68	90	72	92	74	83	114	96	92	103	71	90	72	58	90	79	91	122	99	172	102	91	57	59	77	105	55	98	62	86	92	87	97	92	77	84	65	71	41	158	59	97	69	66	90	64	116	49	66	77	104	74	107	48	64	59	84	85	127	84	77	71	55	93	80	105	93	70	124	111	58	150	67	67	72	65	124	58	75	39	53	69	120	80	51	102	70	111	57	61	96	79	25	60	60	107	67	114	60	61	57	95	61	73	62	54	126	74	72	64	65	71	173	106	93	74	67	49	76	66	53	79	50	66	71	125	95	52	109	56	56	81	121	86	69	113	64	98	86	66	46	48	84	37	84	81	67	94	39	70	76	64	74	64	70	56	87	84	118	69	76	61	54	43	42	79	57	61	57	55	61	82	130	64	62	64	62	85	46	72	110	63	58	62	37	72	130	41	65	92	83	57	113	58	103	55	96	105	76	77	91	44	73	45	89	78	55	74	73	67	66	74	66	46	92	67	50	72	49	57	64	57	63	48	44	73	54	62	75	102	37	95	92	47	72	42	66	54	66	53	24	86	84	31	82	61	42	33	67	62	77	46	63	54	60	39	75	48	61	47	49	73	46	59	55	73	62	58	73	93	35	44	31	39	84	76	64	96	81	42	72	68	68	47	68	61	85	42	45	35	37	42	55	55	70	54	58	48	41	83	46	54	47	93	50	116	40	25	53	102	52	71	63	52	56	41	46	76	46	32	31	50	43	53	56	27	39	80	74	72	37	81	84	46	42	67	53	62	28	45	54	69	56	32	44	37	71	62	43	30	27	128	77	68	23	73	32	59	27	57	28	40	23	53	51	52	53	53	54	62	29	47	42	35	52	45	46	53	47	35	55	70	56	54	64	28	38	48	31	50	66	39	58	63	42	55	60	15	46	45	42	33	43	43	40	52	33	60	26	122	42	43	34	45	33	31	32	40	35	39	21	25	52	41	28	28	16	38	33	30	52	21	47	44	40	35	54	49	41	44	64	21	32	32	26	61	33	30	47	62	79	77	24	35	45	25	58	37	52	33	27	38	35	73	65	29	48	32	72	30	22	26	47	32	31	33	34	43	25	56	28	42	66	46	29	25	28	54	17	34	55	13	26	57	36	37	31	33	17	27	46	45	44	39	77	34	32	23	37	47	38	48	30	38	35	62	39	41	31	63	32	35	45	30	23	17	25	34	52	47	24	55	26	24	11	19	17	32	45	33	24	18	27	32	22	25	34	52	54	53	52	34	36	19	17	56	59	33	45	23	44	23	31	43	26	17	24	34	23	28	24	24	62	23	11	28	31	14	38	31	33	35	44	60	23	22	21	20	33	25	23	36	34	34	36	30	35	30	20	39	26	29	24	59	43	18	18	16	31	37	22	22	21	24	43	14	11	55	41	17	16	14	23	22	31	27	19	27	24	34	13	21	16	20	19	20	22	20	31	13	37	20	28	13	25	13	20	15	22	31	15	13	21	29	28	19	21	35	18	12	13	25	15	10	25	16	27	17	17	24	30	15	34	22	30	13	21	52	26	9	25	19	25	41	14	25	22	19	24	19	26	8	26	12	17	24	20	27	10	19	20	15	18	4	9	27	14	10	23	18	5	16	13	15	14	26	12	35	17	14	16	18	11	30	24	27	8	12	7	9	21	15	20	11	19	11	16	7	9	16	14	12	14	38	22	6	23	13	8	10	18	12	21	3	13	23	22	19	17	27	14	11	7	27	17	17	5	14	16	13	7	4	16	20	34	17	12	14	18	35	13	9	18	6	9	5	17	9	13	7	8	8	11	13	26	9	21	6	11	24	7	5	12	24	4	49	2	9	8	15	8	20	7	4	10	7	6	14	5	17	5	4	6	6	4	18	9	7	11	6	2	7	3	9	3	7	17	6	4	14	16	5	0	7	31	3	6	6	6	5	4	2	11	9	32	1	2	13	23	3	3	13	1	4	2	4	10	14	5	13	3	6	4	1	4	7	2	2	2	2	3	2	3	2	7	4	1	0	3	1	6	26	2	21	5	1	1	0	2	3	0	1	1	2	1	5	2	0	0	2	0	0	0	0
ne0349	287	560	225	252	140	106	134	70	126	129	86	78	120	100	223	114	73	110	140	95	122	76	161	85	100	102	181	73	86	211	105	64	50	48	100	133	59	62	65	118	81	67	52	65	72	89	38	60	89	54	40	73	58	60	49	91	81	93	68	69	48	83	115	64	65	40	47	61	72	69	104	73	80	96	69	84	66	73	55	46	40	49	38	62	94	37	62	63	62	57	93	74	33	74	30	46	33	61	43	48	53	68	74	31	38	29	57	39	50	43	30	49	43	38	37	37	33	56	52	20	61	17	89	30	43	81	36	50	27	26	42	41	44	54	60	62	40	46	20	32	50	39	32	33	35	60	45	43	29	70	24	44	42	46	46	69	42	40	16	64	41	36	45	61	49	40	51	113	37	44	60	59	26	100	21	57	44	22	39	44	50	83	39	35	33	49	34	35	26	42	73	18	34	21	40	49	36	19	40	36	33	33	36	43	35	35	34	14	60	32	21	48	35	41	71	75	33	85	41	49	76	46	49	21	80	66	41	67	23	28	48	27	15	40	22	76	51	53	60	26	44	65	42	48	30	18	44	19	30	42	31	39	34	22	54	15	39	33	30	15	36	40	33	18	33	38	27	44	38	40	48	34	21	29	30	35	36	39	57	35	31	28	37	20	43	39	65	29	15	25	50	30	47	14	38	53	43	45	21	27	38	64	45	22	18	63	33	75	20	48	51	53	51	20	37	31	23	42	34	29	37	52	26	51	15	56	22	27	18	39	21	24	27	25	30	16	40	64	46	31	26	21	53	55	28	18	19	71	33	23	27	35	39	33	17	26	29	29	39	21	34	42	28	26	35	25	24	48	21	17	29	26	22	22	27	28	19	55	33	27	20	47	29	21	68	32	14	35	24	23	34	26	11	25	22	24	29	33	19	19	31	79	15	15	25	25	28	87	22	36	21	19	20	17	20	19	37	25	35	21	18	30	22	27	45	42	27	21	31	18	28	28	22	31	20	23	50	18	20	23	21	66	15	24	21	18	26	17	36	9	33	24	21	21	34	25	25	25	27	28	11	11	18	24	38	13	30	28	17	25	9	7	19	21	24	24	6	20	16	16	22	39	28	21	17	11	13	14	37	39	21	25	25	34	34	22	10	19	18	28	17	29	14	18	38	22	18	25	16	16	9	36	16	17	24	51	23	16	16	17	22	16	42	35	11	23	20	9	51	11	12	55	23	20	23	11	18	19	40	32	23	24	32	22	12	22	23	41	32	15	33	18	4	11	30	35	12	14	8	19	21	53	22	17	16	15	19	15	24	20	21	13	17	20	21	35	25	18	17	9	30	11	16	17	8	13	15	31	51	15	9	16	27	34	15	31	20	23	26	15	16	22	40	32	16	33	5	14	21	15	16	10	36	7	32	17	13	14	28	31	13	23	8	63	13	17	18	25	18	17	8	8	20	27	20	35	14	12	21	16	20	31	40	9	20	10	30	3	37	15	28	11	9	14	17	13	6	15	40	17	18	9	12	12	37	11	15	21	25	9	25	26	16	17	18	14	15	19	18	28	18	17	10	11	24	10	13	13	20	8	15	4	21	13	10	11	8	31	13	23	17	17	5	23	9	6	22	18	9	45	8	12	44	26	15	9	14	17	13	26	14	12	7	28	24	14	8	11	18	12	16	13	46	16	7	22	18	4	7	8	22	14	14	9	14	15	23	12	4	9	10	15	20	8	17	10	13	11	19	8	12	12	10	11	10	7	13	16	8	15	22	8	26	14	11	17	4	18	2	19	13	14	16	11	7	12	12	10	9	20	14	9	8	12	17	11	4	9	6	15	8	13	12	13	8	5	7	24	7	16	30	14	10	18	8	14	14	11	14	10	16	13	14	10	9	11	10	12	11	14	13	14	10	29	10	7	4	14	13	7	15	10	16	13	9	30	11	9	6	31	17	7	4	14	11	19	15	9	27	11	17	9	10	15	7	9	14	12	9	12	14	30	11	9	32	25	8	9	11	5	16	6	12	27	5	16	11	29	4	10	8	12	10	8	6	11	7	11	8	11	20	5	7	4	12	7	20	2	18	10	10	5	12	14	6	9	8	6	11	7	16	6	8	13	10	12	12	25	6	9	8	2	5	7	17	18	14	11	7	10	7	10	18	8	12	7	11	11	11	1	10	10	13	9	9	29	11	35	10	8	4	21	9	16	5	14	8	9	5	10	10	13	13	10	25	5	7	8	14	20	13	11	7	4	14	13	8	9	12	19	8	9	9	10	6	4	21	4	5	11	7	10	8	9	13	16	7	6	12	7	4	10	4	9	10	8	5	4	16	21	13	8	8	13	15	5	12	12	5	8	11	5	4	2	6	14	7	20	18	3	10	11	11	7	5	17	9	6	5	9	5	2	15	4	6	12	8	9	6	7	6	4	7	15	3	15	3	7	7	4	5	12	14	8	7	11	4	3	0	10	5	6	4	8	7	4	7	11	4	18	8	9	16	10	2	7	4	7	7	8	11	8	16	18	15	10	14	7	6	6	9	4	6	14	5	12	3	12	6	9	5	9	5	6	11	6	8	15	9	12	3	7	7	0	4	8	6	5	6	9	26	19	2	11	11	5	8	11	9	11	7	6	3	18	4	7	3	4	6	1	9	8	3	6	5	10	8	7	5	5	4	7	7	7	11	7	7	8	17	13	4	7	7	4	6	2	12	7	12	7	4	4	7	12	10	7	8	7	9	7	4	8	1	5	16	6	2	8	3	6	16	1	16	3	3	6	4	8	18	10	15	5	2	5	11	9	11	15	4	5	8	6	9	3	3	7	10	14	7	8	7	4	2	5	4	8	2	8	8	5	7	5	6	3	2	8	7	7	9	6	5	11	1	4	9	6	4	5	6	8	8	8	3	13	4	20	3	7	10	11	7	21	2	12	2	12	4	1	3	5	9	3	7	3	2	6	2	6	7	12	7	8	1	5	6	2	2	5	4	8	37	10	3	1	5	6	7	2	1	18	5	2	8	1	5	8	14	2	17	12	5	4	4	1	4	1	1	7	3	2	10	8	0	3	3	7	0	4	7	8	1	15	8	9	7	6	3	10	5	1	13	5	1	5	20	9	6	5	4	3	7	2	3	4	4	6	3	6	5	6	7	1	10	4	7	1	7	4	2	3	4	0	0	5	5	2	2	0	9	2	8	4	3	19	8	8	13	7	6	7	10	8	1	7	2	4	2	5	1	2	4	7	2	3	3	7	7	6	8	4	2	0	8	6	6	6	5	12	9	1	10	10	0	5	3	3	2	8	8	10	1	8	5	2	1	1	4	3	13	4	4	4	4	10	6	0	2	6	6	3	1	4	5	8	11	3	4	17	4	2	2	3	8	2	5	4	4	4	1	0	21	4	7	1	7	2	5	5	3	2	4	1	7	11	0	5	3	0	16	9	6	5	5	5	4	4	4	3	5	3	5	2	4	0	5	1	0	1	9	4	3	6	0	3	4	2	2	1	2	7	2	2	2	1	4	2	5	0	16	1	2	10	4	1	0	4	3	2	4	0	9	3	1	2	2	8	6	6	4	3	3	3	3	2	5	3	5	5	4	2	4	4	3	5	0	1	5	4	2	2	1	3	1	1	3	0	0	3	3	3	4	4	14	5	0	3	5	3	2	2	3	0	1	0	1	1	4	2	0	1	2	3	2	1	3	2	4	3	4	3	4	1	0	3	2	5	3	3	2	3	0	2	0	0	4	2	2	2	3	3	2	2	2	0	3	0	2	2	2	8	1	0	3	2	1	1	1	0	2	0	1	1	1	1	5	6	0	1	4	4	1	1	0	0	0	0	0	1	1	0	2	1	1	3	1	4	1	0	0	1	1	1	4	2	1	1	5	0	4	0	7	3	1	0	2	1	0	7	0	0	0	2	1	4	0	1	2	7	2	0	1	4	1	0	1	1	0	0	1	0	1	0	2	1	0	4	0	0	0	0	2	1	2	0	0	1	0	3	4	1	0	1	3	2	0	1	0	1	3	1	0	1	2	0	1	2	0	1	0	0	2	1	0	2	1	0	0	1	0	0	0	1	0	0	0	0	0	1	0	0	3	0	0	1	5	0	0	2	0	0	0	0	0	0	0	1	0	0	0	1	0	0	0	0	1	0	0	0
ne0352	4297	4338	1868	2573	1678	2324	2086	2137	1393	1924	1323	1796	1889	1713	1683	1543	1782	699	1524	1660	1704	1131	1080	821	1027	803	1531	923	1285	1404	853	803	715	1219	1299	932	818	907	867	1882	857	755	575	951	813	1273	1052	1196	1245	598	1175	682	626	772	576	964	617	848	781	608	1238	629	797	1240	561	828	1159	588	610	636	607	727	639	1152	618	1392	1043	528	586	560	675	690	1006	646	930	865	470	521	618	617	686	877	1036	1109	360	629	844	870	547	403	573	584	537	914	617	487	864	1042	661	487	697	557	922	1054	850	547	863	739	380	970	965	838	632	569	548	618	622	250	905	906	516	593	374	397	842	682	356	265	845	279	723	677	441	310	513	684	568	479	430	841	409	307	620	445	621	452	756	508	883	567	363	456	422	741	653	461	404	967	357	376	851	238	454	670	813	488	433	858	476	273	479	552	323	813	278	436	371	443	422	454	821	612	271	310	338	363	363	804	973	447	306	226	204	340	325	600	360	431	485	423	779	541	441	509	482	795	277	516	520	363	683	289	450	481	697	471	391	655	295	210	543	326	352	406	484	605	406	420	466	259	594	443	376	618	718	423	389	276	250	417	246	331	502	278	354	728	249	552	550	339	334	448	269	442	470	409	423	389	345	429	233	371	359	304	456	338	371	326	401	326	256	381	266	255	437	324	488	397	300	409	299	469	386	377	471	182	296	713	454	174	348	327	353	341	372	361	485	584	703	290	438	250	385	314	235	583	340	570	207	503	512	453	233	372	418	346	397	274	375	341	301	545	437	227	294	288	503	551	371	228	371	315	544	439	437	246	325	431	248	143	211	379	340	180	166	403	299	309	331	190	199	186	254	237	424	275	338	380	346	231	228	283	235	252	195	260	635	359	381	293	295	253	257	379	435	358	205	397	271	247	325	379	296	422	215	184	291	188	167	188	233	518	371	234	313	308	303	470	320	370	188	243	177	355	240	584	247	352	429	246	284	353	412	431	231	518	268	275	341	317	205	312	170	325	215	276	309	245	454	175	263	418	272	164	374	165	375	539	427	203	298	186	261	150	264	253	282	226	233	281	234	270	293	289	174	253	240	268	301	228	263	236	287	111	334	190	246	234	228	193	213	268	199	244	280	286	166	283	273	287	202	169	348	289	334	189	233	255	172	257	156	321	288	197	253	231	199	189	302	272	191	251	302	180	158	357	142	342	166	123	155	212	263	285	254	152	253	273	266	292	315	377	217	210	224	149	203	242	271	256	192	232	243	139	367	107	171	310	356	262	184	241	290	163	348	250	214	206	192	124	231	407	281	128	158	218	143	263	95	164	81	561	174	140	86	263	191	96	200	289	213	181	88	153	230	229	187	192	282	359	170	215	301	292	286	178	251	122	177	186	266	234	314	187	141	142	160	209	153	167	166	356	221	230	244	149	142	114	154	208	128	329	191	358	194	207	217	246	163	104	219	182	158	267	242	303	133	195	163	314	177	336	202	172	144	121	201	135	262	110	266	190	126	235	120	172	132	178	313	108	251	257	163	90	218	171	176	167	164	134	296	253	168	208	208	117	135	140	163	155	159	147	148	138	209	156	279	154	409	189	138	211	194	138	164	144	206	196	193	188	160	154	102	126	187	134	169	275	153	301	260	190	206	110	144	162	179	217	104	220	175	125	208	200	250	119	120	150	61	192	177	180	257	288	88	204	282	173	166	153	229	129	177	215	107	124	61	158	172	66	179	81	139	156	287	112	148	217	195	136	168	216	157	202	71	241	125	237	121	198	131	197	185	69	130	105	284	109	197	150	240	193	142	140	160	126	116	130	114	164	143	151	283	197	139	154	176	141	144	176	99	82	110	213	128	167	107	149	128	197	136	137	140	109	143	247	148	162	121	157	147	241	143	96	93	195	181	224	54	35	128	89	145	250	147	110	103	112	118	105	154	169	116	77	182	126	101	52	163	152	188	92	124	192	156	122	160	171	169	134	259	177	176	108	113	126	201	81	95	86	145	229	183	159	99	162	153	79	66	135	105	284	181	214	136	351	140	209	169	71	165	177	89	157	185	76	212	135	131	134	142	140	82	111	159	163	191	200	128	117	122	82	195	122	101	133	126	141	147	45	171	170	46	102	101	142	123	281	105	149	113	97	95	114	99	137	84	123	104	192	122	144	86	84	149	99	192	200	181	206	103	133	152	71	77	237	121	157	74	133	117	59	222	147	80	174	179	113	92	112	148	120	199	79	136	50	56	103	124	140	126	49	159	86	74	131	51	195	128	135	109	130	146	124	88	71	123	84	129	146	122	125	155	199	98	141	69	165	129	61	90	135	94	116	93	76	106	74	80	124	145	93	91	135	94	113	65	90	67	48	84	113	107	152	97	122	112	99	148	109	73	83	138	178	105	91	145	73	115	95	54	57	197	134	58	66	158	65	109	63	104	123	51	75	137	115	44	60	88	38	96	114	130	116	81	123	79	52	105	82	109	136	78	116	66	84	146	107	127	112	179	186	92	61	199	70	112	132	45	82	101	82	185	149	112	122	91	146	72	44	90	113	86	161	60	85	58	88	67	53	108	48	80	144	88	93	73	71	76	70	97	51	60	73	43	93	85	164	104	116	162	106	76	112	89	57	158	88	35	68	91	67	59	84	43	113	59	126	59	82	83	75	41	131	40	80	99	157	153	87	94	76	58	71	200	84	88	100	132	88	48	77	207	72	85	67	86	68	106	49	120	78	123	123	164	109	92	97	100	121	136	75	115	123	90	54	188	148	39	123	41	24	80	78	145	68	42	62	124	87	100	65	119	102	32	25	111	56	65	73	96	53	140	39	55	101	101	53	98	112	82	89	73	66	65	49	89	120	55	124	53	36	58	123	101	92	43	43	73	72	142	57	89	64	74	123	63	112	22	73	59	48	95	118	72	98	25	90	71	82	57	94	38	140	68	133	116	83	76	48	72	48	89	41	23	63	78	98	102	38	106	71	38	63	55	88	93	48	56	90	162	76	83	69	31	70	140	54	112	53	53	87	53	118	55	61	72	49	93	52	43	76	105	106	60	30	47	44	59	57	43	66	66	47	61	90	79	44	58	119	50	42	62	104	86	77	16	46	54	109	112	102	48	63	158	66	25	55	64	127	71	43	64	73	74	86	49	91	54	90	93	29	59	62	33	79	75	48	76	89	85	45	34	55	48	47	51	62	71	79	65	101	100	73	92	32	89	143	68	87	43	136	74	21	62	79	72	64	51	46	105	73	58	55	16	57	76	51	58	37	75	50	52	25	71	108	45	26	47	39	54	53	22	47	70	62	73	58	13	71	35	30	31	45	41	45	47	95	118	45	50	35	21	44	52	57	90	33	59	47	22	53	89	61	43	32	27	218	36	33	38	69	58	37	42	35	50	46	24	94	49	47	45	25	86	36	24	44	66	61	47	80	45	39	64	38	38	20	39	47	24	67	21	22	72	55	34	109	90	26	32	72	39	104	28	59	47	25	65	42	20	77	29	31	30	41	45	64	35	44	54	64	59	34	58	55	29	31	59	50	30	60	16	65	32	68	18	31	25	35	26	55	18	45	21	78	54	28	57	35	39	21	46	44	25	27	74	78	29	10	54	25	25	36	33	57	46	63	26	70	45	26	19	51	31	29	36	58	62	53	56	98	47	32	36	35	54	69	23	36	29	97	21	13	22	22	35	45	21	39	18	20	50	20	22	16	13	28	29	13	18	17	8	38	46	36	16	59	35	16	27	17	27	23	30	42	23	14	51	25	77	16	18	28	18	75	15	66	49	33	19	29	48	42	17	13	17	20	18	34	27	9	66	27	42	25	28	44	5	22	11	26	25	31	12	15	17	24	27	8	29	19	32	26	52	16	33	22	40	9	18	18	27	7	21	10	39	37	22	27	26	12	12	18	34	23	25	36	18	47	35	19	27	7	68	5	17	5	18	27	8	17	30	16	11	21	34	14	26	14	15	22	11	53	35	29	8	8	10	11	24	7	25	15	10	7	11	18	25	6	33	7	16	23	10	9	5	9	21	20	7	10	43	11	9	3	11	13	4	5	4	8	44	4	7	10	10	3	2	26	8	2	15	12	3	15	31	16	8	10	14	29	21	13	8	9	4	2	7	3	2	1	4	4	2	5	0	8	4	25	2	3	2	5	1	0	0	3
ne0354	1929	1702	1410	661	1345	610	694	554	758	703	620	621	591	640	505	536	491	523	384	560	451	526	635	451	559	635	500	528	428	455	673	379	575	383	455	537	524	489	549	337	402	547	351	457	240	303	397	283	306	506	286	456	513	284	294	367	406	423	444	504	299	385	437	345	563	299	282	352	335	273	694	363	355	264	374	362	310	306	384	399	355	430	268	217	471	353	319	442	314	392	221	276	230	260	378	375	253	414	241	289	317	274	275	264	282	426	282	218	238	212	254	309	270	237	258	278	227	198	279	229	273	227	369	265	278	260	310	394	209	250	362	253	344	427	299	315	228	359	207	271	292	178	201	269	367	212	244	291	218	275	293	345	194	279	224	383	219	208	198	130	205	241	398	262	218	325	324	246	263	218	219	249	305	190	199	307	202	204	328	272	140	180	428	161	332	231	317	166	276	196	260	198	150	325	289	119	311	205	213	164	250	320	318	231	273	147	203	209	180	210	205	134	146	179	240	245	205	242	193	194	158	289	302	201	182	159	197	225	180	161	193	246	197	220	168	274	158	263	136	234	136	251	152	221	214	236	131	207	148	131	266	174	262	186	166	167	214	289	210	186	146	164	273	168	245	231	140	169	219	345	229	239	133	235	122	297	184	126	214	227	239	225	249	341	141	383	134	218	198	120	168	115	217	141	120	291	118	111	216	212	193	184	256	146	159	183	191	232	84	209	178	359	174	194	173	155	172	302	159	183	220	243	194	157	153	125	195	142	144	199	149	120	159	170	146	149	138	119	115	145	145	142	158	101	98	171	171	134	184	171	181	145	112	124	171	94	141	114	137	212	189	248	112	188	112	101	148	162	87	139	162	183	161	123	180	216	126	86	173	169	107	160	153	95	112	142	156	92	149	135	131	259	106	185	154	168	154	106	219	183	170	78	91	128	130	135	135	163	94	96	172	147	119	86	91	84	144	83	166	85	115	165	81	102	87	154	80	165	131	131	64	145	123	146	133	89	156	118	112	173	67	131	113	132	129	173	227	91	137	75	149	131	141	135	95	128	115	101	105	115	110	78	96	152	180	102	159	75	139	66	136	66	114	221	77	117	114	76	158	139	112	132	145	124	96	127	35	105	41	92	94	150	123	138	180	170	74	150	130	113	161	107	65	69	45	90	182	97	75	108	68	93	71	132	168	148	131	106	93	105	158	124	112	93	108	153	77	87	124	114	76	102	87	126	96	126	182	67	108	123	131	91	79	99	148	81	169	93	162	88	114	65	72	105	161	104	80	136	69	144	92	103	64	122	89	66	140	91	87	127	169	55	116	134	138	37	49	119	90	82	48	89	140	94	80	129	61	100	58	71	57	42	75	81	119	117	79	80	76	92	77	101	122	82	131	109	119	78	129	191	74	49	85	99	117	145	101	129	119	74	146	93	67	118	55	67	113	62	71	87	80	102	79	108	98	65	122	52	86	72	107	72	96	72	130	108	85	63	73	102	267	82	100	105	134	61	60	48	78	107	62	73	95	127	96	81	73	85	76	90	131	92	73	26	82	93	93	100	45	103	86	78	95	107	89	32	86	90	71	95	99	58	82	78	126	79	37	127	67	136	97	58	127	190	57	49	79	82	77	80	58	46	95	116	83	74	28	82	54	142	84	82	59	48	89	84	61	92	115	74	78	94	54	86	60	74	81	63	94	47	62	67	122	54	49	99	41	65	65	94	50	111	108	41	91	106	38	73	100	75	41	31	42	52	67	87	78	53	72	84	69	42	74	51	85	71	38	70	47	51	51	55	51	49	60	73	37	27	96	50	86	47	40	87	35	54	66	72	52	85	57	66	93	44	29	60	90	79	63	40	111	51	54	66	64	41	65	53	48	91	22	43	42	57	46	61	58	57	62	114	85	78	51	68	59	53	56	59	86	44	47	78	10	83	78	40	104	68	47	62	61	57	32	34	67	52	45	70	45	57	92	38	25	69	51	43	64	49	53	102	75	69	70	26	88	75	43	66	68	52	82	73	41	36	30	48	61	40	75	60	66	47	84	80	57	39	29	37	36	36	50	52	56	52	81	47	22	68	61	57	80	36	39	30	71	87	90	53	31	75	44	34	63	39	123	32	45	42	52	92	75	31	39	36	53	65	54	51	71	46	47	33	68	41	55	41	27	47	59	29	31	52	88	30	49	59	69	45	69	50	33	61	32	35	51	60	32	38	48	36	33	63	48	30	69	62	71	37	53	34	53	33	41	44	36	51	28	23	44	16	62	54	71	44	77	43	34	36	50	42	56	52	73	24	40	50	37	78	41	23	27	23	52	50	24	33	49	43	30	41	37	60	34	37	49	52	14	46	45	73	31	46	20	33	38	57	31	81	25	20	74	47	42	34	72	32	28	38	36	42	37	64	35	38	60	46	50	55	64	49	24	49	57	40	20	30	37	48	76	42	40	40	43	46	31	28	28	73	52	17	49	26	110	25	44	33	30	53	18	34	29	41	48	58	18	61	61	48	68	23	44	39	23	34	44	28	59	33	28	29	165	20	39	32	16	47	29	55	53	59	47	24	31	19	77	24	52	72	49	19	30	43	45	28	47	51	45	70	46	34	18	25	43	27	38	30	24	60	65	38	24	57	121	38	50	24	36	21	34	18	31	58	70	34	24	38	91	45	22	61	22	34	48	24	27	35	34	27	33	49	15	16	16	57	39	139	42	28	35	46	23	41	22	23	31	22	36	16	70	13	16	24	70	42	37	43	26	38	51	18	40	15	17	27	27	29	43	47	40	38	31	68	17	43	65	41	36	25	37	31	43	25	29	23	43	52	31	75	26	48	16	31	19	24	36	34	67	33	16	62	18	22	20	27	52	35	36	12	43	22	19	30	37	11	26	31	14	27	22	37	24	33	24	35	53	31	42	39	70	34	35	37	34	35	18	70	24	31	26	28	19	32	29	82	57	18	16	29	26	36	17	47	41	21	26	51	28	21	24	22	13	20	33	48	35	133	22	36	15	20	91	28	44	16	21	18	53	36	46	20	21	57	27	26	28	42	31	40	24	16	28	10	12	18	18	66	31	23	22	51	33	23	43	18	24	16	23	42	45	8	17	38	15	51	14	20	30	53	14	19	18	30	5	21	27	42	17	14	50	32	14	29	22	30	37	15	15	28	14	14	14	17	17	10	13	24	48	15	25	20	16	18	13	23	10	25	49	18	19	15	33	22	14	26	15	36	16	16	11	25	9	17	97	14	13	25	32	10	30	17	25	7	30	37	18	19	19	18	15	30	19	21	24	25	27	19	18	18	43	25	26	18	33	15	40	17	27	26	31	31	20	15	8	20	37	15	11	18	25	12	7	17	11	10	16	64	16	30	20	113	9	72	14	30	39	21	16	20	11	7	15	23	6	11	32	7	17	30	46	32	12	26	11	4	21	5	10	10	17	10	13	13	16	11	14	20	3	13	16	15	24	11	15	5	17	15	18	14	22	18	18	9	19	11	13	14	31	25	12	15	10	22	23	19	1	25	14	30	10	13	18	24	10	3	16	10	6	16	22	9	22	4	10	19	33	37	15	25	14	23	8	6	18	15	101	14	17	9	6	13	15	19	17	15	12	13	17	11	13	4	13	4	45	5	6	15	2	22	24	13	12	13	13	4	6	21	8	15	16	21	6	9	7	8	12	93	14	5	15	10	17	10	4	9	10	8	15	7	2	7	14	19	17	5	10	8	21	13	7	13	14	16	15	8	11	5	17	95	3	1	12	6	7	16	3	3	4	7	11	10	10	12	4	6	5	18	5	13	1	10	13	5	13	7	6	12	7	10	9	14	10	17	8	7	11	5	13	11	9	10	4	5	4	6	6	11	8	13	4	3	16	10	13	37	5	4	12	8	13	23	5	9	4	7	13	2	5	5	4	0	5	11	7	5	10	4	6	2	2	4	10	8	7	6	11	9	1	11	5	4	2	9	5	7	13	2	2	5	3	4	6	4	2	4	6	3	6	6	2	4	3	4	8	6	2	6	2	4	2	7	4	5	4	5	1	2	5	0	4	7	2	1	3	4	2	4	2	0	2	1	1	1	3	5	2	4	0	9	1	3	1	4	1	1	1	0	3	0	0	0	0	0	0	2	1	1	0	4	0	5	2	0	0	1	0	0	2	0
ne0355	2228	1695	1218	916	1304	787	1078	773	747	806	688	739	785	790	630	618	615	512	512	610	658	657	507	526	575	548	467	625	580	497	624	462	740	545	413	540	546	590	556	611	422	565	319	542	384	444	434	428	327	547	424	496	569	300	441	406	367	278	506	566	371	310	415	388	557	404	379	380	328	248	535	410	316	488	422	352	308	367	445	346	365	396	400	276	283	377	301	469	353	465	333	327	326	460	298	332	354	341	292	368	416	312	285	336	305	555	255	304	214	350	240	357	342	333	315	254	309	204	262	347	237	304	212	294	350	216	332	290	304	321	370	367	226	324	295	288	263	365	274	274	329	227	206	257	349	248	263	271	270	375	296	267	284	304	247	193	255	202	270	191	221	254	400	311	172	277	259	287	307	295	239	221	288	217	257	274	246	277	219	232	112	215	250	203	322	198	315	200	256	209	227	282	209	343	248	252	218	261	314	233	334	270	279	215	228	195	185	300	190	264	255	175	171	294	143	270	204	199	265	219	185	321	297	351	179	193	223	271	147	176	160	276	241	176	175	317	240	256	160	199	273	180	236	160	204	308	181	256	159	157	211	190	152	222	172	235	239	271	223	246	198	189	244	264	228	240	238	129	199	223	194	238	162	230	124	173	151	148	176	174	174	233	175	253	144	149	156	200	237	132	252	153	155	197	92	180	217	162	283	241	277	112	299	196	217	168	265	218	168	203	150	222	136	165	145	147	226	316	181	193	233	224	148	120	239	201	199	139	182	207	130	132	220	154	192	217	141	101	151	197	157	204	204	70	115	119	239	164	212	175	171	159	122	135	173	132	127	99	123	147	242	134	164	202	139	168	151	133	120	211	127	190	217	131	161	198	169	95	200	123	78	205	131	107	88	136	117	129	154	154	140	95	115	185	167	152	149	102	133	212	139	147	108	109	155	87	134	113	131	156	150	179	158	104	113	138	206	108	167	109	89	155	124	169	117	325	114	154	123	151	155	101	107	122	120	125	104	123	133	218	101	123	98	172	166	137	135	119	165	103	116	160	114	114	65	138	87	90	99	118	116	67	126	101	132	86	110	90	126	95	46	111	105	200	90	113	124	104	161	92	112	89	172	88	118	96	79	81	140	64	193	135	89	151	112	197	91	155	143	118	122	73	114	208	155	155	100	83	140	138	90	81	123	112	119	135	124	304	105	149	128	164	118	107	113	125	91	118	117	102	118	78	101	119	126	188	110	65	73	99	105	88	106	93	163	75	115	52	152	118	83	77	79	110	161	107	115	106	62	168	128	80	62	101	89	79	96	106	93	109	156	105	129	120	107	114	85	132	68	87	62	114	105	103	110	97	44	77	70	87	65	46	48	68	109	60	81	85	103	97	92	86	70	88	116	59	113	122	88	78	79	70	70	84	122	109	60	102	108	71	104	74	73	69	56	94	76	91	83	60	85	103	67	144	74	76	135	76	66	62	117	57	90	76	103	68	93	77	80	112	162	80	144	129	101	75	78	126	72	196	71	72	88	109	93	91	84	87	54	55	78	98	103	133	106	128	60	75	75	77	147	97	127	105	51	222	66	64	273	117	102	94	90	84	93	83	31	145	63	148	79	82	134	77	46	56	63	77	71	57	85	110	64	140	130	63	49	63	87	115	36	63	90	49	41	72	72	97	90	65	42	54	56	54	78	62	59	56	94	49	32	77	64	73	65	125	66	151	92	54	53	84	52	54	100	83	58	92	123	69	63	46	59	84	99	67	56	59	98	75	81	64	78	56	70	107	55	33	60	77	56	54	69	69	46	48	60	42	64	51	109	47	48	90	41	68	78	82	76	65	63	72	55	46	46	60	84	77	60	74	66	32	77	135	82	71	44	51	56	50	64	42	21	54	49	70	67	89	93	66	48	63	48	31	89	111	48	44	91	61	67	45	98	95	81	32	56	51	49	73	44	50	72	52	72	59	59	47	41	40	74	48	53	65	31	60	55	42	73	38	74	55	45	47	43	63	52	41	69	56	49	146	55	54	56	26	52	35	64	23	56	42	52	61	60	67	50	59	62	41	48	80	45	99	118	44	42	80	41	58	65	49	38	32	52	57	83	50	38	41	53	42	61	44	63	56	64	37	32	67	48	33	83	50	35	51	89	45	67	46	54	48	39	35	48	49	60	49	64	37	39	57	50	44	43	57	58	22	68	55	55	61	29	30	79	52	46	62	61	34	46	69	52	22	42	57	54	46	45	30	32	52	26	47	41	45	51	34	24	38	26	45	74	49	93	50	49	37	35	54	40	77	40	65	50	35	30	38	53	34	28	39	52	49	32	44	42	40	30	49	45	44	42	33	39	51	40	37	66	44	28	59	15	36	48	68	59	42	35	38	44	64	66	29	43	35	48	34	31	38	26	70	39	44	58	45	44	56	49	40	39	37	52	38	38	49	50	76	60	46	31	36	25	30	45	33	41	37	59	44	49	37	39	27	29	53	45	45	64	93	48	31	34	47	39	35	89	26	54	63	35	25	43	49	50	33	64	34	46	26	60	31	58	30	35	33	72	51	72	23	63	26	42	66	33	34	33	45	46	36	36	52	47	32	44	27	49	25	82	19	18	109	35	47	36	22	37	44	39	52	47	29	32	51	31	55	94	36	40	43	33	27	62	28	34	43	43	29	23	62	34	26	21	29	29	51	32	45	33	34	42	19	27	30	43	22	34	29	30	69	25	50	31	21	24	26	34	39	50	34	33	29	54	24	37	22	33	24	44	28	65	24	16	48	26	44	58	36	37	33	35	29	32	36	85	42	38	39	21	48	34	47	78	34	38	54	46	110	13	15	21	31	35	27	43	22	73	31	21	46	20	24	20	38	24	69	49	28	39	39	28	25	34	27	13	42	20	34	26	27	14	31	38	32	19	47	29	23	41	29	59	18	25	33	26	46	37	30	49	29	14	41	29	34	72	24	29	26	19	34	32	35	39	43	25	27	29	22	15	22	13	19	36	36	48	26	24	19	31	28	42	25	26	27	30	27	52	23	15	24	25	27	35	30	24	64	36	34	20	30	17	15	17	26	18	24	14	39	65	17	45	24	51	15	30	14	24	44	90	24	11	35	21	24	16	11	28	20	30	27	19	43	10	23	49	16	15	29	26	37	30	15	26	22	34	22	23	49	15	40	6	13	18	15	30	21	33	29	37	32	25	19	12	15	22	17	20	33	28	18	18	23	12	15	15	17	17	16	12	14	13	10	26	14	14	10	68	33	41	27	23	13	14	24	12	23	15	25	24	41	11	25	24	26	12	19	23	19	8	24	26	20	23	24	24	14	13	46	19	20	22	12	15	7	16	14	24	10	15	24	13	23	12	5	22	21	36	22	8	23	12	31	23	13	17	13	13	14	18	21	18	14	16	20	18	15	7	25	30	22	19	8	8	17	18	8	6	7	13	8	16	17	9	12	15	16	12	15	15	15	27	18	21	14	18	25	24	14	24	23	66	12	11	21	21	8	16	26	12	9	16	14	15	24	7	13	17	21	7	14	8	38	19	6	12	14	9	15	17	12	9	5	8	14	13	13	13	16	9	8	19	13	15	10	14	20	15	7	12	23	9	12	7	14	19	14	15	15	15	6	15	14	13	9	9	45	14	17	14	15	7	10	10	11	13	5	4	9	25	15	8	9	6	2	10	18	12	15	13	7	16	10	2	15	7	9	22	17	2	9	11	6	21	8	4	9	30	4	9	16	10	14	10	14	4	7	5	14	10	5	11	8	12	14	2	6	4	15	6	20	5	6	5	6	8	7	6	2	5	2	8	5	7	13	11	1	7	17	5	5	1	21	3	4	4	6	5	3	11	11	9	3	1	1	6	5	14	5	7	14	29	16	8	6	2	9	8	2	10	4	2	1	3	3	4	10	5	7	4	4	10	9	9	9	2	7	6	2	4	13	2	13	9	5	2	11	6	8	5	14	4	2	3	11	6	3	1	15	3	5	2	2	9	7	3	3	3	6	6	3	4	3	8	6	16	2	3	4	1	0	2	1	6	3	1	5	5	7	0	4	4	1	3	3	1	1	3	0	2	0	0	3	10	3	0	4	0	6	2	2	1	7	0	8	1	2	3	3	4	1	0	0	0	0	0	0	1	1	0	2	0	0	0	1	0	0	2	0
ne0356	2043	1817	1317	591	1588	677	846	565	1012	778	873	631	681	675	713	555	477	639	498	521	511	453	835	469	552	595	505	510	460	570	655	348	557	458	447	514	534	643	571	569	434	567	393	527	283	405	402	362	349	503	417	409	701	227	279	411	485	339	511	648	331	400	432	456	516	317	371	367	346	345	606	392	350	389	478	367	363	393	384	442	331	339	284	312	471	406	373	446	306	416	322	299	285	361	380	313	280	330	268	231	348	292	243	279	292	397	295	278	276	204	246	254	302	284	275	281	255	271	485	272	268	239	295	258	239	218	280	192	241	298	368	296	321	452	284	519	272	399	222	249	332	191	197	240	371	296	287	324	220	326	272	344	249	252	230	279	199	193	247	125	256	308	388	324	171	330	320	346	379	227	250	295	269	292	211	332	201	243	287	368	118	225	228	239	437	358	270	218	316	268	297	229	135	280	288	180	244	226	299	231	257	229	233	247	359	223	220	210	209	208	206	184	147	216	171	266	216	314	245	204	216	283	355	206	284	127	181	291	157	183	190	235	227	349	199	322	322	261	138	232	135	294	142	169	313	217	186	218	151	176	228	211	151	217	222	195	240	226	210	238	159	177	264	185	263	252	153	211	243	245	235	223	187	221	134	207	129	146	200	207	268	227	181	430	190	441	194	185	232	113	186	170	246	158	82	243	145	176	228	211	229	144	296	159	161	267	200	257	174	232	186	327	180	179	225	264	169	185	139	232	221	217	181	248	145	137	170	157	179	190	119	129	161	156	168	174	192	185	165	160	209	142	232	64	126	166	184	194	185	196	183	169	131	151	205	139	122	122	214	198	211	229	150	218	156	230	205	156	139	137	169	226	180	169	185	298	202	119	198	169	42	172	139	108	132	98	150	172	157	138	140	91	96	155	140	178	148	161	302	160	157	157	103	127	108	188	171	120	115	123	204	174	135	108	104	144	163	106	159	82	124	337	101	174	108	123	105	182	247	139	99	97	230	120	144	119	150	156	132	172	75	179	115	163	132	176	127	187	152	70	109	124	124	149	105	144	102	142	132	126	124	73	154	152	203	101	113	64	152	119	39	90	101	201	63	139	133	92	191	125	136	87	148	123	109	118	61	65	94	111	105	168	172	138	94	155	84	148	127	126	185	101	109	74	91	112	131	158	84	174	70	127	112	113	143	130	128	141	122	124	144	156	133	101	115	122	119	125	145	78	82	111	100	152	129	109	104	85	115	102	123	146	89	110	156	69	96	52	144	116	143	83	71	124	170	105	70	135	61	129	128	99	73	151	76	90	151	111	209	157	133	128	89	133	116	62	66	85	89	65	59	107	128	135	108	90	86	82	116	80	55	52	47	128	129	87	71	108	106	105	76	104	105	75	157	131	128	146	105	97	94	69	107	152	144	191	107	118	124	75	145	93	85	118	44	98	106	90	78	73	92	172	85	113	100	77	88	55	97	93	111	113	77	62	94	74	97	114	93	123	156	116	95	107	113	74	103	59	90	130	66	76	88	159	109	68	76	102	38	74	145	118	83	59	90	51	96	89	41	99	114	84	132	122	58	65	67	113	123	141	107	64	89	98	96	73	46	161	76	178	92	71	150	76	70	48	52	84	58	111	107	66	90	112	89	63	32	74	76	84	66	124	69	73	48	77	71	122	103	103	72	101	80	62	66	74	52	99	112	54	51	81	48	65	51	119	59	89	71	100	50	115	81	56	73	113	52	92	89	100	58	51	64	70	73	113	45	48	100	85	77	76	84	42	72	96	60	76	65	83	43	31	63	120	49	70	54	30	58	49	72	42	44	89	57	64	99	54	99	91	63	66	174	47	47	49	105	73	61	58	70	45	54	134	106	51	57	37	38	60	66	43	31	101	31	91	71	126	75	88	64	82	37	64	81	64	58	57	92	60	69	54	35	136	74	36	71	120	52	121	61	60	33	52	81	65	55	89	50	48	114	58	49	86	28	58	54	44	73	108	86	53	58	38	53	86	72	42	121	56	67	86	56	88	53	49	43	54	69	48	76	102	77	81	49	56	35	100	60	38	64	40	61	54	73	39	34	59	105	68	87	49	31	36	57	64	89	90	45	40	60	34	35	33	63	69	64	59	54	106	58	32	64	49	41	55	77	44	108	63	187	45	177	36	73	40	37	32	55	38	33	53	58	35	41	52	131	57	62	107	39	57	48	18	63	47	41	50	103	38	63	60	69	20	59	66	62	39	51	24	37	37	40	74	59	74	38	50	28	40	52	35	99	59	112	34	61	48	40	69	32	77	76	40	46	51	43	57	94	32	32	43	42	48	33	62	71	65	38	44	76	52	67	110	36	27	14	18	48	56	59	79	32	47	31	72	47	49	28	31	62	29	43	37	71	137	37	23	49	46	25	102	51	61	59	93	33	99	58	54	27	28	52	30	36	43	49	63	50	48	38	32	33	51	44	53	32	57	53	34	48	36	24	32	45	54	30	52	34	76	55	37	51	51	26	33	63	30	53	85	50	54	49	76	46	47	79	27	37	38	34	9	87	28	29	33	35	45	60	50	88	30	21	36	52	32	45	51	29	30	34	55	47	26	30	46	50	50	70	35	36	243	53	21	69	3	51	105	28	67	41	34	30	96	34	26	40	30	38	23	45	53	64	47	25	46	52	25	31	60	34	52	66	29	34	49	46	27	60	34	18	23	27	63	45	61	35	45	24	59	31	38	44	21	45	30	46	22	54	19	34	27	77	36	33	59	28	61	68	22	95	34	27	23	27	36	54	55	84	53	56	38	23	41	21	32	53	24	83	35	38	37	92	23	38	49	14	67	18	20	22	48	25	23	119	42	42	25	16	43	21	25	13	40	59	28	52	28	62	38	34	63	47	17	21	31	41	35	15	27	40	42	26	41	27	21	25	31	77	27	55	26	32	16	17	38	25	33	32	24	16	16	27	28	60	21	13	26	27	44	32	61	47	32	56	73	18	35	22	77	53	14	167	114	50	20	35	33	23	41	69	38	34	17	30	23	66	55	41	23	34	26	38	36	27	23	85	47	118	40	13	14	23	13	20	39	26	36	54	33	42	57	59	22	28	26	23	51	34	15	17	30	22	37	30	20	30	27	35	39	20	32	16	24	28	32	13	22	30	29	23	33	23	43	41	35	25	34	18	14	12	13	25	14	17	28	37	22	18	22	24	20	12	22	14	40	46	52	35	17	31	36	9	32	17	26	16	25	24	12	8	17	13	13	14	15	44	10	42	10	28	15	27	18	32	36	26	28	20	26	19	35	34	25	21	37	20	38	7	12	18	25	19	17	28	21	12	34	53	31	33	11	8	28	22	19	12	14	21	36	20	16	15	11	15	11	57	29	28	17	17	22	10	22	17	20	12	27	13	12	24	17	15	27	46	11	33	21	36	31	25	40	11	27	37	10	18	8	28	12	17	16	16	24	26	23	31	18	16	12	27	21	13	4	19	20	28	12	10	21	22	11	13	48	33	10	13	21	5	3	12	15	29	38	4	13	27	42	12	7	24	46	51	12	20	21	19	26	11	17	20	1	7	9	20	20	24	15	10	10	24	4	24	14	14	11	20	18	9	18	11	11	11	14	25	33	25	21	23	7	21	9	18	4	16	17	16	6	15	23	15	9	7	15	12	17	11	24	58	19	12	9	5	37	8	17	11	13	39	15	19	17	9	27	12	20	22	8	7	10	6	16	25	5	10	8	8	4	15	19	9	15	15	11	8	7	28	10	22	4	7	13	9	12	8	3	13	15	7	11	9	12	6	5	9	16	24	14	5	11	13	6	6	6	10	9	20	22	1	18	8	8	6	3	4	5	7	1	31	9	6	9	8	7	11	5	11	2	8	11	3	34	7	6	6	1	9	7	13	4	6	7	1	3	11	8	6	6	3	5	7	9	5	11	10	8	7	2	0	11	5	13	10	9	6	10	3	9	6	6	7	10	7	7	9	12	2	14	4	13	3	7	5	11	3	6	2	1	6	2	3	1	2	3	9	3	5	3	8	1	6	1	4	2	0	1	5	7	5	1	0	1	4	3	3	9	2	0	1	1	0	6	8	3	2	1	4	0	0	1	7	3	0	4	1	4	3	7	1	0	0	1	0	1	3	2	0	1	0	4	0	0	0	0	2	0	0	0
ne0357	2266	2442	1150	1199	1466	723	978	582	812	648	896	618	579	523	656	608	474	543	809	581	692	518	609	473	561	552	591	480	649	575	598	526	461	389	534	613	532	553	560	600	465	439	369	515	335	355	343	288	514	491	280	455	450	270	392	355	507	304	569	384	329	462	527	516	431	440	288	432	388	474	375	601	411	570	488	495	500	309	403	402	279	416	233	358	441	294	381	411	697	400	418	390	244	454	272	358	252	366	280	286	281	389	317	248	310	284	299	271	233	346	306	376	256	234	208	315	199	388	287	198	386	186	254	383	340	251	226	294	186	238	345	249	292	224	264	297	248	299	189	229	344	244	276	221	359	274	369	228	284	256	213	300	184	225	303	218	152	208	183	158	211	280	283	230	221	313	324	323	267	220	252	209	242	209	177	316	264	194	221	212	100	385	221	250	305	246	242	269	253	249	425	203	202	225	251	137	291	159	290	169	321	221	265	182	158	184	252	185	229	273	150	230	191	163	253	257	240	394	455	226	452	231	377	258	214	255	184	294	205	188	308	256	227	282	204	272	279	279	195	176	290	184	378	227	277	147	179	210	171	206	215	262	150	205	300	134	521	149	231	245	169	228	175	138	229	286	144	163	243	250	217	241	136	211	207	283	193	149	203	187	271	198	173	156	209	313	242	212	305	166	222	140	284	202	130	271	149	258	188	161	266	175	316	190	212	247	220	202	207	180	232	176	229	189	189	249	236	214	134	247	190	193	169	151	138	114	193	149	206	181	167	170	127	135	133	218	211	155	209	146	151	267	229	125	113	173	345	223	172	205	159	178	238	241	137	111	145	145	192	151	219	265	139	202	170	141	180	256	168	215	160	222	226	125	153	277	215	135	175	133	74	245	96	118	175	161	130	236	144	127	127	127	122	179	111	131	143	122	250	141	120	172	116	100	131	164	133	137	111	159	151	133	139	111	88	192	257	205	137	133	164	157	110	185	144	223	84	160	167	152	136	117	220	123	145	149	126	188	183	190	103	313	131	166	146	130	122	189	179	89	108	92	160	104	168	174	91	121	113	121	106	106	114	132	124	104	132	109	114	158	48	100	124	102	69	147	207	204	154	89	159	144	279	86	113	164	73	101	68	109	115	156	144	173	172	134	110	178	126	137	107	80	90	97	104	91	100	110	126	91	120	204	119	109	107	155	94	180	126	127	101	164	178	274	121	88	291	112	170	99	104	151	136	139	223	115	100	76	91	110	121	136	156	96	161	103	198	120	102	109	192	93	103	117	117	141	90	100	85	116	149	100	86	102	73	80	82	94	118	141	108	155	81	96	92	43	105	72	147	107	132	118	138	110	109	88	95	95	109	91	75	60	75	167	116	85	82	100	79	95	107	88	107	110	103	100	110	134	106	78	72	121	138	111	155	105	105	79	108	132	194	101	104	147	58	94	133	188	131	80	64	119	76	119	88	146	92	126	79	86	160	104	80	86	71	58	185	195	157	75	108	153	84	87	81	103	77	44	116	121	111	82	83	103	95	137	97	188	56	73	94	138	74	36	93	93	66	101	62	137	98	87	104	122	44	118	81	63	174	121	85	76	174	103	91	79	47	138	88	161	93	52	127	44	65	103	97	126	89	97	91	96	108	168	113	52	37	79	80	133	54	93	94	135	59	72	77	73	72	87	58	94	116	65	91	319	137	61	112	62	43	108	57	172	91	106	49	117	86	94	60	80	59	75	76	109	63	115	68	87	56	50	58	93	57	151	68	89	95	70	150	84	78	54	77	75	74	91	80	92	101	41	45	82	56	73	80	31	70	44	81	45	58	65	75	57	78	69	85	71	103	43	58	81	32	80	101	80	83	64	69	55	68	157	83	44	95	44	33	52	43	59	36	100	40	158	72	241	71	37	43	62	130	68	97	95	62	88	154	41	47	58	23	62	93	87	63	41	68	186	91	87	69	112	93	78	89	59	93	38	80	60	54	95	57	262	55	43	85	68	76	63	74	81	108	103	64	39	68	61	53	58	63	55	34	52	83	111	44	35	58	55	50	45	57	66	37	112	47	65	49	374	51	64	66	42	25	110	92	96	103	70	94	46	67	82	74	51	59	58	86	82	68	51	60	79	68	122	35	117	94	41	67	56	39	56	151	142	60	61	73	59	36	34	57	51	85	145	76	56	74	40	119	48	46	64	47	40	54	74	70	59	44	51	48	57	51	61	64	42	53	57	61	30	74	48	54	49	65	33	56	30	75	64	41	78	44	47	33	55	69	124	57	65	61	61	69	58	48	57	35	80	56	62	52	55	57	64	55	31	35	27	74	59	30	45	44	32	42	76	47	47	49	48	47	60	58	37	75	50	53	65	35	47	46	45	42	39	81	25	43	45	65	67	66	38	82	22	61	54	28	153	70	62	56	53	45	67	47	44	58	41	43	48	25	126	53	74	88	59	79	33	40	40	64	43	78	40	114	24	56	110	45	42	44	55	27	64	48	68	42	59	44	54	42	39	74	49	44	51	49	37	49	49	30	36	157	40	35	26	43	19	36	75	29	469	31	35	58	34	141	38	35	41	47	51	42	40	42	36	50	52	50	46	32	39	31	77	82	28	59	86	32	35	97	27	103	41	40	86	66	36	43	55	50	24	40	25	46	25	25	38	43	54	24	36	48	55	57	59	231	43	44	38	36	64	52	26	43	28	32	33	71	41	67	44	35	40	40	48	21	40	36	52	34	30	52	23	67	29	34	37	39	35	71	26	52	48	76	31	50	42	30	66	29	49	43	24	110	79	44	19	33	40	41	21	65	46	33	41	29	27	81	34	33	48	22	51	50	26	18	49	35	34	46	44	18	36	32	28	25	26	56	61	44	27	42	36	58	51	28	53	38	35	24	37	18	31	33	42	28	27	43	52	25	21	37	28	44	29	53	28	39	32	32	39	31	35	57	30	17	62	13	33	45	43	23	33	47	32	67	38	36	24	42	48	25	29	37	33	33	18	23	78	49	26	27	30	43	29	20	27	54	34	28	20	65	36	73	52	31	39	68	55	14	32	23	33	40	31	24	23	26	20	26	32	29	28	49	29	25	41	30	23	40	42	22	43	36	13	26	24	13	16	26	10	28	29	35	37	23	40	29	21	31	34	16	16	29	17	21	30	34	15	27	24	32	56	23	25	22	19	21	22	35	50	20	23	26	34	19	27	20	21	19	41	30	96	23	15	14	50	28	27	31	24	33	14	22	17	23	6	28	18	23	32	22	13	53	29	22	12	19	16	24	23	20	28	13	17	21	29	27	23	22	36	80	31	18	62	11	29	25	20	17	15	19	32	28	22	50	14	47	27	15	19	27	25	23	16	11	19	20	25	29	12	19	26	17	11	8	23	47	30	12	13	10	28	23	20	24	16	8	27	19	16	23	17	40	39	59	19	29	25	34	20	19	14	22	18	9	15	29	31	32	25	15	22	22	14	35	34	18	22	12	73	10	12	20	18	23	7	20	22	15	12	9	26	13	11	18	17	16	20	4	21	21	25	14	15	18	16	13	4	7	28	28	26	14	15	18	2	7	15	18	24	31	14	12	15	50	1	51	13	9	14	14	8	12	12	14	18	14	21	20	18	29	21	30	8	22	7	12	2	10	27	11	18	94	14	34	15	7	13	13	10	10	17	14	23	7	8	12	17	7	13	24	11	11	15	13	14	8	16	10	8	12	19	13	11	8	24	18	11	8	7	19	35	19	17	11	10	3	17	10	19	7	11	21	7	12	9	8	12	4	4	14	13	8	16	8	34	7	7	8	11	9	5	8	4	9	5	17	7	13	6	12	10	5	4	4	11	2	10	12	5	4	14	69	6	1	5	18	3	15	11	2	4	20	13	15	7	13	1	9	4	11	7	8	4	14	11	4	3	12	7	15	4	8	13	6	11	8	11	2	6	5	6	2	7	4	31	3	8	4	23	3	4	0	8	7	2	3	6	7	9	1	8	0	4	6	5	7	4	5	2	4	1	3	7	7	6	15	4	10	11	10	4	19	0	9	7	12	10	6	2	6	3	2	2	2	2	3	3	1	3	3	0	2	5	3	4	15	2	0	5	2	1	8	0	4	17	0	5	2	2	9	2	1	0	0	0	2	2	1	0	0	79	1	6	0	0	0	0	0	0	2	1
ne0358	2263	1927	1408	1055	1294	772	907	721	846	801	820	758	927	771	950	519	558	605	494	677	655	589	609	493	653	645	620	602	587	669	723	450	644	609	602	581	662	544	544	598	477	616	363	509	263	488	431	480	402	543	422	452	537	390	355	479	391	345	617	512	359	359	533	370	544	397	388	374	358	319	525	413	416	493	423	371	348	408	490	544	456	425	309	317	346	381	340	419	368	513	255	449	306	425	318	255	330	382	268	361	423	264	254	308	316	479	347	336	398	297	304	300	329	314	320	276	312	326	398	337	270	280	289	355	310	287	433	423	280	336	382	287	378	372	318	267	333	454	261	320	310	283	205	278	331	352	331	224	277	451	304	343	283	264	225	307	191	182	287	151	255	232	391	386	222	284	327	381	374	215	335	271	309	322	253	378	216	258	251	324	253	254	230	167	277	363	209	199	332	281	205	296	258	299	277	149	271	236	233	286	388	301	339	247	264	266	221	284	256	274	253	288	196	244	148	395	271	277	220	206	189	324	315	288	370	205	228	267	198	179	226	304	244	286	231	374	258	242	132	243	204	290	180	249	157	273	293	248	152	215	267	249	152	196	196	225	253	221	271	263	172	232	242	279	213	294	219	206	195	288	237	307	148	241	133	323	223	169	197	178	244	258	263	168	167	328	211	167	198	166	204	231	184	171	176	209	127	170	241	236	296	174	282	196	211	185	237	370	136	240	129	251	135	176	199	139	224	303	183	193	257	284	183	240	206	141	218	136	181	141	159	216	202	140	179	226	199	191	124	171	176	202	152	89	203	183	240	211	235	163	200	157	105	176	182	194	105	113	202	218	272	217	137	206	238	154	167	148	146	217	148	185	195	162	215	198	113	172	186	165	151	216	164	173	194	180	122	132	214	143	165	157	100	199	171	201	151	119	213	188	112	281	164	159	130	132	130	122	182	109	194	149	128	180	86	84	229	120	215	100	124	175	115	128	173	302	114	160	137	152	105	187	200	128	136	126	200	125	118	192	94	167	86	189	153	181	149	91	263	93	103	152	91	133	92	163	120	129	106	115	134	94	163	105	135	81	104	109	201	127	110	123	113	229	93	115	116	113	206	87	126	76	175	106	123	144	57	113	48	137	130	133	119	207	111	158	119	156	155	140	168	72	109	76	58	132	158	95	107	115	63	79	113	149	142	194	148	149	116	126	154	136	101	83	140	160	130	95	92	96	84	137	91	138	220	125	140	85	88	120	136	115	86	92	142	97	133	106	205	92	119	118	82	156	182	91	81	161	48	154	89	93	67	131	78	98	136	151	138	139	126	77	146	137	127	57	138	107	83	146	63	145	130	105	100	105	52	137	165	109	63	71	67	94	103	129	90	91	110	100	87	85	83	161	134	128	110	144	131	127	119	77	77	95	126	142	100	134	108	52	130	72	92	129	101	76	89	100	99	86	83	118	64	203	95	66	113	63	140	87	129	84	124	90	108	65	82	103	78	104	173	96	115	89	114	68	83	44	123	122	104	121	74	122	89	90	122	108	77	82	109	77	90	47	119	110	84	78	46	97	108	101	143	89	91	119	114	108	195	119	111	74	90	92	104	51	35	188	77	134	69	83	179	96	69	72	71	137	63	115	91	93	108	130	143	77	56	56	77	167	68	106	68	63	56	96	102	99	110	83	106	95	36	41	69	88	88	45	126	74	41	97	114	97	77	112	83	87	95	94	58	109	77	53	69	116	83	91	114	89	64	61	48	73	75	109	52	47	88	72	88	61	96	48	45	83	47	67	122	83	40	67	42	63	61	69	36	54	54	56	106	98	95	92	83	97	69	73	64	89	73	75	83	80	52	51	91	86	47	74	91	56	57	82	88	39	60	66	71	63	57	28	53	57	37	74	55	111	72	68	73	59	53	79	104	75	44	73	97	83	51	60	22	135	86	78	88	84	46	183	48	64	57	34	71	58	47	68	39	60	91	45	90	78	49	87	55	43	74	76	105	83	81	36	44	87	47	43	64	75	73	87	83	76	54	56	45	31	49	44	56	85	54	42	80	54	52	62	55	60	53	64	38	78	113	30	28	86	81	72	78	56	52	39	90	98	72	65	44	50	68	50	52	41	55	46	46	84	42	166	77	56	60	63	30	107	88	73	49	60	142	35	41	48	54	50	44	59	46	49	50	62	76	33	38	87	48	67	67	46	47	63	54	30	61	65	53	67	68	94	69	99	60	28	48	62	72	55	56	57	24	45	54	76	49	96	60	35	56	31	48	51	55	64	79	40	45	38	27	81	52	55	59	40	51	77	53	33	67	28	35	28	54	48	28	37	72	39	48	43	88	48	36	74	56	31	33	46	55	65	77	82	24	62	27	46	51	45	39	40	51	74	77	30	52	35	56	27	48	70	34	87	67	48	72	60	33	77	28	45	42	36	87	31	31	36	58	48	50	34	112	49	61	44	45	55	44	43	60	49	79	45	41	18	60	40	44	48	56	55	60	42	54	55	38	41	83	42	69	78	45	30	76	50	53	62	80	43	19	30	66	23	39	26	29	56	43	44	81	45	94	26	23	59	25	47	23	63	33	30	43	51	45	29	31	28	32	37	38	20	93	59	69	32	53	8	36	50	30	67	52	38	38	39	31	42	38	27	36	26	31	38	36	47	24	35	49	96	28	85	36	61	21	23	51	42	50	23	29	27	48	33	40	26	58	39	50	24	30	76	32	72	32	22	40	44	48	25	91	17	32	27	41	44	36	41	44	37	39	26	37	38	62	32	40	37	56	44	50	63	47	58	23	21	70	32	47	29	33	41	44	42	67	49	29	95	24	37	18	42	20	68	33	33	36	50	73	45	22	32	36	34	15	29	40	49	42	32	68	42	25	32	21	25	41	64	23	40	23	55	29	25	42	105	43	37	22	31	45	49	55	63	27	36	23	34	47	57	37	19	37	36	45	46	78	12	16	35	35	29	32	37	23	27	48	47	35	23	20	36	71	39	20	60	40	43	49	39	38	20	51	39	35	11	34	17	49	43	29	26	24	16	44	40	15	24	34	30	67	29	41	18	21	12	28	52	24	25	59	20	80	24	43	21	31	53	9	48	44	25	14	21	34	33	44	15	31	16	33	44	31	50	16	37	23	38	15	28	40	38	23	25	44	17	37	23	31	30	26	32	7	39	15	15	21	20	22	20	16	33	28	13	30	48	20	30	33	47	29	18	29	31	17	18	15	20	21	17	23	9	4	15	25	14	11	32	56	27	25	27	25	10	26	23	74	38	32	21	27	21	22	22	39	22	17	24	37	20	26	18	34	13	27	30	62	12	25	45	15	19	30	16	20	31	29	18	8	12	29	39	10	15	27	18	49	53	40	24	41	17	26	12	12	29	43	42	34	29	30	37	10	27	23	12	24	14	17	7	53	39	20	35	10	13	23	11	18	13	3	12	30	15	9	15	22	27	35	21	26	26	33	20	26	16	31	25	45	13	34	21	21	27	17	15	2	15	9	29	11	20	19	33	41	30	4	26	23	11	15	10	18	18	16	19	22	23	19	21	8	10	13	3	13	13	17	30	49	14	17	12	20	11	24	18	33	13	16	31	15	15	21	18	10	19	17	27	13	10	15	4	13	17	29	10	22	37	9	14	17	22	16	23	8	6	17	2	15	9	7	10	4	14	6	9	14	17	13	10	25	21	11	24	7	14	9	17	16	6	6	22	14	10	4	9	2	8	27	7	22	18	7	20	36	11	9	10	10	13	12	10	20	21	3	8	6	9	8	15	12	15	10	13	3	17	4	8	12	71	10	9	8	7	6	7	5	6	16	19	4	10	11	31	6	5	6	6	2	6	12	12	11	7	2	12	5	8	8	20	5	29	3	11	4	10	10	4	14	16	6	5	8	9	5	4	6	16	3	3	3	9	8	6	7	7	3	10	4	4	2	13	11	4	9	5	11	10	3	8	1	4	7	1	2	9	3	12	2	2	3	3	6	7	12	3	2	7	2	9	11	5	5	1	14	18	17	2	1	15	5	3	2	0	9	5	2	5	8	8	1	3	1	2	6	11	3	16	2	1	2	2	2	4	5	4	1	2	2	2	5	3	1	1	0	1	1	2	2	4	0	0	0	1	0	0	0	0	2	1	5	5	0	16	0	0	0	1	0	0
ne0359	2141	1742	1064	922	1463	844	842	713	756	674	829	713	843	733	661	694	576	620	527	664	646	484	647	377	540	573	495	547	511	514	556	399	491	618	451	521	472	504	678	601	350	538	295	507	333	454	420	437	421	499	431	432	444	277	324	451	497	367	463	414	451	407	476	424	482	342	415	359	300	385	403	479	412	494	478	410	304	445	398	306	341	351	339	245	408	372	377	340	404	400	547	318	353	387	320	292	350	284	273	294	386	371	208	340	261	382	246	359	450	242	505	343	419	350	351	232	336	338	327	362	294	311	251	272	318	230	306	251	315	341	316	306	232	236	267	279	215	254	301	199	257	259	185	180	352	358	251	203	260	257	255	251	281	225	267	276	212	219	300	129	217	246	280	320	206	274	252	247	299	167	179	221	251	297	291	248	199	312	222	227	212	524	236	205	261	222	235	224	240	235	204	176	217	259	216	154	193	300	211	282	279	217	249	227	160	251	171	271	290	241	286	180	175	232	187	184	219	302	216	197	280	226	342	227	259	158	175	257	193	183	226	223	201	197	213	281	250	230	169	189	143	286	204	144	193	205	298	213	161	197	191	298	125	192	245	269	194	188	194	202	377	212	160	157	256	233	216	214	186	227	152	192	158	161	139	150	172	152	165	151	183	181	181	142	208	181	254	191	265	138	208	198	181	207	107	171	137	139	257	146	214	107	267	217	182	281	163	154	142	201	161	220	153	120	174	191	192	149	397	206	184	179	142	189	134	132	132	156	469	161	131	180	192	116	152	179	150	156	157	200	123	180	182	82	207	135	204	175	173	161	151	138	132	191	149	208	89	137	170	167	210	164	107	167	160	165	160	179	146	173	164	260	212	157	130	163	156	123	176	102	58	176	105	159	176	117	183	166	147	136	135	77	89	118	162	147	135	92	148	143	106	169	142	140	112	165	100	107	172	137	171	156	126	150	90	122	185	94	148	79	137	171	86	202	208	274	98	163	113	110	109	85	188	143	123	116	143	146	158	114	328	148	119	190	146	125	102	124	146	106	98	154	121	94	99	140	356	120	127	153	95	78	116	108	138	86	123	84	124	167	55	104	118	118	50	140	126	142	128	110	126	113	163	126	89	128	70	56	63	157	108	119	133	134	107	98	104	152	112	151	115	82	129	47	101	104	93	110	117	145	70	104	131	151	92	87	83	110	105	142	85	115	108	136	82	86	104	89	126	104	102	152	87	104	126	117	97	115	90	93	150	123	101	103	141	69	120	60	106	90	130	81	94	88	115	92	92	105	65	82	126	84	72	101	94	79	86	94	140	115	99	90	110	90	83	43	106	64	73	101	87	113	92	105	85	75	80	125	133	77	52	53	48	99	137	69	96	92	145	99	77	108	71	75	92	135	99	147	99	69	76	118	108	100	105	97	124	60	67	80	110	105	121	102	61	86	95	166	92	63	98	117	61	108	89	88	98	67	81	80	195	183	54	77	109	83	137	160	97	98	96	104	104	84	86	79	56	41	64	106	70	67	95	94	75	138	110	360	56	59	120	93	101	49	123	98	76	101	81	95	95	86	150	84	93	55	68	75	206	162	86	94	83	69	86	72	55	107	120	97	72	89	120	89	79	62	43	96	66	115	73	54	72	112	83	87	31	93	67	89	61	108	73	81	57	52	87	69	62	54	59	75	327	67	58	80	67	55	81	64	66	90	91	75	64	85	50	80	96	67	42	62	44	319	74	94	59	87	58	94	55	58	61	71	95	84	60	47	67	85	86	42	108	48	85	83	42	83	40	82	49	48	53	52	68	93	49	30	69	66	98	67	87	56	41	67	70	58	72	82	51	82	102	66	34	75	72	78	87	69	58	53	57	163	83	43	52	30	58	45	52	31	37	75	42	85	66	441	108	48	58	86	38	43	99	84	62	49	106	54	62	60	18	75	60	23	43	64	64	97	78	66	41	36	64	44	63	55	54	39	73	40	64	53	47	75	63	47	74	71	63	46	37	54	56	114	49	54	53	72	45	73	41	39	51	47	41	53	48	48	59	49	51	51	44	61	42	348	46	54	38	87	50	66	65	49	48	51	119	48	109	55	36	43	49	61	88	61	45	54	56	42	18	42	63	72	56	125	52	88	52	36	50	46	37	42	71	55	59	43	70	56	52	41	65	62	41	52	60	55	60	38	41	41	45	53	53	29	37	56	36	64	45	288	53	57	40	46	45	23	55	58	61	11	35	47	46	55	50	28	34	28	58	31	33	109	53	44	29	40	26	57	43	58	54	61	36	49	42	47	45	49	45	21	38	45	52	56	78	26	25	31	47	41	27	47	55	37	42	47	58	46	57	32	28	48	27	25	50	109	48	71	28	51	47	62	46	39	60	49	42	29	33	24	40	27	37	21	67	63	20	69	81	315	44	42	32	66	29	39	297	36	32	41	29	95	66	61	89	50	57	45	31	76	84	37	40	37	56	30	49	42	35	30	43	50	35	56	39	56	52	62	61	64	49	32	57	30	39	50	50	48	42	48	58	34	62	31	26	51	25	22	27	39	37	53	27	41	41	30	84	30	38	39	33	288	30	65	23	30	56	31	287	34	44	37	33	51	45	25	24	65	32	26	64	13	56	49	46	45	88	42	24	29	37	29	34	19	40	33	26	96	45	33	19	32	51	30	33	63	42	47	45	18	48	31	55	28	40	24	33	19	49	41	79	40	44	49	41	62	27	32	36	32	36	36	48	31	98	30	39	25	50	32	40	30	40	46	42	34	48	17	26	46	32	29	37	44	53	78	27	13	48	22	42	51	52	66	28	36	33	49	57	18	56	33	18	61	27	24	18	33	26	25	49	41	22	26	30	43	20	28	21	55	37	23	29	22	44	27	27	37	30	25	10	57	32	48	30	29	17	29	44	28	25	34	39	26	41	27	40	25	39	44	28	39	40	45	60	19	33	23	19	28	62	31	17	41	36	27	29	44	35	30	40	39	48	29	27	27	49	19	18	100	25	31	37	32	25	27	26	41	37	15	30	19	41	57	29	36	26	24	31	37	9	30	33	58	29	23	14	20	24	17	17	35	48	34	43	31	37	44	38	28	56	23	22	52	43	19	25	27	26	29	13	21	35	24	37	28	16	22	12	36	39	15	23	23	16	29	20	29	15	26	36	31	12	24	21	23	12	21	12	12	18	16	25	18	16	22	17	29	15	20	21	27	18	51	24	19	15	32	16	25	19	34	17	11	22	11	8	4	10	9	15	16	21	10	41	8	26	22	19	15	14	40	27	89	10	15	15	32	24	11	19	36	17	28	10	23	18	25	26	42	11	24	24	12	25	36	19	15	19	26	19	21	8	14	22	16	18	26	18	34	14	11	33	19	8	7	11	26	25	22	7	9	19	17	14	22	21	24	10	91	21	13	18	15	78	26	21	16	26	9	32	18	12	8	24	24	6	14	21	48	18	13	6	16	9	16	24	14	15	11	9	309	16	10	9	20	21	13	22	35	7	10	9	21	13	9	10	28	14	21	2	18	16	22	9	15	18	16	18	7	6	15	10	20	13	11	18	5	21	12	21	14	19	16	29	7	32	18	16	29	9	23	19	8	12	15	16	16	12	15	12	15	18	18	24	4	11	10	20	8	11	24	5	9	17	28	21	14	6	16	20	11	24	13	7	9	7	5	15	24	11	2	16	8	25	20	11	9	7	11	13	4	20	7	5	17	17	8	14	9	5	13	20	8	15	12	9	8	5	13	16	7	12	1	9	7	10	9	6	9	6	11	16	16	3	13	13	18	13	5	2	4	9	36	4	9	2	3	8	22	5	6	12	13	5	14	2	5	5	6	9	20	5	5	58	17	8	7	11	10	9	9	5	4	18	11	4	11	12	2	7	3	8	10	9	9	13	4	1	4	6	10	1	3	2	12	9	5	7	34	3	4	19	2	2	7	7	19	10	8	7	18	4	1	2	3	5	1	5	8	8	5	1	2	1	7	1	10	5	7	2	0	9	2	6	2	6	4	24	5	6	1	1	6	6	2	0	7	8	4	2	4	3	5	0	3	1	0	2	8	4	1	2	0	2	0	4	2	2	6	0	1	3	3	2	1	1	6	2	1	2	7	1	7	0	0	0	3	0	1	4	2	0	3	0	3	0	0	0	1	0	0	0	1
ne0360	3570	2060	1740	1579	2296	986	1512	839	1411	783	1470	962	1153	849	1167	1009	803	829	788	770	1000	783	795	669	823	905	868	756	731	749	943	739	813	859	654	547	951	803	782	1003	642	828	410	784	301	600	663	717	597	614	501	592	653	443	524	626	495	369	749	679	498	675	682	487	682	697	479	583	512	393	696	681	453	709	674	582	461	717	649	478	626	552	431	355	653	465	404	530	526	698	269	463	369	665	568	529	353	705	436	515	559	277	210	370	457	588	433	465	431	433	292	638	379	327	350	359	352	485	365	356	328	310	326	503	562	466	574	462	318	317	446	412	391	414	369	526	437	416	320	424	423	448	262	355	487	510	504	274	531	454	384	377	469	354	299	416	374	293	306	206	379	415	411	487	278	486	364	408	451	234	425	355	415	525	293	479	305	275	325	285	302	309	361	279	400	292	317	294	464	350	250	379	222	415	423	140	301	285	342	415	309	341	324	407	236	432	247	420	365	504	264	356	270	314	294	340	322	461	421	358	338	405	458	487	365	302	375	275	241	263	369	485	376	234	279	524	444	423	239	328	255	288	262	247	288	311	394	335	306	165	405	280	234	263	222	245	312	373	334	365	144	302	294	323	370	465	350	227	294	384	271	448	240	353	201	237	200	228	180	265	210	261	294	179	253	226	343	284	342	229	301	358	354	215	195	192	175	211	400	365	390	224	321	265	397	319	486	280	234	355	256	374	361	252	208	191	401	491	281	258	291	226	269	256	273	164	259	247	243	265	175	338	193	207	252	402	271	312	259	196	226	397	163	136	318	195	429	338	233	220	272	191	222	135	232	326	192	188	258	229	249	229	102	291	244	201	273	165	202	374	188	403	269	170	287	187	180	237	311	218	161	212	221	273	164	197	158	207	233	267	176	162	168	370	263	257	218	179	164	312	132	279	265	217	157	189	234	241	296	206	196	205	196	290	110	147	218	188	193	191	183	245	159	187	203	485	130	268	219	178	92	192	166	165	214	155	194	206	202	295	120	260	161	319	192	217	160	169	322	169	142	203	274	188	126	272	147	165	119	199	172	101	163	182	210	183	192	126	229	103	87	187	184	247	104	175	195	215	268	70	174	96	169	168	159	158	133	150	56	105	223	178	204	260	182	260	98	187	154	182	190	160	164	68	52	256	141	131	189	181	119	100	197	200	188	164	165	351	173	220	192	212	128	116	180	175	191	107	170	208	121	200	206	176	182	181	131	167	127	74	128	207	207	150	274	89	181	117	152	151	85	122	108	142	164	146	128	145	99	204	203	77	91	158	141	127	181	176	137	229	196	125	188	134	160	43	118	164	93	124	104	160	148	96	168	194	116	108	219	97	105	77	91	169	147	110	136	134	135	93	107	120	108	169	165	198	163	158	154	116	116	102	134	133	173	198	129	157	105	115	151	179	122	200	60	119	165	78	183	99	111	98	156	278	164	116	258	78	180	171	125	88	93	148	156	72	118	118	147	142	176	128	140	219	164	100	85	51	97	168	120	126	159	157	68	124	167	137	80	63	189	128	143	36	100	203	139	114	115	178	182	147	192	155	93	148	95	103	415	231	141	89	133	131	124	120	65	147	107	229	163	95	219	110	93	74	98	132	108	182	114	110	111	116	134	105	46	109	65	265	117	136	142	133	70	135	82	115	149	91	74	103	95	87	96	170	146	125	174	104	77	149	148	143	97	97	38	126	115	44	71	128	78	87	137	162	112	109	171	142	71	90	118	122	151	166	58	79	134	102	166	90	101	71	130	181	79	49	97	137	73	91	42	108	77	148	74	43	84	73	179	108	87	173	51	94	76	54	93	109	115	71	84	120	42	67	134	114	98	91	84	78	90	199	235	53	86	73	64	89	74	55	77	147	56	104	89	160	97	129	97	96	74	58	114	126	71	110	166	90	126	107	20	129	83	76	88	92	67	101	118	87	61	68	77	120	48	48	100	76	147	59	74	64	59	108	63	64	73	78	136	61	65	100	54	79	85	46	89	68	101	88	108	53	70	54	66	85	80	91	78	119	86	95	69	102	66	99	96	89	47	109	49	90	110	57	42	84	94	42	101	50	44	33	100	100	135	99	70	55	65	68	39	53	77	76	110	85	63	99	114	38	125	71	37	80	127	67	73	84	89	65	82	93	79	84	84	60	110	50	52	49	118	47	70	113	62	45	79	71	56	74	54	38	99	72	51	109	64	64	110	64	67	61	54	65	95	59	40	32	22	34	54	77	54	106	54	62	50	44	35	96	83	73	123	50	91	67	83	60	61	100	66	51	56	103	47	59	70	49	51	42	69	77	72	92	67	48	56	108	69	64	76	74	50	38	33	42	51	65	86	115	12	47	77	120	116	56	53	34	74	80	53	53	94	96	60	63	37	59	20	127	79	85	80	79	77	74	78	87	63	46	37	81	32	43	63	124	66	78	47	60	55	77	58	84	65	73	87	57	75	104	65	109	49	49	64	75	67	129	59	68	76	54	83	40	122	44	90	83	40	107	49	42	76	85	91	27	77	43	48	59	36	39	62	71	57	76	160	27	103	32	41	59	43	59	75	68	24	25	71	41	47	58	40	77	37	53	73	35	30	95	68	45	79	21	23	51	45	96	43	88	51	74	75	35	68	33	53	54	85	66	74	73	58	45	47	56	67	88	68	62	54	39	37	60	62	45	55	41	56	26	42	31	51	62	47	55	46	116	39	46	36	51	53	44	56	53	95	49	51	40	77	65	69	45	36	74	41	57	82	32	38	51	44	51	84	30	49	85	69	67	48	43	106	56	61	36	36	85	61	56	92	24	86	111	38	65	44	38	18	55	37	32	55	37	115	31	39	35	20	34	26	48	54	62	44	46	67	46	29	38	48	15	37	52	31	49	29	42	16	61	108	42	36	42	50	29	79	33	48	44	39	68	39	58	83	58	69	58	49	26	38	39	110	45	28	29	54	56	35	82	77	71	38	60	47	41	31	49	116	34	22	47	35	52	34	39	37	26	74	29	45	18	36	44	82	25	64	37	22	49	45	35	22	33	25	47	40	55	28	17	27	27	23	49	47	72	93	33	57	23	41	26	29	46	22	59	114	21	33	41	43	23	15	28	76	44	33	38	38	36	18	27	46	31	21	26	28	47	19	29	36	21	43	50	28	62	36	53	24	18	24	14	88	46	17	25	9	23	31	37	34	27	26	51	28	31	40	18	40	39	52	34	39	39	22	31	13	32	19	19	24	18	16	19	66	27	38	30	32	25	32	14	30	25	27	37	18	34	37	53	43	12	19	52	47	40	21	45	56	26	21	27	40	21	44	80	40	55	22	16	16	25	12	15	24	16	18	28	15	26	22	17	34	23	30	27	31	29	25	47	25	35	35	34	29	30	20	16	11	15	28	16	33	19	21	24	49	46	24	45	17	68	31	15	21	17	26	23	23	19	20	16	30	26	28	20	17	9	41	53	32	16	15	23	40	31	28	31	71	33	14	22	15	17	21	37	28	28	18	24	15	59	8	55	28	27	8	31	26	32	19	25	12	19	14	40	19	26	41	7	10	21	39	31	45	24	32	8	44	19	26	20	61	25	11	24	12	30	5	15	11	32	18	28	19	20	15	15	12	7	27	13	8	63	16	24	29	14	22	34	15	14	17	28	12	9	14	29	11	18	4	6	6	23	24	8	18	12	21	29	10	18	7	25	7	12	7	10	15	6	10	23	24	2	45	10	17	32	8	13	25	24	21	36	12	13	13	7	19	21	19	18	6	7	5	15	19	25	13	15	10	15	5	17	18	2	18	23	8	11	15	21	14	9	13	17	13	20	8	29	6	3	19	10	13	3	30	15	7	12	13	7	2	8	10	4	25	18	17	24	25	16	7	4	17	9	7	7	4	8	12	7	11	13	2	7	4	1	6	7	6	21	6	8	11	3	11	10	9	7	20	10	9	11	6	3	3	12	17	2	11	12	8	4	2	2	5	5	2	5	15	3	7	0	4	3	10	5	8	7	25	10	10	2	1	6	2	3	2	1	13	10	9	4	4	10	5	2	3	2	9	6	0	2	4	0	3	3	13	2	17	14	1	5	10	5	4	5	2	2	0	10	1	2	2	4	1	0	2	3	0	7	2	1	1	4	1	6	0	1	0	0	1	0	0	0
ne0361	4937	3991	2733	2424	3222	1737	2075	1408	2068	1607	1585	1522	1495	1335	1371	1704	1207	1162	1444	1197	1390	1200	1313	1300	1386	1228	1266	1226	1050	1103	1625	994	1391	1058	1078	1119	1221	1181	1276	973	991	1139	673	1074	742	818	1007	839	890	1076	778	1077	1287	754	769	871	875	704	1077	1226	787	927	1037	831	1137	873	737	944	801	653	1218	1244	790	887	1040	846	858	853	940	843	865	870	647	556	822	763	702	1037	898	905	635	729	619	835	744	861	627	794	646	781	750	634	637	813	694	985	722	619	626	629	527	753	645	599	557	640	586	670	661	570	764	512	569	705	667	643	767	1090	528	580	783	634	738	708	555	621	539	737	490	657	743	497	429	592	700	562	708	484	631	679	627	684	547	637	545	566	500	497	499	453	448	785	747	570	406	755	692	601	632	565	588	561	652	509	459	680	592	474	534	585	505	540	699	506	730	538	689	423	682	494	553	543	456	717	606	341	555	468	545	490	616	608	687	499	572	480	427	518	468	603	437	425	393	484	1207	570	460	650	490	515	510	743	720	607	486	500	531	478	335	362	521	662	560	556	412	598	525	870	417	529	452	446	414	424	446	547	396	485	331	359	639	492	369	383	354	401	619	421	493	559	310	414	511	485	519	513	343	362	497	475	492	567	320	515	327	506	394	297	392	423	533	452	582	348	378	485	377	399	512	339	534	353	582	388	243	494	357	445	470	512	785	378	674	371	466	496	515	462	323	474	395	590	455	548	324	377	512	515	486	445	451	402	478	321	371	268	447	380	415	293	323	359	367	510	368	472	350	372	357	418	354	443	365	322	315	370	526	350	470	397	413	360	414	341	357	308	278	281	364	465	502	383	261	486	421	368	391	359	251	444	333	418	455	292	401	410	347	248	370	335	318	416	317	286	269	349	300	394	383	295	398	233	269	371	448	361	361	224	361	485	328	233	280	262	330	250	301	410	307	317	374	351	309	287	214	348	379	271	315	526	307	377	230	312	235	383	241	350	280	308	227	356	248	308	319	318	286	302	297	439	223	239	230	334	314	358	279	300	360	213	232	411	422	325	272	339	236	241	220	260	234	178	291	353	318	239	253	225	329	205	220	225	233	384	154	253	285	254	381	201	347	247	373	214	285	296	159	307	159	205	288	321	260	420	292	389	227	297	249	291	409	174	221	159	197	259	248	235	252	268	175	200	220	382	367	345	318	345	222	291	315	315	316	264	248	295	204	204	261	301	215	221	251	304	260	334	361	190	199	221	246	247	287	220	397	226	212	207	265	214	226	179	242	244	280	215	182	279	126	348	296	139	166	223	173	158	278	266	255	303	426	217	204	240	319	122	181	337	184	413	216	235	220	214	237	191	162	174	185	158	145	162	190	266	227	128	228	189	196	162	203	248	198	230	280	247	247	281	207	151	194	134	267	244	276	255	235	282	230	211	252	214	204	249	111	151	196	250	207	209	157	217	193	285	227	231	257	153	220	167	284	158	248	174	213	136	198	191	266	224	314	146	278	210	264	188	180	111	202	241	159	173	211	243	152	198	189	221	189	127	217	169	201	121	189	211	150	198	141	202	215	208	296	250	162	192	135	209	298	224	180	153	227	199	212	188	90	239	142	462	196	148	337	196	104	147	138	208	149	141	203	211	194	251	276	169	101	139	138	252	119	176	173	200	110	193	159	194	255	161	132	168	156	152	124	136	208	142	251	120	91	184	331	226	132	208	125	224	170	180	159	239	171	107	210	235	128	218	197	182	107	132	136	116	192	225	113	145	153	190	166	152	167	119	216	188	107	161	120	176	122	103	98	148	136	157	144	92	171	162	202	99	122	194	151	125	172	135	145	173	148	133	133	185	110	105	205	220	123	178	147	149	126	207	409	90	127	141	178	118	136	87	112	162	93	135	117	305	179	189	114	138	134	121	167	190	124	125	243	123	135	181	71	195	182	150	133	117	121	255	143	149	91	113	182	158	130	149	165	118	143	103	145	158	96	139	126	131	173	139	189	128	108	104	109	131	112	141	165	110	125	176	136	106	95	132	112	166	118	105	158	102	132	135	137	131	77	144	117	123	98	141	125	138	236	104	81	131	124	130	174	99	118	76	144	131	242	146	104	114	145	116	104	104	180	112	134	167	70	221	110	90	145	74	88	140	189	152	102	122	149	124	130	81	135	99	112	129	137	88	94	117	181	88	123	156	142	71	180	94	101	115	84	64	167	105	82	114	142	122	105	155	112	85	161	120	124	107	116	96	75	102	77	112	116	129	87	89	79	80	151	151	112	91	144	126	95	99	101	116	108	154	137	91	119	119	94	99	90	78	70	61	107	86	80	120	120	80	82	107	126	113	81	79	79	85	82	132	110	117	105	158	49	98	54	133	121	89	86	88	86	137	155	101	137	80	113	56	107	109	62	181	110	112	121	99	111	107	107	124	87	100	89	110	59	154	111	134	119	110	288	98	106	98	117	88	108	104	157	72	82	337	71	73	90	91	84	108	87	113	90	89	92	90	73	90	143	82	110	117	98	78	89	88	88	84	162	74	87	81	113	67	88	101	60	106	69	88	149	89	217	74	53	85	74	87	94	111	84	89	95	96	84	70	78	95	104	80	149	56	62	112	88	75	115	49	76	98	73	94	113	100	91	154	98	73	94	78	78	60	62	128	121	108	102	80	90	72	69	135	89	75	71	65	72	111	89	107	55	87	60	77	66	72	92	130	87	69	70	160	61	76	53	51	81	89	90	74	137	50	56	75	140	105	90	75	91	52	71	52	99	51	60	58	55	100	115	70	84	101	122	130	74	73	110	80	97	76	54	101	83	84	191	77	83	131	64	123	56	65	47	74	70	58	83	64	76	77	47	62	80	53	49	105	95	86	91	60	81	102	47	82	76	104	77	66	41	83	64	51	58	79	94	120	39	80	68	57	84	62	95	84	91	69	47	48	71	70	77	65	43	65	56	56	162	76	40	54	60	97	70	80	109	62	77	102	69	56	53	70	34	73	31	71	82	88	66	49	70	35	87	56	62	44	66	50	141	65	62	56	52	111	127	91	55	67	45	90	71	56	34	28	38	36	51	72	48	73	90	47	76	40	83	62	74	51	34	108	123	46	36	46	55	60	50	34	76	97	68	46	53	66	43	44	80	64	36	41	59	84	41	88	63	53	88	60	49	82	36	43	48	39	31	36	53	274	55	44	43	39	37	51	43	60	50	52	40	74	81	42	57	53	267	49	51	32	40	44	41	42	24	34	49	35	38	35	69	35	67	40	39	29	43	34	53	57	73	48	19	46	42	72	64	39	31	53	110	44	23	64	50	48	70	57	76	38	55	61	72	64	35	35	26	43	35	42	28	35	31	34	16	33	50	31	64	70	48	80	27	40	43	86	50	63	48	43	26	54	49	38	24	51	31	28	20	32	34	38	86	75	50	34	38	37	48	29	25	23	27	32	64	28	54	55	54	42	37	32	31	29	68	43	44	30	69	90	54	24	49	58	79	27	29	48	20	20	56	43	27	22	37	33	30	58	11	33	30	75	25	36	28	32	22	26	24	59	28	49	30	34	57	10	26	28	54	50	51	38	33	24	53	12	39	30	64	24	35	18	22	35	30	31	15	41	19	32	33	25	25	10	35	12	34	18	15	52	14	32	37	49	24	29	43	35	28	43	18	30	30	34	31	18	20	20	33	32	22	24	28	30	38	27	29	31	17	27	17	22	14	25	20	27	16	26	27	22	43	10	26	25	15	20	31	34	18	25	33	29	6	14	25	22	22	26	17	11	14	36	23	35	23	26	10	21	16	32	27	23	20	27	11	13	25	12	34	38	16	22	7	19	39	35	11	15	237	31	18	10	21	24	11	9	17	6	17	24	6	5	18	27	25	19	12	13	16	5	24	11	14	8	13	10	5	15	13	7	9	6	8	11	17	30	20	15	13	15	12	7	10	19	5	18	14	17	5	25	9	11	12	10	25	10	7	35	6	13	3	16	10	36	2	6	15	6	8	4	5	6	15	4	31	6	33	9	7	5	3	22	10	7	11	3	11	8	10	3	11	10	0	8	1	6	14	4	4	10	6	0	6	7	11	8	29	11	10	6	2	5	6	3	2	9	1	4	2	2	1	7	2	2	1	5	1	3	2	0	4	2	2	5	4	0	0	1	0	1	0	2
ne0365	3328	3290	1977	1904	1775	1790	1518	1541	1249	1421	1059	1377	1068	1019	1209	941	1034	1163	1208	934	1080	982	952	797	966	807	1005	993	1054	1123	786	962	726	731	853	929	706	791	723	855	919	760	857	717	719	709	613	915	872	611	670	637	779	648	1051	756	721	767	719	677	643	535	645	853	746	842	575	572	661	589	823	697	780	625	606	772	539	565	714	602	562	783	495	578	595	430	663	605	555	721	637	537	384	605	428	658	433	511	510	527	507	581	639	535	527	474	465	394	443	841	528	682	388	411	407	601	380	531	486	420	559	433	690	674	668	471	566	411	368	372	423	495	495	447	478	573	633	451	346	413	432	500	522	383	479	447	375	496	526	509	438	371	484	430	507	468	426	390	393	528	399	542	335	478	514	397	431	585	384	527	485	424	385	591	290	440	439	302	350	438	255	391	396	468	430	409	408	438	411	477	551	424	395	306	337	490	483	281	505	311	494	401	429	371	547	395	401	519	401	540	264	340	420	361	477	406	323	415	410	396	424	349	464	521	562	335	439	415	380	315	371	496	480	380	420	404	351	430	470	333	291	347	276	302	498	396	299	279	334	311	283	357	400	398	267	225	280	369	410	458	415	345	382	402	354	304	446	349	438	358	266	313	280	277	296	318	429	280	413	371	344	399	348	504	240	529	477	316	254	372	360	367	357	381	298	354	363	316	363	345	376	366	345	360	444	368	334	351	403	340	329	284	337	243	350	471	436	373	229	306	226	334	272	237	319	414	321	296	210	317	323	299	336	262	275	399	334	323	234	214	241	406	335	292	299	289	411	357	276	326	223	356	340	339	230	307	218	284	355	290	255	302	410	271	321	286	237	312	295	404	307	218	291	239	216	315	350	328	241	279	302	281	269	246	342	305	200	292	255	250	225	303	317	311	163	249	248	258	307	205	305	259	263	352	299	240	239	370	209	329	244	247	208	231	345	337	252	218	227	232	261	244	219	279	272	234	244	217	300	281	246	269	274	246	235	232	216	219	252	215	222	257	200	274	192	198	209	287	239	245	238	163	249	230	304	252	241	259	180	182	160	306	186	251	221	205	194	188	237	227	183	241	225	200	211	176	231	147	196	270	262	149	208	228	196	187	230	189	245	232	224	192	186	181	212	175	201	189	190	171	158	218	204	377	230	178	231	184	243	227	190	200	206	159	163	228	176	209	163	133	195	187	250	199	177	187	262	179	249	181	196	239	174	146	172	254	177	166	303	172	232	147	190	159	166	303	174	239	170	203	208	205	189	169	244	251	249	197	231	161	194	202	179	130	197	214	147	215	222	145	147	266	189	208	138	270	150	135	137	155	190	186	161	216	221	160	140	249	236	215	128	172	140	220	151	247	155	161	125	240	165	174	170	220	131	147	126	168	123	155	122	207	196	185	225	153	159	139	129	176	180	195	185	226	203	137	197	194	147	200	166	237	157	178	188	211	160	154	200	201	177	116	180	169	159	146	149	175	215	180	117	118	219	140	119	163	232	182	231	148	124	111	146	89	189	158	122	147	148	224	142	158	146	186	112	152	168	156	126	122	151	177	141	118	181	153	177	134	172	137	139	148	118	108	189	117	133	162	153	129	144	155	103	127	177	125	100	131	106	200	128	186	159	136	158	115	167	137	157	159	182	137	152	171	182	166	94	187	109	168	146	105	187	133	148	178	111	103	100	164	146	156	132	119	122	132	169	156	118	122	110	112	163	163	153	87	108	102	160	97	134	157	167	170	112	112	216	90	161	146	115	176	94	110	125	118	144	93	112	108	106	150	168	119	145	100	182	143	120	115	122	194	156	117	134	158	113	129	138	92	91	151	158	103	133	100	77	102	97	172	103	134	84	132	105	146	124	159	94	165	171	139	110	79	127	128	99	108	139	110	101	160	80	121	100	96	190	106	117	73	168	120	149	118	114	77	113	115	122	115	85	105	155	62	97	101	127	121	139	99	128	114	134	112	105	118	97	122	107	104	120	132	122	83	114	107	177	83	135	133	88	110	122	181	140	167	96	123	117	130	128	97	110	106	129	86	135	98	112	134	175	85	114	110	132	94	156	140	120	135	76	65	70	118	81	109	107	115	104	134	100	70	112	135	100	79	92	85	95	102	113	97	103	161	153	106	82	85	88	110	63	99	64	92	86	110	127	93	85	105	87	99	114	125	76	139	92	67	136	106	64	64	102	88	109	89	116	84	89	75	101	110	73	151	94	122	62	103	115	67	100	60	138	100	69	110	75	97	84	105	128	70	118	57	97	75	126	90	50	122	76	91	168	54	99	106	50	105	76	127	76	104	58	186	79	81	101	78	87	89	122	77	72	83	104	76	89	97	89	72	93	60	80	98	85	112	64	88	72	90	69	88	103	66	67	112	107	75	72	96	89	92	80	55	64	63	71	82	80	93	87	92	44	80	103	89	90	48	61	76	59	83	67	60	85	89	43	49	44	91	56	65	106	55	68	99	79	70	55	96	45	85	78	96	64	76	86	50	52	70	108	48	41	102	94	69	104	60	79	79	76	107	108	85	117	66	137	53	60	93	84	67	131	38	72	54	77	65	85	73	42	109	40	76	65	71	96	94	83	77	58	88	59	47	37	56	58	65	78	46	75	63	78	49	44	87	92	51	79	48	48	49	93	93	131	70	63	69	51	42	70	62	169	74	76	56	45	87	54	92	34	43	125	92	54	64	51	50	90	89	89	90	83	70	102	57	80	64	91	72	81	83	62	38	56	76	65	62	101	76	79	22	50	58	85	94	114	119	63	81	74	57	44	64	46	81	79	67	76	63	51	73	39	50	30	44	53	69	58	48	67	60	103	69	61	74	72	50	89	84	46	59	28	53	47	53	88	64	71	51	66	67	63	39	43	183	73	71	30	75	48	40	40	48	35	53	42	43	62	59	83	43	52	83	56	45	58	51	61	64	52	64	48	44	43	74	37	70	64	41	27	52	39	44	48	26	61	67	30	50	115	34	67	91	88	53	63	141	39	57	47	69	27	71	28	57	58	41	64	31	50	32	55	65	52	34	59	50	48	42	30	30	53	71	50	37	26	49	51	36	57	63	63	53	74	46	59	30	57	87	41	38	50	64	89	80	37	48	46	23	50	48	58	44	30	15	26	43	54	47	65	45	58	31	48	44	66	36	31	44	77	47	44	51	47	148	70	34	43	35	38	54	31	28	45	22	42	42	36	52	61	55	24	47	43	52	14	61	40	41	44	23	57	84	29	52	25	81	32	30	45	44	31	46	31	53	58	28	31	39	24	28	27	64	22	37	27	48	22	41	23	32	38	40	53	28	35	52	46	29	66	43	95	33	42	38	32	35	33	52	56	33	38	29	32	23	37	12	35	34	27	29	27	34	25	24	31	15	23	37	32	16	46	49	39	41	46	28	27	44	14	31	39	37	42	37	60	39	41	45	25	30	29	58	15	26	46	47	37	37	25	16	22	31	39	26	19	33	35	27	41	53	49	15	27	34	21	33	33	34	34	24	15	50	14	39	19	17	34	23	20	26	23	26	32	25	33	13	23	27	48	10	23	34	29	22	23	40	27	26	31	24	33	33	23	24	20	16	42	17	20	14	28	20	33	22	28	27	54	19	32	31	23	31	53	20	30	21	11	23	25	36	39	15	23	18	30	21	26	35	26	22	9	38	13	25	24	9	19	36	18	8	24	12	10	26	18	10	29	30	21	28	19	20	14	13	32	13	15	17	6	15	8	23	17	17	27	20	20	17	5	12	18	15	8	3	9	25	27	10	26	15	17	14	24	11	11	2	26	8	13	23	15	9	17	12	12	9	15	18	11	12	15	15	11	5	20	23	35	16	16	13	30	16	14	13	20	6	9	19	7	17	10	7	6	8	6	15	22	10	8	13	10	24	10	22	11	37	3	15	12	5	8	7	11	16	8	14	20	8	15	18	12	27	15	30	18	12	6	8	3	10	17	5	3	9	3	7	5	19	22	30	9	17	11	5	2	13	26	4	9	2	4	19	2	6	30	4	12	2	2	11	6	1	4	4	3	4	2	2	11	6	4	15	0	3	0	1	1	4	6	20	3	1	1	3	3	1	2	2	0	4	3	7	17	7	1	1	5	1	0	2	5	1	0	0	2	22	3	6	0	1	0	2	1	1	0	0
ne0370	1898	1744	1090	980	963	1010	875	913	756	926	532	698	657	600	517	598	660	535	807	522	547	593	483	558	604	510	465	488	682	544	431	705	421	428	427	443	433	458	388	389	493	376	643	532	454	318	386	535	465	327	411	350	318	374	569	412	382	372	443	283	358	441	286	391	339	508	311	415	420	336	398	420	512	328	311	329	354	419	451	318	307	461	337	357	300	271	412	251	276	425	386	299	251	312	310	290	303	323	451	495	346	346	349	364	342	277	236	253	360	400	343	362	240	232	243	329	252	297	353	252	333	306	275	360	306	230	249	274	241	261	221	327	204	297	269	326	555	220	251	225	270	319	357	203	214	269	183	263	300	312	269	225	296	277	290	388	287	256	240	268	288	267	185	270	251	206	234	292	239	325	270	198	212	225	197	233	222	182	219	246	179	156	190	307	166	211	230	241	240	293	283	252	370	198	225	273	217	208	289	276	303	207	274	207	255	233	290	208	223	332	177	251	414	270	264	269	196	179	232	211	200	184	203	299	239	231	208	176	238	206	225	284	276	264	265	145	147	183	199	201	219	159	178	165	238	222	186	183	291	166	152	199	214	207	134	151	177	205	226	247	295	174	199	217	243	171	213	192	200	171	149	167	158	162	146	178	223	161	228	169	177	211	165	171	131	205	158	236	143	223	161	222	135	192	151	145	219	185	215	181	156	160	178	211	251	130	163	199	233	153	140	144	146	152	186	203	243	147	181	143	164	159	167	133	176	243	190	152	166	174	221	199	213	122	209	237	179	137	141	121	149	224	121	146	202	178	214	134	148	190	164	200	181	176	170	210	147	191	184	159	142	125	164	127	167	163	166	173	178	209	148	134	129	133	107	150	195	115	130	122	115	126	161	157	175	185	130	159	161	165	140	166	169	134	123	153	134	131	143	161	153	88	169	153	168	168	157	156	142	150	130	132	156	156	179	190	132	104	161	170	155	152	157	144	147	84	132	130	143	122	176	159	171	191	119	156	131	149	146	119	139	123	106	144	115	116	125	189	126	119	118	121	189	123	106	145	112	151	114	116	117	161	72	139	101	129	173	113	148	113	72	125	88	136	116	103	172	97	91	162	179	94	102	107	113	108	200	144	147	126	152	89	116	144	90	90	179	127	135	78	108	108	132	180	131	128	88	110	111	166	135	97	145	110	93	111	99	117	96	92	86	81	92	86	109	102	141	102	126	135	132	104	129	110	57	102	143	84	97	143	134	104	88	91	137	249	86	85	67	141	106	113	137	137	114	109	155	99	128	101	124	80	108	96	148	121	96	136	155	90	105	154	119	126	67	164	186	155	103	84	86	119	93	122	104	87	107	159	93	150	92	88	84	103	83	91	161	94	96	117	151	104	89	75	81	93	69	99	58	62	91	72	91	92	102	108	105	84	88	100	92	70	105	68	122	89	104	111	104	114	97	102	88	82	124	84	142	108	149	109	103	153	75	99	66	59	70	130	90	90	81	81	86	77	62	55	148	142	87	112	97	121	72	64	122	113	64	86	103	133	119	67	103	125	93	181	113	75	156	50	74	109	92	59	87	97	99	65	57	66	69	87	71	85	91	80	89	66	98	62	93	100	65	73	84	79	61	72	64	80	69	99	100	67	54	71	106	55	65	90	92	79	128	78	77	69	103	87	49	78	69	68	66	68	75	72	61	86	72	129	59	86	78	71	72	73	119	65	71	71	74	48	71	210	85	50	66	66	61	75	106	69	81	83	62	49	207	54	141	78	52	94	50	58	79	75	100	33	111	84	64	69	53	99	73	78	141	85	52	128	56	98	104	51	70	105	65	70	104	55	52	66	63	71	65	54	52	61	74	99	51	78	59	97	57	69	100	68	64	55	67	62	54	78	80	62	50	61	67	71	53	53	78	62	46	70	92	80	50	49	87	165	111	57	80	47	45	64	81	42	53	88	80	45	41	56	90	43	51	54	33	78	74	52	70	47	54	60	41	52	82	75	33	69	38	55	94	50	52	99	54	85	65	77	64	63	45	51	72	56	81	44	51	60	65	49	85	27	61	71	50	68	60	68	44	50	61	89	62	60	31	45	80	65	66	43	43	64	49	39	37	68	60	61	50	38	63	31	62	35	80	74	55	76	38	28	44	38	63	66	53	76	69	97	46	66	52	31	50	61	35	63	32	104	46	57	49	27	45	49	60	34	59	58	59	79	58	38	29	37	45	69	55	67	56	34	59	63	56	38	52	43	49	64	41	55	49	54	74	46	61	61	52	32	53	50	35	63	42	62	63	61	33	39	48	44	34	48	37	71	74	52	48	42	39	48	49	47	47	44	60	71	51	32	51	54	93	41	40	44	54	43	42	56	57	46	42	50	33	60	45	66	72	43	32	33	55	48	49	72	48	64	42	35	48	36	48	37	41	43	54	114	33	38	38	45	52	39	49	46	40	43	60	43	32	35	57	31	25	135	39	62	57	48	35	60	82	44	41	31	34	46	51	47	85	48	54	54	47	53	67	43	25	46	39	36	70	56	56	52	51	75	61	45	57	64	55	39	63	30	31	40	50	24	42	49	80	26	61	18	51	44	21	53	77	56	45	60	75	37	39	19	53	77	29	56	55	32	22	29	43	30	26	27	20	58	62	33	65	69	39	40	27	39	44	38	41	27	33	25	36	29	31	41	35	30	28	52	21	37	77	29	42	41	31	30	49	31	53	51	68	58	25	23	43	32	33	55	32	60	54	38	27	15	30	46	37	34	44	45	33	32	32	45	45	41	36	54	20	46	32	21	43	34	60	37	32	40	47	34	37	32	24	28	26	25	27	25	47	21	31	31	52	39	51	38	25	43	60	42	43	38	21	29	23	20	43	46	27	25	40	22	31	23	34	61	46	45	10	67	25	37	14	37	20	40	14	30	24	34	36	39	27	38	30	29	31	16	31	39	16	41	30	17	32	41	63	31	33	28	21	28	25	24	26	17	19	35	25	27	14	28	29	54	32	25	27	30	36	17	48	37	18	77	30	36	25	35	21	16	27	13	20	39	18	24	19	28	36	22	28	28	34	22	8	16	27	26	25	19	47	23	38	29	44	17	27	31	30	37	24	27	26	33	37	42	28	21	17	14	25	36	38	26	31	51	16	20	40	28	25	21	18	15	34	29	35	24	23	24	24	42	31	37	20	39	28	24	27	13	13	23	25	34	40	14	13	26	17	26	21	20	28	20	24	40	17	16	18	25	23	24	21	21	17	23	5	16	17	38	28	37	20	39	27	31	24	9	18	27	53	30	22	46	14	27	16	25	10	12	15	22	22	25	31	26	10	29	20	36	47	32	57	16	29	25	28	16	25	20	27	14	28	19	32	12	55	13	21	10	41	15	10	28	21	35	33	19	7	25	21	14	28	56	26	26	15	15	21	20	16	13	19	13	22	20	20	23	10	16	13	16	18	23	12	16	28	24	20	11	17	14	17	27	17	11	16	20	17	20	22	18	20	13	12	11	32	9	22	29	23	83	42	16	25	19	11	19	22	13	24	8	25	15	29	22	11	7	9	20	10	20	26	18	16	18	9	13	20	6	9	19	13	8	8	11	10	14	20	10	16	14	24	22	22	10	14	13	21	12	7	31	22	14	36	6	12	16	15	19	22	13	21	6	22	19	14	14	10	9	18	14	8	13	14	7	9	3	21	15	12	14	17	14	6	13	8	8	16	18	25	13	12	11	16	6	13	15	8	7	4	10	3	18	13	10	15	4	4	6	4	5	8	13	8	3	4	5	12	9	10	6	7	10	6	6	11	23	9	11	7	17	5	30	2	3	8	13	3	4	13	3	15	4	9	12	8	4	20	9	6	8	18	10	11	6	9	5	70	8	5	1	9	11	7	10	7	9	6	3	5	6	11	18	6	3	6	8	7	4	1	5	3	5	9	11	7	7	4	6	5	2	3	11	6	20	1	8	3	1	6	3	9	7	0	7	3	10	5	6	11	1	2	5	5	2	1	8	9	3	7	7	7	2	6	2	5	11	5	9	0	9	3	3	4	9	4	3	4	3	8	5	3	2	1	3	5	4	2	2	11	3	1	0	2	1	0	0	2	2	1	1	4	0	4	3	3	21	0	0	1	0	1	1	0	0	1	2	0	2	2	0	0	2	0	0	0	1
ne0373	1072	2346	803	637	858	416	479	301	496	447	732	293	390	325	588	359	220	429	400	323	384	340	401	239	334	390	621	280	463	456	531	283	194	245	533	556	297	437	310	548	314	242	315	184	230	246	134	212	410	334	144	243	325	188	142	355	357	342	262	307	148	305	831	500	227	196	127	242	206	408	267	345	334	271	436	586	237	242	220	290	191	341	63	238	427	93	209	246	335	197	355	316	75	209	142	296	96	256	183	162	164	266	364	85	145	122	234	147	274	109	190	145	114	62	91	184	98	284	248	58	318	51	304	218	220	218	191	177	61	82	188	207	199	241	244	434	280	168	69	134	129	161	219	173	359	194	201	225	150	153	113	105	143	121	269	171	134	247	62	109	171	189	170	150	195	184	207	238	266	108	309	139	139	216	53	217	168	55	194	158	90	329	174	102	198	298	202	185	140	132	178	105	176	129	226	98	160	44	139	88	139	148	162	148	201	159	130	107	245	147	47	280	191	114	172	413	122	277	183	205	382	165	212	87	304	315	129	210	133	80	210	82	229	296	114	254	341	214	253	109	424	162	200	259	195	93	120	172	158	205	91	190	140	173	236	25	173	112	246	236	130	190	161	75	164	192	69	96	173	173	162	132	87	103	209	138	151	104	187	151	259	147	138	177	198	195	207	121	257	93	139	151	186	116	122	126	99	119	87	84	258	110	171	147	86	173	206	268	77	143	210	123	150	122	183	146	86	249	67	106	181	217	118	139	155	123	83	115	129	163	104	113	67	70	93	68	185	198	127	78	93	91	137	83	94	118	93	156	152	167	72	101	143	166	78	52	122	173	220	137	153	108	122	188	120	126	79	311	90	63	145	142	125	57	93	138	66	137	126	85	36	208	113	108	159	130	41	157	61	86	93	137	79	200	84	87	127	72	171	71	106	179	105	82	88	92	112	156	54	112	136	157	86	108	126	69	120	231	106	33	98	184	79	109	158	65	81	106	161	80	144	152	105	118	112	98	124	100	168	96	102	177	119	70	88	71	113	80	146	38	132	81	66	63	135	93	84	106	140	155	63	54	137	86	79	53	95	103	143	106	35	35	90	59	105	97	75	103	207	85	78	114	118	96	41	125	46	58	99	119	65	77	138	122	146	81	77	101	61	116	72	102	82	58	83	75	140	88	114	54	53	88	67	96	94	197	68	180	51	54	98	159	138	128	62	49	136	73	149	37	85	128	66	87	205	86	84	63	113	114	97	215	109	79	164	97	223	84	112	86	128	79	61	80	119	143	98	91	85	69	78	80	71	44	62	36	67	49	62	80	43	51	63	83	64	48	99	32	94	51	82	52	85	65	44	99	85	82	72	60	55	120	112	134	47	96	49	68	65	61	50	93	147	57	89	82	126	103	77	78	61	72	114	141	127	78	69	68	65	92	83	116	53	158	45	68	52	152	106	93	45	68	91	87	132	107	68	72	73	80	121	193	126	77	95	57	98	52	119	61	102	84	30	56	48	96	62	19	138	46	52	41	84	39	90	71	79	176	129	84	56	155	46	41	68	55	64	110	39	84	102	71	48	115	45	68	54	97	94	119	81	53	148	53	79	61	39	113	38	93	75	48	39	71	24	56	78	62	25	118	85	121	128	68	188	70	48	84	41	80	27	93	35	118	92	90	47	78	44	39	73	112	200	63	66	167	237	23	30	100	71	83	53	93	49	42	102	57	54	75	55	53	80	46	88	28	62	84	119	56	55	42	66	50	57	95	62	45	77	69	156	89	83	50	46	38	37	69	37	78	59	26	81	33	49	51	35	42	49	65	81	49	54	53	59	56	44	87	26	79	34	56	73	41	41	70	40	62	32	33	81	36	21	40	45	54	48	62	68	54	73	86	32	25	21	86	30	54	96	22	50	42	88	92	56	39	35	48	86	40	35	67	15	24	65	49	41	27	76	107	50	65	12	146	85	44	59	70	78	38	86	64	32	52	25	86	43	49	182	64	61	173	61	56	88	84	17	43	67	42	58	20	139	41	40	79	60	81	30	28	37	49	71	98	61	27	22	80	70	29	88	65	61	23	64	85	34	39	18	72	62	20	190	120	53	38	66	36	55	58	85	35	55	14	32	64	29	48	28	80	31	29	35	66	47	86	79	47	22	73	62	24	35	17	47	40	54	70	45	50	77	34	92	26	48	54	25	70	28	52	29	57	68	25	40	34	30	64	62	37	59	24	97	34	173	38	23	31	27	34	54	74	20	32	40	70	9	57	52	126	37	32	56	43	76	51	88	34	19	23	40	38	52	97	32	42	36	63	54	20	29	93	28	55	18	35	38	55	47	87	40	39	17	38	28	34	32	45	55	36	95	46	52	54	41	42	16	74	83	45	57	34	212	16	82	80	27	15	50	59	12	33	93	20	29	63	31	91	39	45	33	45	18	11	16	113	59	10	19	23	59	38	103	16	96	47	33	37	66	57	60	47	30	19	65	32	100	30	20	72	30	37	29	25	21	27	68	31	22	53	44	24	26	49	63	49	74	75	14	16	46	40	69	197	10	46	28	23	28	38	64	27	27	16	44	35	19	44	74	31	11	31	35	13	30	39	49	31	19	49	74	90	33	72	34	13	66	22	37	41	82	27	26	40	18	11	27	24	23	14	17	37	37	52	35	38	73	15	25	65	54	20	32	40	90	62	26	26	83	47	4	17	49	26	34	36	27	30	62	15	19	25	52	42	61	57	28	28	43	13	10	28	38	17	69	19	38	63	36	46	47	13	107	27	14	4	49	22	26	48	45	39	11	43	35	44	53	109	43	34	57	34	45	16	23	30	28	20	65	18	50	43	12	29	6	45	37	15	27	16	16	23	21	25	44	54	36	7	52	21	23	37	57	15	15	39	24	32	30	16	52	10	9	30	14	39	18	64	26	29	35	41	50	69	29	36	28	24	33	15	25	20	34	29	16	59	11	22	50	20	60	15	9	16	57	21	25	37	31	18	50	26	11	16	23	23	78	26	41	12	23	13	27	14	37	23	43	14	42	20	30	22	19	13	25	2	21	32	29	41	16	32	12	24	8	32	36	43	37	28	13	16	5	71	69	48	12	45	42	22	67	17	26	26	24	24	7	53	28	29	19	15	29	18	8	18	27	13	33	17	14	59	25	47	40	29	23	14	12	17	62	17	42	108	8	16	22	35	14	28	48	16	27	29	8	25	49	38	14	15	38	18	27	15	30	20	60	25	17	8	19	17	14	34	25	55	37	30	27	17	17	15	18	15	40	24	16	37	22	11	15	8	17	25	42	19	21	26	6	58	25	21	19	3	11	24	12	69	53	15	14	4	15	40	22	12	9	37	15	28	27	23	28	41	36	9	17	87	19	19	30	29	33	36	8	25	23	29	38	17	19	8	39	48	21	13	20	19	28	23	19	28	49	59	12	21	24	11	12	13	16	3	41	76	34	29	28	28	24	8	14	15	22	40	15	21	10	19	18	6	19	18	12	12	41	6	14	23	6	32	10	29	8	12	19	17	13	10	22	9	28	16	11	26	12	34	17	20	19	3	25	8	11	24	18	23	51	22	10	24	28	4	27	9	31	17	8	24	4	7	5	13	26	33	14	13	29	7	15	13	50	30	10	11	12	9	8	12	21	16	25	26	8	15	9	13	7	20	20	21	20	11	33	14	3	19	20	7	8	6	11	26	15	5	6	8	27	3	8	13	15	3	5	13	4	17	18	12	23	6	9	10	3	15	11	7	8	9	22	3	62	9	9	8	1	10	10	7	19	25	5	8	6	11	14	12	19	15	6	8	3	5	7	1	13	15	8	19	21	9	10	6	7	16	5	2	5	15	5	8	4	20	10	15	7	3	2	5	14	8	5	10	13	1	8	5	17	3	5	1	17	4	7	3	21	4	11	15	4	3	13	5	6	2	6	2	9	3	13	5	9	13	0	6	11	5	4	5	1	3	12	7	4	7	1	23	4	9	1	8	14	11	5	3	0	9	9	8	3	2	6	9	10	19	24	12	17	2	10	5	2	9	3	4	9	12	3	7	0	7	5	2	30	4	1	5	0	1	0	4	2	6	12	2	2	8	0	4	7	1	0	12	16	5	2	3	19	2	1	1	2	0	1	0	0	2	0	0	9	1	2	5	0	0	1	0	0	0
ne0378	2665	1400	1268	1338	1229	1154	868	971	1195	867	1215	1021	959	810	761	696	584	993	475	711	831	590	574	558	820	773	811	583	506	616	708	575	643	559	501	608	515	758	613	480	462	506	451	656	259	431	567	348	336	562	550	539	399	428	392	416	813	687	522	407	516	478	624	745	630	455	478	491	456	603	422	559	406	442	565	924	694	571	355	481	369	452	414	331	690	503	346	432	315	318	460	312	404	390	402	345	518	420	324	239	410	216	288	387	405	465	411	411	283	292	481	323	434	376	415	309	497	312	634	444	405	354	416	294	361	326	330	231	420	401	525	233	429	282	376	491	361	275	352	311	415	242	239	380	335	408	488	427	368	275	281	360	379	290	379	395	472	369	384	308	327	331	301	331	205	313	320	300	448	162	216	453	301	323	423	309	482	337	433	335	349	220	300	397	253	519	224	248	368	322	283	327	248	352	453	151	308	333	350	338	309	348	205	266	395	254	231	243	223	264	380	348	273	215	181	260	347	336	232	373	414	156	321	220	207	245	322	233	410	370	266	253	193	396	260	235	280	345	334	305	263	214	234	561	727	268	280	166	265	106	290	269	154	326	222	310	177	256	208	185	182	270	268	187	370	256	342	380	276	257	279	361	217	205	263	310	219	161	274	311	249	134	338	394	344	685	157	131	232	146	355	165	336	278	449	241	169	295	116	224	251	240	329	189	176	189	303	133	232	318	390	177	318	243	235	401	196	409	140	260	246	177	309	339	332	289	218	222	148	390	245	168	172	95	131	160	219	286	281	342	160	206	130	244	142	215	185	215	279	240	229	175	215	118	143	401	149	197	237	161	352	305	107	267	153	211	257	162	152	177	188	284	182	168	283	374	260	157	157	169	245	261	178	115	216	201	273	196	155	224	218	202	146	255	125	215	159	200	317	146	179	160	139	140	182	245	200	185	218	209	251	196	160	120	150	277	222	176	208	129	167	345	173	134	163	112	119	182	211	204	95	167	109	201	226	70	214	144	249	245	276	226	147	145	139	170	222	285	138	68	171	109	201	182	198	187	84	206	173	154	76	88	121	136	141	193	224	221	164	172	376	197	114	123	139	135	117	191	207	206	225	94	219	302	95	247	78	92	53	157	203	218	287	304	256	200	212	104	93	123	143	160	115	87	66	214	234	87	81	113	172	130	153	205	197	128	146	256	138	168	186	140	144	69	126	165	148	130	127	83	146	156	180	197	160	165	113	88	189	207	97	183	239	111	346	91	159	134	122	153	112	148	101	117	116	138	260	123	96	164	232	168	83	156	156	98	184	75	231	260	95	181	136	120	163	128	93	55	134	88	218	92	96	130	90	183	157	86	103	130	138	124	275	222	183	160	88	133	114	126	63	254	164	84	189	183	142	131	188	127	256	191	206	203	108	200	152	141	88	138	237	207	75	130	78	116	104	47	180	158	102	74	132	90	175	135	108	71	203	224	31	116	78	86	148	149	98	73	165	116	156	154	132	119	173	118	76	70	120	67	83	114	411	112	85	54	125	68	245	103	170	178	107	63	312	68	184	171	38	137	118	100	94	138	111	106	157	220	107	190	78	280	127	177	210	232	57	93	55	159	185	81	167	102	107	80	104	122	64	127	174	110	90	146	119	171	83	127	62	72	90	93	68	133	160	119	70	80	114	130	190	108	54	179	134	162	143	88	149	116	87	152	89	71	41	72	108	101	65	93	177	106	103	246	151	157	72	74	171	207	63	55	60	66	163	191	61	266	93	71	124	84	92	116	108	104	51	102	75	81	99	46	45	50	123	184	36	80	130	76	75	80	56	111	146	57	66	49	81	136	161	74	146	53	76	42	130	54	43	43	61	138	44	21	102	49	95	74	104	47	25	153	149	95	83	39	54	115	68	51	120	109	106	198	110	90	95	86	57	52	46	79	49	55	71	97	90	79	97	92	94	74	67	94	70	76	91	67	119	160	116	108	54	98	73	68	261	85	79	133	67	73	127	73	49	90	44	98	58	76	48	57	108	34	50	164	93	138	101	104	72	102	119	86	123	88	71	56	63	61	38	42	81	116	100	143	24	48	86	65	85	130	77	70	78	26	91	65	85	112	86	115	69	43	43	116	92	50	113	114	116	70	43	29	73	135	88	23	49	80	217	44	133	61	71	61	57	25	118	73	87	104	82	67	115	82	138	303	65	89	69	69	133	46	94	90	81	69	109	111	69	49	78	34	57	85	26	59	49	81	69	38	29	31	77	78	118	93	257	56	44	81	113	109	91	84	39	54	169	67	96	101	137	36	69	75	154	107	126	37	22	35	150	88	28	74	116	67	158	47	41	78	35	108	72	47	31	49	42	84	93	56	57	64	71	43	66	51	80	38	92	41	40	41	121	72	202	140	50	67	43	66	33	52	39	133	40	73	89	79	50	75	148	25	52	20	26	146	16	87	35	65	42	70	72	49	71	81	66	35	93	60	136	52	66	47	81	30	56	66	50	46	88	64	44	78	53	98	36	123	62	62	38	55	83	55	50	61	35	55	93	38	77	67	28	69	33	40	40	44	85	35	40	52	38	47	121	30	52	28	50	62	60	42	32	43	47	121	93	28	69	32	129	42	88	30	21	54	92	89	31	69	101	84	67	53	49	18	32	40	50	61	45	99	42	66	33	16	52	30	49	38	41	53	62	65	58	68	81	55	39	45	76	115	50	88	177	39	32	40	18	27	30	69	40	36	31	17	141	211	33	40	105	54	59	66	43	86	64	41	44	117	66	20	48	23	51	89	42	37	47	48	24	66	29	59	69	21	83	28	55	30	53	132	77	51	28	39	67	72	68	24	18	54	65	35	57	44	70	98	29	73	51	30	121	54	37	38	56	47	34	18	52	26	80	54	29	20	59	14	23	31	67	46	61	58	73	46	68	38	46	74	34	72	69	57	26	52	13	46	31	35	39	74	40	37	46	61	62	54	24	44	92	48	36	161	19	50	7	31	27	108	44	84	47	37	46	41	29	32	29	25	41	23	39	38	67	24	77	40	46	66	38	107	35	62	64	74	133	55	86	8	27	33	13	58	27	27	35	39	49	21	22	47	20	69	33	76	70	23	12	60	35	100	31	33	34	68	58	94	39	48	43	57	51	51	31	15	46	31	5	46	20	18	15	24	36	50	36	44	81	33	65	62	19	75	99	15	24	12	22	18	64	48	14	43	63	18	37	10	41	41	36	30	25	53	33	29	9	25	44	24	45	22	20	33	21	62	9	12	64	13	37	27	51	76	50	27	31	63	52	33	10	30	42	33	26	30	152	45	49	46	32	8	48	48	32	46	32	93	62	9	14	13	29	35	17	58	39	17	13	36	21	24	9	29	84	29	43	69	25	70	41	47	30	62	32	18	52	29	21	54	18	22	21	14	26	53	80	36	9	72	10	29	47	20	22	9	23	14	32	18	55	12	35	46	18	20	21	10	39	25	29	11	37	13	34	27	10	17	36	11	36	31	37	36	32	17	50	29	15	32	42	12	9	26	20	16	16	19	36	62	8	12	40	10	28	38	27	41	45	15	13	18	39	36	11	9	30	28	38	10	20	35	17	30	28	25	13	6	12	19	17	33	2	38	27	3	31	33	21	11	67	29	25	39	10	25	13	13	25	24	17	25	3	40	7	31	21	19	13	23	5	14	12	68	22	0	65	49	35	24	26	18	9	9	21	4	32	15	21	20	20	29	4	12	22	27	9	7	9	1	16	20	14	15	18	34	4	12	42	45	34	25	5	33	6	26	31	20	10	7	13	10	29	28	20	0	17	9	31	7	51	19	15	6	27	20	18	22	23	17	5	5	11	7	14	21	14	5	3	5	28	24	13	11	29	21	14	9	32	5	23	46	20	12	6	12	6	22	17	20	18	0	25	25	29	11	7	4	21	11	3	2	29	5	10	5	1	10	29	12	20	12	22	69	5	4	8	6	11	6	9	15	75	11	6	8	37	16	9	29	12	3	0	6	10	11	10	3	1	14	9	9	5	16	9	5	10	32	14	4	7	5	9	0	6	23	51	2	1	3	6	5	3	4	3	2	11	4	1	0	24	8	16	24	4	7	4	5	10	5	5	11	21	6	1	0	0	1	0	1	1	1	17	3	6	0	2	7	9	2	3	1	1	2	1	0
ne0379	815	756	409	573	570	341	286	329	240	172	301	306	239	202	165	348	234	281	234	224	170	234	234	213	210	177	167	132	138	130	236	171	176	173	196	127	156	164	170	99	163	152	220	130	178	184	198	73	83	169	206	178	210	261	249	113	195	203	108	184	163	135	286	115	169	117	159	124	142	179	175	223	163	117	254	180	149	148	106	212	115	131	206	121	170	158	164	162	200	81	115	96	143	141	124	173	156	123	107	137	71	151	165	145	78	135	123	136	78	159	117	115	139	131	157	148	122	72	130	172	64	158	155	87	114	98	65	221	120	131	143	74	99	74	54	162	74	101	132	70	149	39	157	97	132	55	86	127	69	90	110	71	49	57	78	104	64	138	125	125	113	87	115	44	68	101	73	59	87	150	46	101	101	62	120	83	90	131	98	122	51	92	128	90	176	86	130	76	73	81	78	27	86	108	70	130	114	126	27	49	55	102	166	87	134	43	101	69	61	46	118	37	77	68	100	29	103	135	53	99	140	113	84	37	49	54	66	39	73	105	65	57	76	98	52	71	115	81	84	67	30	87	100	97	50	68	46	77	93	87	115	95	76	94	51	109	86	68	55	74	114	74	84	19	57	56	39	84	140	56	81	77	86	67	27	67	121	62	65	86	138	82	82	121	82	86	92	46	89	50	70	39	92	59	60	92	117	88	41	57	72	109	53	75	42	71	64	33	27	66	66	67	69	70	95	52	34	50	95	53	22	44	48	77	52	96	50	72	57	48	99	25	56	78	40	38	34	56	51	52	56	34	45	45	28	51	43	38	99	129	56	61	57	43	41	33	53	53	80	68	41	51	82	75	38	67	35	51	32	42	77	75	82	63	56	78	37	30	25	49	94	39	50	25	36	53	49	62	32	52	58	57	50	56	76	44	49	67	83	83	54	28	59	31	41	67	63	71	36	42	54	68	44	36	41	48	31	46	13	66	45	57	34	26	41	11	25	33	94	43	82	72	46	30	54	36	27	50	48	36	24	72	59	40	51	45	30	31	33	49	35	53	88	40	64	55	33	47	39	54	54	82	64	51	84	54	37	36	23	46	150	20	40	41	45	50	32	47	62	81	43	46	27	40	21	34	26	44	95	27	44	40	40	33	54	36	31	48	45	33	47	16	20	78	81	26	90	43	27	27	44	29	23	56	39	47	33	22	47	32	53	37	72	70	57	44	32	22	16	39	18	20	13	22	63	50	63	28	74	35	35	50	45	53	60	52	79	85	24	33	51	31	31	47	12	9	29	42	57	33	19	31	48	38	37	28	34	14	44	30	50	19	45	21	33	58	32	50	27	24	44	46	48	39	33	31	37	28	22	36	35	15	38	43	21	34	18	40	29	43	25	40	41	76	37	40	43	62	42	84	37	51	39	35	32	61	45	27	40	34	50	27	38	15	27	52	49	12	17	30	20	48	39	21	28	30	45	37	26	25	17	27	32	37	55	52	21	23	45	18	27	34	25	28	28	20	43	61	23	25	23	33	26	46	28	13	10	29	45	24	34	65	16	63	36	21	46	32	41	21	48	20	33	30	21	23	4	28	19	39	30	17	13	51	37	27	28	21	28	65	12	27	12	22	16	34	16	35	29	27	50	15	15	10	32	27	14	40	50	21	19	25	19	32	46	34	19	16	28	19	36	43	36	23	31	43	24	18	10	31	28	51	22	18	16	25	21	29	32	40	26	33	51	24	18	17	20	20	24	21	21	16	16	21	30	44	33	36	28	41	68	32	19	25	48	17	23	30	20	30	3	15	48	25	30	27	52	13	38	21	16	14	17	29	14	6	17	15	7	47	14	33	38	24	7	35	10	32	25	20	30	21	17	28	48	19	43	23	33	27	19	26	17	16	40	21	23	29	37	23	18	25	36	28	38	16	26	25	66	23	9	7	48	22	23	72	26	12	10	42	9	30	29	17	58	12	14	30	34	28	24	26	7	28	9	19	17	16	35	38	19	19	51	4	33	24	8	14	44	12	16	6	13	26	30	12	15	35	35	22	6	18	36	18	6	13	7	19	25	6	44	10	29	41	34	32	20	23	13	31	19	29	8	17	19	17	38	8	22	31	8	5	7	12	21	23	21	8	19	21	23	15	18	27	22	23	46	18	23	12	23	4	26	12	34	23	18	19	10	3	21	20	25	15	14	17	43	18	49	21	10	26	15	5	25	22	18	28	43	23	19	20	9	15	26	20	24	21	21	16	14	17	14	6	18	12	17	17	28	12	34	9	38	17	31	25	28	10	16	17	20	9	19	23	25	25	15	15	12	21	19	24	31	26	3	18	21	23	12	18	19	25	17	12	21	18	12	27	15	19	21	26	10	4	21	10	14	27	9	16	33	6	14	35	26	38	7	26	6	10	67	17	5	18	26	26	16	9	10	23	8	26	17	7	25	2	24	10	19	8	24	12	20	12	17	15	7	31	17	19	22	14	21	15	17	17	27	20	6	18	10	17	12	25	4	20	16	11	24	21	16	24	18	14	22	15	11	14	17	15	26	6	47	2	5	18	23	3	24	30	17	17	19	14	27	9	7	15	23	7	13	27	18	11	18	37	17	7	7	6	8	31	55	6	11	20	21	12	21	19	6	25	30	28	21	6	9	2	7	6	15	15	34	23	35	15	16	6	17	18	31	11	23	20	11	21	6	10	23	28	4	8	33	13	18	10	27	10	25	9	7	6	16	11	5	8	3	5	24	3	3	9	7	17	20	20	11	14	18	17	30	17	19	15	8	10	27	13	4	10	4	7	2	10	22	23	12	2	22	6	17	6	28	10	5	11	4	16	11	47	11	4	13	15	11	17	9	10	12	13	10	15	10	3	8	5	23	7	19	15	8	21	13	14	5	18	12	8	18	11	10	8	3	21	8	6	24	13	21	14	21	5	24	1	17	28	7	8	20	7	6	14	10	22	0	39	18	7	8	12	7	5	6	8	11	8	6	14	11	12	13	6	18	10	18	16	7	5	2	13	10	8	16	10	23	4	13	12	3	11	5	12	5	14	12	17	12	19	2	16	5	4	7	11	9	10	10	8	6	20	5	17	18	8	4	2	16	18	7	6	9	6	3	14	3	7	11	6	6	8	13	1	8	17	15	15	6	1	4	5	12	21	2	18	15	2	9	11	1	4	4	5	6	13	3	26	12	1	6	2	12	4	5	5	13	9	12	18	8	5	13	14	9	11	14	8	4	4	22	17	6	10	14	2	4	7	14	13	4	14	12	4	11	6	3	5	7	13	3	8	7	4	2	7	7	11	5	6	10	15	2	3	2	1	7	12	2	11	19	7	8	4	4	5	7	4	6	3	6	6	6	14	7	4	2	7	1	4	12	19	4	3	4	8	9	6	15	3	22	2	5	4	3	3	3	1	12	2	5	12	4	8	2	12	5	3	4	9	4	6	5	14	7	2	12	4	1	3	1	1	10	2	2	1	7	7	7	6	2	6	1	4	7	6	18	21	6	3	2	9	1	8	5	11	1	4	9	6	6	4	12	0	1	1	11	1	2	7	3	9	5	0	2	6	18	2	3	5	4	10	19	0	2	9	7	8	1	6	1	5	2	6	7	6	3	2	12	2	7	0	9	3	6	1	4	5	1	8	9	2	5	9	5	5	4	16	7	0	22	6	8	7	0	20	2	12	7	0	1	4	4	6	1	9	5	8	2	7	1	7	6	4	6	4	7	4	4	4	3	6	3	0	3	7	6	1	12	11	0	8	10	3	4	6	0	1	3	6	1	1	0	6	6	2	6	10	8	3	1	4	4	1	3	3	10	1	1	10	2	0	2	0	4	4	6	2	4	4	0	1	1	0	8	5	0	2	0	7	1	1	7	2	2	6	2	1	2	0	1	4	1	3	2	0	3	1	0	1	1	0	1	0	1	1	10	2	3	0	1	1	1	3	0	3	1	5	0	0	38	1	2	12	1	1	0	2	0	8	1	9	3	3	0	1	1	1	0	3	5	0	0	3	2	0	1	0	11	1	1	3	0	2	0	0	1	4	0	1	0	0	7	1	0	1	0	8	1	0	0	1	0	0	5	2	0	0	0	0	0	0	2	0	0	0	1	1	0	3	0	2	0	0	2	0	0	1	0	0	1	0	0	0	0	0	0	0	0	0
ne0380	313	461	239	166	297	85	90	48	118	148	169	80	53	52	103	101	49	94	75	48	97	78	94	58	89	66	124	61	109	64	117	87	58	56	61	66	56	74	90	67	89	51	90	33	40	22	40	48	53	56	35	59	81	37	48	70	114	54	48	60	38	45	141	83	52	55	38	43	71	66	117	119	70	66	92	155	60	77	41	109	51	63	19	54	112	29	72	75	97	35	42	45	10	64	54	84	22	62	53	44	21	54	52	27	33	33	59	26	52	23	46	62	17	16	16	45	17	56	84	12	70	12	62	41	63	66	52	88	16	18	42	42	44	64	42	66	34	79	9	39	47	25	55	53	68	38	51	36	33	44	30	54	16	30	48	57	33	76	6	36	35	50	51	21	42	51	39	34	63	21	46	31	34	43	9	41	46	12	40	56	21	39	42	18	62	76	58	22	50	19	54	36	37	33	35	31	32	6	27	14	30	65	57	51	76	30	36	21	45	29	8	41	27	22	41	28	36	102	46	49	86	24	61	27	30	37	33	17	30	29	46	26	44	50	26	25	59	56	63	28	74	36	32	40	76	33	19	26	29	30	22	33	36	54	24	6	22	49	53	49	21	33	37	29	29	28	17	32	72	33	27	23	16	26	22	36	26	27	18	64	72	28	72	35	59	76	40	22	30	29	43	25	60	25	17	43	41	28	17	24	45	56	33	13	23	55	41	32	21	42	68	70	48	15	31	50	23	76	18	17	16	18	20	28	20	18	22	21	14	62	21	20	20	15	12	26	22	25	22	20	18	26	25	24	16	42	30	38	60	37	17	25	39	19	18	12	29	31	35	56	23	50	13	35	59	25	35	31	13	18	41	30	36	14	24	35	18	18	14	17	14	28	23	19	22	33	12	37	9	26	27	37	14	27	17	10	22	23	50	22	10	23	15	27	22	30	41	34	7	34	21	47	21	17	25	14	22	40	17	11	24	61	13	18	17	19	17	18	35	28	6	42	30	13	19	24	17	21	33	19	14	33	27	17	34	20	28	19	30	12	28	19	33	13	41	26	26	17	23	36	14	16	26	20	38	4	27	38	38	24	21	15	19	24	16	29	19	33	49	20	18	30	14	28	13	23	13	13	20	18	17	16	31	19	39	16	15	16	8	22	50	14	20	30	14	20	33	17	28	17	7	10	14	37	20	30	13	66	24	4	21	23	49	19	27	24	25	18	9	17	22	17	29	20	37	16	43	11	21	9	32	35	33	28	40	13	29	32	16	18	20	24	12	7	10	16	23	21	12	14	17	13	14	16	22	14	19	12	24	20	12	16	25	15	15	15	13	11	14	7	25	5	13	28	18	14	24	10	17	1	29	23	9	31	11	19	11	29	8	12	8	23	18	24	20	17	20	16	25	22	17	9	29	20	21	31	38	10	31	25	15	36	12	14	1	12	35	18	14	22	12	15	28	13	28	35	16	2	20	21	19	31	23	18	55	6	5	9	32	9	19	16	10	26	11	12	6	5	18	10	7	13	25	6	18	17	13	17	13	7	15	33	12	6	9	14	19	14	2	23	43	10	11	7	10	49	9	13	17	21	10	18	15	31	18	11	7	24	4	41	16	17	10	23	4	5	7	11	7	6	12	19	5	7	20	13	6	20	12	12	6	23	14	29	13	29	8	18	13	7	14	16	15	18	20	27	28	11	6	41	15	27	34	13	9	7	12	20	16	13	11	17	21	5	22	6	13	15	24	32	5	6	6	13	22	25	8	3	21	13	28	8	12	11	14	12	8	13	5	17	11	7	11	11	8	17	6	5	10	10	21	8	9	26	9	4	9	7	4	15	8	16	18	9	5	9	7	11	10	11	25	6	4	4	13	7	17	14	12	10	14	11	11	8	5	10	5	16	25	10	7	9	10	19	6	10	8	7	30	5	16	19	2	22	8	24	8	13	7	18	8	11	3	12	16	19	9	9	27	9	41	9	1	17	7	12	10	8	11	23	10	10	12	9	9	14	2	11	18	7	9	4	19	9	4	11	8	23	7	5	8	17	8	18	11	11	1	9	7	9	19	8	10	4	7	27	5	6	16	13	21	7	7	7	5	13	24	12	7	4	9	9	4	8	8	14	6	6	4	31	13	6	16	1	2	18	36	2	19	15	38	12	8	6	7	14	12	2	17	4	6	12	26	4	15	20	12	13	9	15	4	8	2	5	14	12	7	10	13	4	27	14	2	4	17	6	2	7	2	5	2	3	15	7	13	6	7	14	9	7	10	4	16	20	16	3	13	8	11	6	12	7	8	8	12	14	8	15	18	4	5	6	12	7	10	7	20	8	11	7	6	12	7	9	8	6	3	9	7	7	17	16	5	3	8	8	12	14	1	3	9	12	16	5	20	19	12	22	6	2	5	7	6	9	6	6	9	10	6	12	0	8	7	8	0	7	5	8	8	5	2	11	12	7	10	11	8	9	11	7	7	8	12	9	3	6	7	6	2	11	14	8	6	13	3	3	18	11	5	8	4	13	6	3	21	20	3	14	9	0	11	7	12	11	1	20	5	9	26	10	14	2	8	1	12	3	6	17	8	5	1	11	8	5	4	9	8	12	6	3	5	16	9	2	6	7	5	17	18	11	11	3	10	7	4	4	13	4	7	2	6	6	12	13	5	6	9	4	10	10	7	4	5	5	18	6	7	1	9	9	4	9	4	2	2	7	7	7	5	4	2	7	7	9	4	6	2	7	10	3	1	4	15	4	3	18	1	18	16	17	11	2	17	0	4	6	5	5	9	4	6	23	7	4	18	19	3	11	6	8	10	7	12	8	12	16	6	6	15	6	13	16	5	4	10	13	32	5	6	3	5	6	3	3	10	37	15	2	0	4	0	11	11	6	4	6	3	9	4	2	12	3	4	8	3	4	3	5	29	7	17	2	6	8	7	15	12	12	4	7	4	3	2	3	5	8	1	3	7	13	6	17	3	4	4	11	4	1	1	5	2	6	3	14	12	6	9	6	11	7	23	2	6	5	19	8	20	9	10	0	9	9	7	9	6	4	7	15	21	8	4	5	1	3	2	8	1	3	9	7	13	2	10	15	5	16	3	9	5	3	1	2	0	2	6	3	6	8	8	10	2	3	2	3	6	3	2	2	4	10	8	5	4	5	6	5	5	3	3	2	2	6	6	2	2	9	7	3	0	6	4	3	3	2	4	5	5	0	7	2	10	5	2	7	5	1	5	1	7	3	3	2	5	2	1	4	11	1	12	8	4	5	5	3	2	7	0	6	1	4	2	3	4	4	0	5	5	5	1	2	7	3	5	2	13	5	7	4	9	5	7	0	2	0	2	5	2	0	5	2	2	4	2	4	3	2	8	6	4	6	3	9	2	9	5	2	3	4	2	4	4	3	10	0	6	0	7	3	8	9	0	6	6	8	5	2	1	1	5	3	1	4	9	2	9	6	10	5	1	0	5	2	3	5	3	3	6	4	2	2	4	0	3	0	6	0	4	6	3	3	2	5	4	2	4	2	0	2	1	1	8	10	4	5	1	2	0	3	3	3	2	0	2	1	2	1	11	5	2	2	3	0	5	3	1	4	2	1	0	2	2	1	7	6	0	8	1	0	6	0	2	4	2	2	2	8	1	1	1	4	4	6	9	4	6	3	0	0	4	6	2	2	2	1	2	4	2	3	6	3	0	1	4	0	0	2	9	3	0	1	0	0	2	6	0	0	4	1	1	0	2	2	4	2	2	1	3	4	2	1	4	2	0	3	0	0	1	4	3	2	1	2	2	0	2	1	3	2	0	2	2	0	7	2	0	0	2	1	2	5	1	18	2	3	2	0	0	2	1	6	0	2	5	0	3	3	6	2	0	5	3	1	3	2	0	2	1	1	1	0	1	1	0	1	1	3	3	1	2	1	1	0	0	0	4	1	0	1	1	4	0	2	2	0	0	6	2	0	0	1	1	0	2	1	2	5	0	0	0	0	0	1	5	0	0	0	0	1	0	0	4	0	2	1	0	2	4	2	0	0	1	0	0	1	1	1	1	0	0	2	0	0	1	4	1	0	1	0	0	2	1	2	1	1	0	0	0	0	0	1	1	1	0	0	0	5	0	1	0	0	0	0	0	0	1	0	0	1	1	0	0	0	0	0	2	0	0	0
ne0381	2050	2384	1450	1031	1175	802	1015	726	832	1112	717	665	684	553	831	811	667	719	878	646	633	690	663	464	815	579	568	655	562	664	578	609	536	444	687	406	566	537	633	685	652	523	467	461	508	387	400	534	557	454	305	499	410	362	379	405	364	389	468	375	400	386	439	501	434	488	299	411	508	425	509	598	442	428	444	462	363	520	479	411	440	461	248	510	450	246	377	500	655	467	301	480	304	430	382	434	251	409	379	380	320	368	268	353	321	361	321	290	250	340	308	469	240	250	221	309	203	395	320	238	290	240	299	368	407	285	308	269	186	258	298	290	254	301	377	387	317	293	205	245	335	258	238	239	469	327	234	360	320	280	307	254	319	295	276	274	241	364	209	217	298	326	285	281	342	324	300	362	222	215	308	284	324	355	180	408	279	194	233	284	198	245	306	273	255	257	268	300	306	287	349	221	288	264	321	177	201	201	277	251	208	187	242	298	229	266	263	258	256	362	158	189	264	222	393	208	229	304	263	235	303	199	316	276	293	237	224	268	270	245	319	266	222	334	281	333	287	280	229	174	215	280	272	132	212	224	214	148	248	266	185	182	284	171	164	148	263	205	314	241	173	172	292	209	198	287	210	194	229	257	156	241	171	217	167	170	187	169	232	256	200	219	196	219	165	221	294	239	358	314	229	201	269	286	180	228	167	206	208	223	231	193	236	222	248	234	210	199	244	205	232	220	274	171	225	202	233	164	134	212	192	160	221	167	148	129	207	215	249	151	153	196	171	138	184	219	201	245	163	175	197	214	255	159	151	273	254	285	198	181	170	207	240	155	191	191	121	283	195	209	164	205	120	144	185	198	274	144	230	211	134	120	201	149	145	209	200	229	197	139	99	140	163	189	196	189	110	278	168	155	168	140	135	155	117	127	161	204	181	160	171	210	107	218	160	163	160	259	177	201	142	156	147	119	199	184	149	123	133	162	147	176	181	186	136	127	191	204	199	142	104	166	137	212	145	147	127	188	208	159	71	165	239	198	259	123	142	218	173	137	154	153	232	121	174	159	179	158	153	165	102	145	156	136	129	139	115	97	208	163	61	122	132	151	94	139	134	158	132	142	146	151	133	107	137	188	102	104	90	135	126	238	182	185	185	98	124	182	159	99	121	107	147	109	92	120	122	188	191	142	114	90	130	160	107	139	98	101	119	112	95	99	185	162	159	129	126	190	125	159	226	116	141	164	184	168	165	164	105	115	197	147	170	111	143	210	192	116	107	128	76	120	128	124	101	99	141	131	104	72	164	107	133	88	143	105	106	104	141	186	87	161	86	135	147	89	83	137	52	92	134	119	89	122	114	65	106	90	183	135	151	82	104	171	103	91	108	128	84	104	129	85	71	77	105	82	97	116	63	85	83	149	160	104	150	100	69	75	97	122	133	89	130	187	62	139	115	117	103	147	117	95	111	148	154	145	121	137	92	87	149	130	95	113	84	76	120	146	181	104	98	111	98	114	67	160	99	66	67	74	103	79	84	72	107	64	93	79	71	97	102	106	81	71	94	95	63	99	96	101	79	113	117	76	108	162	79	72	94	67	116	190	115	101	91	59	86	124	121	109	96	90	145	96	91	49	41	82	85	155	135	84	92	63	88	62	52	103	51	163	84	98	162	135	64	72	68	97	66	78	87	114	70	80	113	100	80	59	115	111	96	65	91	108	65	83	159	91	114	51	64	75	86	89	83	127	62	158	53	57	66	63	81	93	89	80	99	76	142	140	62	86	59	54	131	78	91	83	64	88	52	126	110	39	68	66	129	40	64	78	77	95	80	63	85	85	116	70	124	72	79	59	71	120	33	86	98	90	81	84	67	60	56	90	66	69	60	72	60	69	77	96	38	58	65	138	79	123	119	89	46	78	59	68	125	133	60	84	89	66	71	85	37	61	92	77	41	70	46	71	76	115	102	58	76	86	95	52	118	59	66	83	91	50	45	74	101	117	67	72	96	68	37	45	59	51	70	108	79	86	99	62	61	55	64	48	52	110	60	59	77	77	77	57	52	43	60	64	79	57	96	108	50	69	101	73	62	78	105	53	87	51	52	75	80	44	63	73	82	55	114	70	72	70	53	55	80	72	58	74	83	62	46	123	54	56	48	104	84	79	46	74	97	53	69	61	69	80	53	40	82	61	66	59	100	50	39	56	76	46	34	54	42	47	67	58	64	67	31	47	49	63	44	61	56	45	49	44	45	60	61	88	73	67	54	86	41	74	47	57	52	49	65	35	32	62	99	46	31	56	53	72	43	61	62	42	36	56	49	49	53	19	54	30	73	77	47	43	62	81	84	45	46	58	41	51	48	44	52	22	55	59	38	55	80	51	65	43	74	45	56	52	49	28	27	61	114	33	46	63	36	79	115	61	44	35	65	39	41	74	31	97	37	28	39	89	99	35	74	17	32	49	58	60	43	44	38	45	43	42	42	98	43	33	38	62	63	35	63	41	96	113	39	62	46	48	40	54	38	52	69	29	48	44	49	64	67	66	39	42	47	55	63	32	39	120	69	23	49	37	77	50	39	62	46	53	47	77	50	35	47	38	53	26	38	62	71	39	65	41	104	58	23	37	36	49	74	36	41	41	58	35	45	66	67	46	45	32	54	29	41	30	49	47	99	53	26	15	106	52	63	65	51	66	51	39	56	31	75	61	47	30	72	54	42	19	45	32	77	55	33	47	88	47	55	37	44	40	72	54	34	28	52	34	40	47	66	47	33	87	35	24	53	41	40	35	45	65	36	54	43	35	28	30	52	32	53	47	38	65	31	76	59	40	32	34	58	23	106	39	33	38	39	69	24	40	17	42	36	60	24	15	42	63	46	32	36	28	46	54	40	47	49	23	37	68	38	80	30	26	42	39	41	31	30	21	31	26	21	56	38	51	27	50	22	29	52	23	72	26	39	43	38	18	40	41	30	36	44	35	59	53	27	56	55	18	30	30	19	19	94	31	39	37	37	37	46	41	42	43	44	41	37	73	54	36	26	34	34	30	18	29	44	34	24	20	19	36	38	26	15	43	15	10	18	28	16	36	50	77	25	32	29	38	58	29	23	10	35	23	44	23	28	20	28	38	34	36	31	28	15	14	15	36	22	27	26	22	10	25	33	47	38	51	42	45	30	51	19	24	53	15	27	31	52	14	15	16	48	38	29	40	33	23	25	21	56	46	52	18	29	18	14	10	30	41	42	19	20	30	35	29	21	37	23	23	37	41	45	23	32	34	28	9	33	21	17	16	38	16	23	19	16	23	37	44	42	33	4	17	12	33	17	22	37	16	31	28	24	27	17	24	29	25	15	22	36	17	21	39	37	28	24	25	17	26	28	55	21	16	21	29	18	37	13	21	34	30	35	31	47	7	33	11	30	14	20	12	32	10	33	43	23	13	22	27	17	8	28	14	7	18	14	22	47	32	16	33	26	9	19	19	43	9	26	42	14	25	20	40	26	26	21	13	24	8	13	33	16	17	25	15	18	23	20	28	15	15	25	2	24	28	23	29	26	47	26	16	3	9	19	10	24	33	21	25	22	44	27	17	15	13	21	8	24	20	6	21	18	7	18	20	18	33	38	28	34	22	12	19	9	60	17	8	18	17	24	17	21	36	16	6	14	15	37	34	21	18	14	24	15	13	14	12	5	14	8	15	9	9	15	6	8	6	11	11	11	10	14	9	12	4	18	9	18	15	8	13	7	12	4	7	5	12	15	3	13	13	8	23	15	7	13	15	12	5	20	8	13	12	18	7	7	19	7	3	14	3	4	21	5	3	8	10	14	20	35	8	4	2	22	7	6	13	3	5	9	3	27	25	13	13	4	11	22	14	5	6	4	12	3	8	17	3	5	11	21	11	8	11	8	11	12	15	10	8	6	6	16	3	4	4	2	8	3	11	6	12	9	11	8	18	3	11	10	0	3	13	3	3	1	9	5	4	6	13	1	4	2	6	8	3	5	6	7	2	8	3	0	4	14	8	8	2	0	3	5	8	4	1	4	2	4	8	3	6	5	5	0	1	1	0	4	1	1	3	1	3	5	0	6	4	4	0	2	4	0	3	4	2	1	1	0	3	2	0	0	4	1	3	1	1	3	4	0	0	1	1	0	0	0	3	0	1	0	0	0	0
ne0384	1654	1763	922	1073	1189	662	791	565	801	596	846	533	582	478	565	498	500	572	477	432	568	479	500	490	551	535	636	453	453	689	430	502	414	380	398	456	400	454	408	390	476	338	414	427	357	356	331	318	380	327	308	326	428	298	286	434	379	463	322	446	304	420	426	431	329	326	309	482	382	391	286	428	363	335	347	626	367	331	287	310	258	293	354	258	484	270	234	275	308	270	258	238	319	263	324	266	264	292	332	317	268	273	317	217	277	250	279	236	247	187	258	245	228	232	245	217	250	299	282	227	335	206	279	241	230	447	271	322	238	215	329	259	267	249	245	355	263	216	200	270	228	211	267	249	243	275	261	251	203	192	188	219	241	210	260	337	251	275	175	205	228	289	186	222	198	245	187	327	274	211	283	259	200	246	203	171	244	183	228	212	336	252	251	201	262	234	218	239	193	195	204	205	230	178	227	172	189	178	259	203	145	249	174	187	246	197	236	188	238	210	175	276	229	202	242	277	215	307	216	228	340	202	256	154	290	301	197	247	224	217	218	179	220	248	183	218	270	236	237	182	286	177	184	235	228	180	197	173	214	201	217	200	131	196	154	155	204	219	183	219	162	195	115	151	242	169	137	170	171	176	228	188	182	193	222	184	144	167	164	159	183	122	232	178	193	234	209	212	179	164	191	152	233	122	134	144	189	206	158	181	289	177	160	133	164	175	245	230	156	177	279	156	213	190	151	183	142	246	224	207	179	161	148	215	164	142	155	144	169	286	117	152	158	147	139	146	222	217	161	152	142	163	190	309	147	133	130	203	178	156	153	127	164	127	125	133	136	193	191	176	154	140	124	244	121	158	145	163	150	128	150	208	120	104	171	204	150	161	139	113	126	166	129	122	168	225	147	169	113	161	189	159	133	179	132	151	145	153	133	140	107	142	112	107	122	140	216	115	122	159	102	126	139	123	101	136	104	171	158	88	107	210	113	129	135	108	89	127	150	119	132	168	142	117	131	104	143	151	149	165	145	137	124	125	98	117	164	143	161	105	141	149	93	110	127	151	99	114	107	125	92	111	132	105	126	105	169	158	149	122	134	96	106	55	108	107	120	158	167	101	226	138	100	130	93	152	121	135	104	147	110	92	175	175	171	136	131	120	92	94	148	121	87	76	99	148	81	102	101	111	142	124	127	141	104	150	97	169	129	141	126	175	122	120	117	104	137	76	126	88	77	132	128	104	108	97	149	109	102	126	72	140	143	94	187	84	136	78	88	99	94	89	91	91	97	107	57	85	80	113	127	103	72	116	136	81	119	96	92	97	88	100	159	89	89	87	188	117	100	93	118	98	82	74	88	101	99	131	108	76	110	91	172	142	77	85	96	78	76	81	95	113	107	70	82	127	95	147	140	119	107	93	114	133	103	131	115	80	80	96	132	124	80	132	77	121	98	72	119	73	73	72	97	67	111	145	118	103	100	96	78	60	115	51	90	79	93	112	122	68	102	99	73	102	87	55	59	56	128	69	63	74	103	70	100	52	98	80	138	59	111	151	92	70	69	104	97	102	116	109	97	94	78	129	119	89	106	75	52	100	61	58	95	96	147	84	64	70	72	100	102	75	80	72	61	66	86	137	67	128	93	81	88	62	109	101	65	71	40	68	47	83	90	97	85	75	75	60	73	83	82	79	68	65	62	152	143	86	62	110	64	71	114	53	64	30	90	87	79	67	191	69	47	66	163	65	67	58	82	129	64	66	58	44	85	103	74	80	89	56	95	89	74	64	80	62	97	69	60	65	90	47	60	83	68	79	73	58	53	106	135	45	36	104	53	41	76	73	57	81	92	56	87	82	56	67	66	114	56	31	106	179	54	100	90	48	62	59	86	97	33	55	185	73	54	60	52	77	60	40	83	62	88	93	58	79	56	47	91	41	59	40	45	54	41	79	25	50	74	88	77	41	22	99	94	74	34	58	85	32	110	87	42	47	71	102	52	45	90	59	90	66	46	67	86	73	34	38	70	36	46	48	79	119	36	78	83	88	49	48	51	81	60	79	52	76	35	97	59	52	70	56	50	51	56	43	78	67	65	90	69	61	104	46	65	61	72	36	54	52	68	74	53	37	46	53	63	103	38	63	47	39	35	39	46	49	76	41	48	45	57	45	63	64	43	62	59	47	77	32	69	42	90	51	35	76	67	91	33	59	48	37	59	49	49	69	44	50	95	48	60	40	61	33	78	40	43	53	46	45	67	61	24	29	56	66	51	79	90	61	49	67	34	40	97	44	50	26	54	23	49	56	58	35	30	72	69	67	49	44	38	59	38	68	45	58	87	50	75	56	35	43	24	62	51	48	83	62	61	31	62	51	64	25	51	31	46	79	46	45	50	28	100	51	82	49	63	39	54	43	37	90	43	45	42	82	15	54	68	47	34	88	59	40	27	28	21	98	43	35	55	48	97	54	57	46	51	46	48	26	65	35	78	33	45	40	93	27	43	70	26	54	36	44	42	64	65	91	43	58	42	29	53	54	45	43	50	72	34	27	41	43	45	69	36	40	50	42	86	34	52	47	36	39	64	37	38	26	32	38	29	44	57	6	38	47	59	55	55	39	47	49	51	106	37	38	36	40	45	81	34	56	53	68	38	20	35	28	19	31	44	45	40	45	42	44	67	90	43	28	41	36	31	30	50	51	33	40	70	16	63	38	28	37	35	48	58	38	75	48	18	29	24	31	33	36	33	15	68	27	42	19	32	26	66	39	21	98	29	39	55	50	46	16	56	21	32	43	38	41	28	38	23	41	62	47	39	27	38	39	29	36	36	39	25	51	25	26	76	39	36	22	23	31	20	21	48	30	58	40	49	47	46	17	51	53	29	44	39	30	33	21	65	23	30	78	36	31	31	27	35	29	40	36	49	32	28	35	52	24	30	40	31	76	32	45	21	35	41	28	31	18	23	30	35	22	38	45	67	35	24	34	56	33	43	40	18	37	17	28	59	26	20	45	32	25	42	36	31	23	29	10	38	62	42	25	29	24	30	20	33	13	22	34	27	40	32	34	37	32	8	30	18	20	34	28	49	19	27	31	36	41	33	49	30	37	25	18	76	12	20	16	23	35	25	35	33	23	17	29	20	37	28	34	31	71	24	14	18	27	30	27	33	24	9	20	48	45	55	32	35	12	31	31	24	37	31	13	17	29	16	29	23	30	21	26	41	16	23	31	25	26	14	20	16	42	14	25	18	13	20	45	37	21	21	10	15	37	15	30	19	19	32	17	35	26	16	28	23	20	59	38	17	43	17	20	18	26	18	46	14	34	13	14	22	39	17	31	34	29	22	21	15	26	16	9	35	14	33	22	27	17	24	15	30	15	30	19	30	24	17	20	21	31	19	32	21	25	16	15	24	17	26	19	20	15	24	19	34	37	14	38	11	16	40	8	15	34	28	11	41	13	42	17	29	21	39	12	20	7	21	8	10	19	19	6	31	8	27	17	45	24	9	13	27	7	29	20	28	8	8	19	47	17	99	33	21	13	18	17	32	20	30	14	18	10	18	30	35	9	24	9	16	4	23	25	42	22	13	22	17	7	19	23	12	14	16	20	5	15	6	10	26	19	17	35	16	13	41	17	20	15	13	9	5	18	16	14	12	16	18	33	13	20	9	11	6	15	16	49	11	25	5	17	5	18	28	14	12	12	26	16	8	16	4	27	14	5	13	15	18	10	13	12	7	9	9	18	17	20	15	4	14	14	19	21	24	19	6	10	27	6	3	10	8	9	11	33	15	16	12	8	5	10	14	18	10	14	9	18	11	20	15	10	7	4	14	12	18	14	23	15	4	8	8	8	9	13	6	8	5	6	10	9	6	7	15	2	9	4	29	5	7	5	7	6	7	4	2	14	8	7	7	7	6	13	13	24	13	4	15	6	3	13	6	8	5	7	6	5	15	5	10	8	13	11	6	7	7	8	6	3	2	4	6	19	2	6	2	13	4	3	7	1	2	3	6	16	14	3	2	21	8	10	1	8	7	2	10	0	4	4	9	8	10	4	2	1	0	4	3	4	2	3	10	3	2	2	1	2	3	2	3	2	3	3	0	1	0	9	1	4	2	5	3	5	3	3	2	0	1	2	2	0	1	1	0	1	2	0	1	0	1	0	3	0	0	0
ne0387	4278	5613	3314	5387	2903	2347	2768	2114	2390	3049	2235	1572	1786	1342	1519	1789	1431	1803	1906	1057	1272	1947	1677	2058	1180	1545	1232	1301	2207	1413	1094	1553	886	952	1423	1260	864	1169	1437	951	1371	869	2370	1063	1545	925	1323	916	1202	846	840	845	1024	1952	2814	1118	1476	784	1234	966	977	1220	904	800	582	1282	1013	1135	1209	939	1189	1136	1347	797	1270	920	896	1003	1062	1255	749	1044	1042	1197	657	670	1383	621	1149	855	1227	588	846	869	1256	1343	715	914	1102	1112	673	1191	1220	725	1264	434	828	619	811	2263	1050	1148	641	803	672	818	502	582	1167	689	868	802	615	864	849	772	688	945	465	621	483	803	697	804	799	621	1400	792	778	1078	515	709	1562	882	648	699	612	757	1001	753	797	825	608	575	845	1088	772	798	530	951	873	851	509	482	855	643	519	507	1246	1457	991	760	614	567	439	783	582	522	646	572	836	717	659	545	757	659	773	762	764	779	939	459	931	383	626	1109	1538	489	493	585	545	865	946	924	665	519	1098	426	711	704	458	639	1070	594	576	601	823	660	413	630	392	532	384	538	644	596	459	580	702	663	735	576	855	763	840	435	572	534	444	669	554	504	764	740	571	380	615	687	897	675	499	682	716	821	699	357	509	592	667	835	840	569	636	458	450	520	464	686	615	469	461	342	740	516	477	788	633	716	554	650	650	528	470	503	551	379	597	651	569	624	521	370	500	691	652	730	720	406	416	525	520	600	338	513	592	897	465	415	387	595	400	630	468	667	760	457	468	510	495	471	316	332	366	637	724	665	535	872	468	454	751	510	640	1365	517	576	417	411	453	372	543	461	447	468	321	546	563	387	371	607	463	782	562	766	594	472	466	466	705	453	259	390	1783	495	544	500	582	603	581	514	575	286	486	510	285	461	372	288	345	426	906	382	346	341	528	403	670	329	286	309	481	675	672	420	363	298	451	667	393	369	506	325	392	496	510	346	605	402	389	483	345	451	632	370	486	292	317	402	290	964	326	278	494	413	357	243	483	359	294	451	537	272	764	468	369	502	335	495	323	273	171	341	405	431	549	460	354	265	253	580	292	331	505	318	318	322	502	379	269	445	521	590	540	446	348	487	334	266	304	434	722	301	256	618	503	368	405	414	351	579	286	302	251	344	452	278	488	567	455	375	548	407	244	252	247	232	296	546	342	308	270	338	352	1796	408	370	380	391	310	304	345	381	331	381	203	285	419	448	517	363	237	360	290	219	431	286	599	538	251	666	467	321	345	307	413	211	393	385	243	329	457	404	380	433	294	717	292	223	199	517	525	411	518	321	223	246	539	283	352	257	287	301	392	380	406	578	202	375	374	276	290	205	371	235	217	349	353	317	415	346	291	228	464	552	439	180	350	332	292	267	398	155	202	131	226	429	308	333	357	311	273	240	201	581	194	219	293	291	226	504	233	116	196	146	224	494	630	192	299	297	213	235	233	236	663	343	320	295	189	239	347	583	341	275	226	223	187	275	491	310	329	281	211	383	298	215	181	274	143	185	111	315	176	226	158	240	424	368	274	330	478	370	234	240	243	332	263	371	156	289	113	230	324	321	235	351	197	177	418	205	200	249	271	222	196	305	287	192	125	148	174	419	190	263	209	214	295	114	368	122	187	321	218	355	277	387	217	275	530	210	190	336	246	139	256	212	100	197	298	160	178	266	240	106	212	220	189	230	152	252	226	239	244	121	211	234	151	441	212	396	191	252	159	272	400	263	342	219	236	368	209	131	271	309	241	187	185	241	259	220	244	301	198	261	171	141	448	239	161	254	249	136	241	301	120	193	319	254	259	184	134	180	199	342	200	237	354	91	254	167	272	267	208	260	138	232	261	227	275	100	132	244	388	213	83	389	163	146	182	314	124	175	220	148	204	127	191	207	194	168	156	107	289	178	492	179	202	91	142	318	119	197	155	183	155	131	211	271	157	150	301	187	272	175	203	210	291	343	147	111	193	205	349	144	143	183	257	131	119	173	169	122	256	155	258	174	148	195	191	209	172	166	227	148	207	279	340	162	169	196	277	107	222	155	161	90	153	81	241	263	158	135	169	137	153	182	264	180	181	260	136	249	162	95	135	194	414	197	116	205	110	132	163	126	195	293	162	207	137	163	114	123	233	495	171	91	149	94	151	129	314	307	129	206	242	248	147	254	168	194	211	211	87	211	84	107	340	178	150	98	106	194	116	122	183	145	163	201	162	197	190	128	121	153	162	105	281	128	157	317	100	154	174	146	146	156	143	173	224	260	174	158	90	276	132	154	253	159	100	94	231	237	141	185	171	103	118	173	179	136	259	136	122	171	119	130	76	97	133	366	281	114	126	521	316	159	320	139	64	74	111	124	145	185	185	158	155	106	116	215	144	168	231	100	144	182	116	76	133	122	165	168	160	204	110	85	252	177	129	227	556	64	125	117	138	192	263	210	89	114	93	116	88	100	122	97	129	74	148	257	146	109	124	124	131	125	125	120	150	215	112	159	236	199	151	148	197	236	159	118	52	165	133	149	71	112	293	81	143	117	105	227	141	92	84	104	76	111	158	332	116	169	120	83	208	148	143	86	85	182	61	243	219	129	81	61	90	124	142	106	191	130	108	191	87	72	198	70	80	90	115	74	97	115	141	132	133	119	108	70	123	110	104	66	200	152	143	126	137	107	130	168	154	64	127	129	65	98	148	117	106	171	111	58	71	132	107	145	72	180	140	124	43	115	66	98	91	173	145	79	104	130	61	79	81	120	105	129	88	168	135	86	128	87	129	258	115	55	128	97	100	55	108	302	84	95	139	244	126	109	84	129	131	83	204	89	113	69	117	51	56	56	53	62	78	80	64	85	76	180	120	143	114	93	174	81	108	101	104	99	170	201	92	70	31	97	98	125	122	287	93	102	98	121	80	55	106	87	43	118	98	112	66	59	87	74	99	51	49	70	104	69	118	52	56	157	80	156	72	99	110	63	75	167	50	294	126	54	107	101	67	86	57	83	72	29	87	72	91	96	81	78	130	68	88	99	34	100	54	69	115	116	47	86	112	100	67	29	23	42	96	29	88	50	67	100	211	51	82	87	191	80	106	31	87	82	114	102	115	50	80	52	70	59	78	43	224	49	60	80	55	68	70	76	91	50	58	43	74	59	125	41	41	107	84	39	79	60	81	34	13	56	44	75	105	58	68	47	52	63	20	82	70	32	183	83	61	92	65	63	79	33	23	55	189	61	45	47	58	88	63	50	68	80	37	32	72	75	102	247	37	108	97	84	58	48	63	61	70	57	57	53	145	73	46	60	71	33	83	146	34	23	106	37	40	43	77	34	105	63	145	74	66	43	50	61	38	94	32	65	90	68	81	122	29	102	49	39	76	41	48	42	33	32	49	108	260	29	74	50	66	24	21	23	45	54	40	86	15	51	55	69	26	32	60	72	62	31	35	43	51	32	43	40	26	20	30	75	34	69	108	42	29	66	40	41	81	48	28	74	57	48	55	38	102	21	37	58	36	50	51	49	42	89	25	215	93	43	90	49	52	33	29	57	69	30	47	22	30	75	66	104	131	37	25	22	28	13	23	31	33	154	33	21	23	27	53	30	18	48	56	74	43	97	59	25	43	52	22	26	45	38	39	8	57	27	25	24	37	5	58	48	25	82	82	31	63	56	39	28	40	33	26	73	44	23	166	28	10	43	48	36	22	10	101	19	20	27	73	21	38	9	25	15	24	63	24	27	18	111	41	394	47	40	53	49	80	19	33	120	54	21	21	41	19	26	35	14	10	33	21	51	42	38	45	28	30	11	26	15	25	18	24	16	11	10	11	66	21	27	249	44	24	7	16	38	28	36	16	25	12	28	51	14	21	26	118	17	10	16	18	6	14	18	16	11	178	115	199	62	38	23	9	5	23	16	12	33	14	14	12	22	22	27	50	1	34	7	23	18	43	8	25	12	2	23	23	17	45	8	24	20	26	17	13	2	21	24	28	27	6	5	17	1	4	14	11	14	37	5	20	74	17	14	12	31	7	6	6	18	15	14	18	9	5	25	11	12	5	34	18	3	26	10	5	7	16	76	11	6	33	14	7	8	2	3	8	7	45	0	2	8	10	9	70	3	3	0	5	8	14	0	0	3	1	4	3	8	7	0	3	0	1	4	3	1	6	0	21	0	68	1	2	0	0	6	0	0
ne0388	2491	1810	1263	1111	1426	856	862	706	1030	959	863	772	710	658	696	604	583	858	390	538	577	528	594	680	675	786	642	537	503	450	771	695	483	557	402	379	523	608	537	432	494	388	451	603	438	523	491	355	242	370	437	391	441	442	344	338	514	469	408	492	395	443	416	465	415	466	455	666	429	615	589	381	410	419	336	347	453	471	418	370	381	512	401	322	383	464	345	336	283	316	303	291	325	411	484	308	448	358	352	395	320	270	315	358	311	339	274	406	263	288	345	302	386	383	364	224	371	273	572	349	351	347	367	311	287	381	320	485	342	392	351	321	418	434	247	405	280	351	339	289	334	264	328	249	331	314	317	494	353	233	274	340	272	212	302	305	183	248	306	289	355	265	245	289	209	545	260	252	309	233	316	322	224	315	325	252	251	303	293	305	403	211	376	259	317	312	363	200	295	319	211	252	252	275	318	176	201	272	225	329	163	305	378	260	371	331	321	194	252	279	297	243	286	272	172	197	335	458	236	251	147	278	407	224	164	242	234	233	274	326	210	243	207	328	301	201	187	281	189	318	216	195	156	172	352	215	257	242	260	155	254	268	235	204	226	266	244	159	255	207	240	187	269	215	415	241	144	255	230	272	218	264	237	241	185	225	230	249	168	237	423	167	303	318	219	403	173	221	179	162	210	242	416	250	114	239	255	249	153	209	200	222	396	190	225	224	246	145	189	252	202	320	232	230	195	228	211	241	221	163	242	116	185	223	140	134	143	287	189	246	133	186	128	199	198	189	174	218	148	201	180	207	130	222	170	380	193	161	192	230	158	363	332	130	201	207	166	202	158	208	209	174	119	194	160	176	161	118	136	179	181	155	158	204	217	251	169	161	136	135	208	148	148	191	102	215	210	150	128	231	225	131	121	248	162	159	216	253	237	195	121	102	172	129	101	370	194	105	178	143	204	173	137	192	164	194	132	140	133	78	268	328	135	103	217	199	136	141	223	187	95	195	192	121	154	113	176	186	301	178	145	164	153	170	159	126	196	170	136	146	159	194	132	107	149	178	111	168	147	170	126	103	143	128	238	121	160	163	216	97	155	127	189	188	77	162	136	126	179	186	166	182	133	234	88	526	148	105	97	88	164	141	367	417	239	150	222	137	146	183	211	112	131	81	79	153	139	177	112	165	184	132	136	149	114	111	109	112	128	165	117	156	90	86	135	136	98	96	118	103	107	72	165	141	92	120	143	85	132	166	133	173	85	127	331	267	90	175	87	104	87	110	106	112	68	85	93	135	98	118	98	90	102	139	97	92	167	80	125	169	171	132	183	173	111	93	123	137	80	110	112	100	126	84	76	145	128	120	116	72	93	84	98	299	113	80	95	134	128	115	84	131	111	85	121	119	124	124	104	129	154	118	95	390	76	172	140	111	116	73	155	144	128	66	56	119	118	84	105	121	114	69	110	82	116	71	143	84	157	111	118	59	75	73	149	132	123	64	126	115	115	139	100	93	113	76	82	65	79	67	57	91	136	149	116	75	122	76	101	108	116	73	118	76	100	99	160	156	134	103	101	121	52	120	79	70	81	231	121	95	107	99	84	120	327	80	30	63	56	290	113	64	84	83	83	77	67	68	60	77	79	68	74	77	87	114	56	79	58	67	68	144	58	74	76	118	128	64	86	81	47	85	36	60	94	90	122	99	85	70	68	77	94	62	52	79	169	86	83	97	113	87	106	54	89	99	77	82	128	120	84	58	63	37	141	294	68	40	109	94	76	66	115	73	104	111	85	92	89	117	67	38	53	73	94	130	71	54	82	88	88	69	98	87	130	59	71	57	62	125	94	60	84	75	58	87	59	65	79	84	67	118	48	80	65	54	92	78	57	65	59	89	142	99	33	80	54	238	53	78	125	95	96	65	62	64	97	89	107	45	52	88	58	98	68	128	85	69	76	240	74	122	58	81	90	114	31	79	65	77	97	124	26	41	56	65	70	61	40	55	74	68	62	65	90	63	55	104	60	99	57	45	57	67	77	42	101	42	121	59	62	103	80	65	37	60	47	40	86	58	55	42	62	51	54	57	39	95	119	55	66	100	81	60	38	79	96	55	66	93	27	86	104	61	48	82	49	37	62	263	44	57	40	31	50	37	69	43	93	59	56	82	154	59	19	72	39	31	82	45	29	64	118	78	56	76	70	49	41	73	39	64	46	34	109	89	51	72	72	79	90	72	46	53	54	82	65	70	60	15	66	102	41	47	83	60	79	50	72	44	42	71	82	54	57	34	27	48	90	41	73	78	247	58	74	82	110	71	50	51	34	40	64	59	70	35	71	67	97	65	41	51	39	81	70	36	86	46	17	64	42	43	60	28	35	43	49	33	26	46	61	95	34	19	232	56	49	61	55	32	32	49	26	65	65	106	42	71	64	78	37	53	73	88	44	36	22	81	47	95	29	58	35	112	17	71	60	50	87	45	40	45	46	54	88	54	43	52	43	42	36	33	96	88	56	80	96	96	64	64	50	48	44	31	55	70	34	71	37	33	80	55	49	43	38	58	46	82	46	28	238	41	15	49	33	44	64	72	37	19	49	33	68	21	76	21	47	46	67	87	41	26	82	49	52	67	24	76	59	34	69	62	80	74	37	28	38	26	59	31	55	41	124	50	49	64	25	104	84	38	29	70	36	53	43	54	59	30	33	21	53	56	15	96	36	281	80	36	26	26	39	34	26	51	17	44	25	46	87	25	23	19	76	31	36	26	15	79	70	43	78	77	17	12	16	30	32	82	52	32	26	63	30	54	59	35	55	37	50	33	29	35	33	55	70	90	74	31	42	30	36	28	30	59	30	34	63	53	49	88	35	23	33	22	216	47	25	33	37	34	31	34	26	29	84	24	38	34	29	30	41	59	58	62	42	31	35	45	50	48	41	60	31	27	52	60	37	101	36	53	27	25	23	29	22	29	27	36	20	46	38	29	62	30	39	214	25	32	24	34	30	50	59	64	25	48	35	71	44	34	45	41	39	70	27	36	32	24	37	42	50	57	29	22	26	26	28	48	35	25	22	12	21	30	13	28	56	27	21	56	34	12	25	25	23	38	86	50	54	16	16	38	40	98	19	24	35	35	48	19	7	31	36	39	30	65	26	30	42	30	14	26	16	32	36	44	26	25	25	40	24	43	34	24	31	24	81	11	30	26	27	29	38	33	11	48	16	9	25	12	39	24	26	32	25	32	31	25	19	19	35	25	39	42	6	18	27	8	28	36	28	18	28	24	34	34	33	24	7	12	50	35	19	51	5	33	30	60	27	32	42	22	31	48	46	74	28	34	17	33	17	19	17	17	30	25	17	16	35	42	16	20	28	26	12	16	14	12	21	38	21	23	10	21	43	18	83	21	15	25	15	35	18	7	11	37	22	34	50	23	31	27	14	29	22	21	6	13	15	33	11	22	22	18	26	41	10	7	4	17	37	30	44	34	23	5	42	24	13	22	33	10	44	26	29	6	22	26	24	26	27	17	40	16	7	33	18	27	2	15	4	20	16	9	30	2	28	19	39	15	45	6	15	16	46	16	9	7	12	33	13	16	26	31	14	15	17	9	19	17	20	41	26	15	27	8	9	10	13	18	8	18	47	19	8	6	20	16	5	8	16	8	17	16	14	1	10	9	25	18	11	12	31	17	16	27	15	2	6	24	8	10	10	8	8	5	10	12	13	9	10	2	40	17	13	19	23	23	6	13	9	7	23	7	18	10	16	32	4	5	7	14	7	23	0	7	11	13	4	27	6	11	18	10	22	8	15	0	10	18	12	17	15	10	17	8	46	6	19	24	48	11	16	14	8	16	40	15	69	10	5	5	4	33	2	5	8	5	0	9	15	5	5	38	5	7	3	5	4	12	2	11	9	7	4	15	9	8	7	9	3	4	18	6	1	2	12	3	6	9	13	2	20	5	15	4	3	3	3	4	3	4	5	16	6	16	18	1	2	9	3	1	1	3	5	6	6	3	0	4	2	9	6	8	2	3	0	1	10	1	6	9	2	2	5	42	4	10	4	6	1	2	6	0	2	1	6	1	2	9	7	3	3	3	0	5	0	5	3	0	2	0	2	4	6	4	0	3	1	0	0	2	0	0	1	0	7	0	0	3	0	0	0	0	0	3	0	0
ne0390	3702	2999	1767	2269	1168	1726	1900	1393	1427	1579	1061	1249	1387	1159	1091	1326	1373	931	1214	1175	1253	1072	910	1055	910	1138	912	949	916	1051	834	880	782	1052	828	730	1043	633	776	1027	961	768	672	704	897	793	897	881	850	739	802	699	492	870	575	940	638	511	672	608	775	719	622	726	638	671	865	563	711	602	503	544	632	978	642	656	869	573	520	535	807	538	736	494	579	698	448	522	506	497	677	572	734	624	484	592	670	520	533	610	525	533	595	714	576	526	431	723	848	471	448	438	749	709	611	560	653	687	428	637	634	655	322	513	410	562	523	599	615	591	576	505	523	409	622	498	363	373	611	424	492	674	429	442	430	502	489	398	469	350	530	376	455	374	560	459	506	427	570	650	467	359	472	413	456	346	369	408	379	504	445	427	532	402	572	330	395	572	395	357	878	485	427	454	357	340	390	416	382	331	319	388	496	480	395	314	367	585	454	425	329	307	523	442	260	550	382	355	634	366	547	442	320	403	608	451	324	367	353	367	302	370	288	320	335	354	347	284	370	344	324	354	259	393	395	323	355	333	318	379	445	312	294	548	497	238	452	358	365	364	317	390	346	421	411	497	233	404	391	209	296	362	298	329	373	413	352	387	250	320	335	410	405	337	311	282	227	360	287	306	254	275	300	204	418	262	298	322	347	319	299	371	271	327	582	214	367	346	273	341	278	203	316	357	347	283	373	257	341	260	390	196	270	404	268	426	278	411	368	323	369	254	281	458	333	357	403	278	312	438	296	464	263	432	263	249	275	409	363	237	284	288	341	459	426	280	259	225	208	247	258	204	231	342	245	315	396	289	247	199	269	216	237	203	343	280	301	342	353	242	158	331	183	198	299	205	242	183	222	236	429	247	332	404	367	307	196	247	275	276	355	517	261	314	395	247	231	254	202	272	176	374	370	248	308	337	265	281	300	274	164	210	226	380	115	241	225	225	218	261	286	191	323	251	349	392	198	238	282	211	238	197	218	220	196	193	162	186	273	269	225	576	271	209	300	218	289	201	194	255	265	367	252	235	188	176	159	187	234	325	207	157	209	247	168	191	209	272	196	275	428	261	178	272	254	167	226	277	181	186	258	191	219	205	195	210	256	223	239	287	243	153	201	194	184	202	195	221	176	268	162	235	235	192	232	227	156	234	222	213	219	213	208	218	188	147	199	296	230	194	195	134	176	240	225	237	159	246	186	227	266	311	275	179	245	145	171	247	119	158	167	240	191	161	190	307	244	104	168	232	172	187	228	139	169	162	236	142	161	194	202	208	205	195	164	178	177	171	127	181	199	158	173	125	156	239	203	207	188	184	187	162	150	171	195	158	202	210	146	173	160	155	164	181	180	210	172	124	246	123	189	195	169	168	158	215	201	95	131	239	174	107	162	128	150	158	207	200	225	156	156	175	146	137	215	206	161	182	191	119	139	203	163	130	164	149	162	159	201	171	180	219	108	185	123	118	121	219	213	120	107	153	114	141	191	127	105	172	191	94	227	232	153	152	159	172	168	174	137	123	219	112	172	161	137	174	142	131	197	130	117	108	107	131	171	166	258	140	332	149	103	216	210	145	130	114	234	143	139	91	201	185	122	157	126	143	129	182	162	184	136	170	96	126	113	129	148	116	93	146	133	119	159	119	108	134	108	121	152	89	170	89	157	189	132	239	157	189	122	127	93	99	148	145	144	101	86	129	176	88	197	140	106	124	144	103	162	165	154	140	93	144	107	94	105	108	150	173	89	114	123	153	189	146	155	108	156	155	161	123	147	127	86	119	92	136	91	134	93	216	133	101	90	84	156	139	135	175	103	126	143	71	117	107	93	134	112	85	93	135	89	192	104	52	101	57	96	147	86	98	64	169	211	110	148	84	92	118	92	101	151	87	115	207	100	87	105	142	67	145	103	81	139	72	78	56	294	97	119	84	92	127	102	139	180	99	112	90	90	122	71	132	137	65	148	70	110	61	74	91	130	94	146	136	139	103	100	88	75	102	102	88	122	79	70	85	173	96	102	89	83	103	55	116	155	83	157	122	99	125	96	85	92	101	90	108	165	127	72	91	85	113	138	121	94	94	84	94	125	49	124	120	95	125	71	97	95	201	72	79	68	88	77	62	74	130	86	131	79	107	59	133	88	123	112	121	113	109	100	92	88	90	46	75	66	128	101	129	80	52	103	104	103	104	146	79	94	96	45	95	105	68	83	105	88	62	98	102	77	159	130	71	75	66	93	90	79	82	101	114	82	99	95	81	45	73	70	66	108	73	127	115	76	77	61	107	98	102	83	89	101	82	82	63	147	85	59	64	92	107	77	96	47	188	99	83	105	58	71	92	60	76	113	79	83	93	78	60	108	90	105	58	104	84	67	79	115	90	86	78	57	88	73	118	103	92	78	70	78	71	51	121	80	50	62	109	100	90	63	74	77	62	67	108	58	101	68	34	63	46	116	104	63	129	39	63	104	100	100	123	91	80	59	85	93	56	44	99	76	102	76	118	121	81	63	85	75	76	56	71	64	80	64	146	38	65	45	59	72	57	60	56	42	117	73	71	103	52	82	83	65	50	97	82	60	105	61	76	48	59	44	35	213	78	54	98	53	47	40	65	73	67	38	56	46	93	56	67	58	82	97	107	53	71	44	65	71	40	75	55	56	55	48	84	79	52	73	62	65	51	73	53	23	75	46	67	79	62	85	45	68	60	45	73	52	77	62	71	113	111	50	49	123	102	46	50	53	177	36	87	50	61	40	45	45	40	68	78	43	36	62	49	94	51	79	33	75	56	48	78	60	56	56	77	66	85	52	52	84	49	60	29	66	35	31	42	64	39	59	51	45	44	48	78	64	80	44	36	46	61	51	46	41	45	93	83	59	47	70	50	58	72	52	23	86	95	28	39	43	54	27	29	45	102	49	63	42	43	43	45	70	44	64	75	48	28	57	34	55	47	60	59	83	50	30	59	78	40	77	59	56	98	48	28	41	56	29	39	65	59	36	34	60	43	44	42	36	67	69	39	51	66	59	43	32	30	38	38	34	52	96	48	61	38	55	43	82	55	44	41	29	60	32	58	32	49	57	67	65	48	63	46	48	52	58	38	46	45	39	53	130	42	42	33	55	74	45	35	37	66	33	46	26	64	43	36	47	36	52	56	71	37	67	68	36	39	56	43	35	30	62	38	55	17	35	54	24	45	72	65	61	57	70	39	27	58	68	39	43	44	73	25	46	27	31	34	18	86	24	33	38	65	48	26	29	29	58	33	62	92	84	51	40	26	62	41	33	48	66	36	317	37	34	33	24	49	43	41	52	44	29	26	27	41	30	18	32	66	26	36	22	27	73	32	15	88	23	65	81	26	28	29	53	36	25	19	51	44	39	35	52	29	28	132	47	34	31	40	74	39	22	56	64	25	20	21	32	19	46	30	81	48	44	24	31	29	30	28	40	50	20	30	31	26	41	49	46	31	5	37	41	50	15	17	28	45	104	28	34	105	68	116	32	16	25	36	62	11	48	33	44	46	26	19	17	28	30	28	36	31	54	29	21	16	35	25	30	21	33	19	41	55	33	33	37	25	11	16	26	22	27	18	28	34	25	7	32	39	11	31	9	17	46	27	7	25	28	43	8	16	31	50	15	29	27	63	14	28	14	26	20	36	52	9	30	13	18	16	19	13	30	31	10	23	23	17	11	33	19	9	55	30	14	17	24	16	40	40	16	15	10	20	9	40	23	19	16	20	18	50	76	27	19	19	3	17	16	32	40	23	18	11	11	28	11	17	10	118	40	30	15	15	19	33	47	15	9	14	14	22	18	24	25	11	20	11	18	16	10	18	21	24	16	26	10	9	6	25	36	10	15	7	13	29	12	13	7	27	8	7	14	37	16	14	50	5	113	12	11	10	16	7	9	9	13	8	9	13	12	7	14	7	16	9	14	6	31	22	57	13	10	6	14	26	20	13	14	11	16	12	10	9	27	6	10	18	20	16	12	4	10	11	12	10	32	38	7	18	34	7	54	9	8	15	2	3	13	15	6	10	3	6	20	14	8	3	8	2	13	0	3	5	6	13	10	9	3	9	3	12	7	6	2	3	2	6	27	4	4	3	1	0	5	6	3	0	9	6	3	10	13	1	1	4	3	2	0	0
ne0391	2467	2004	1239	1162	839	1235	986	1063	895	918	786	847	924	775	911	774	842	626	699	824	749	713	583	606	659	647	719	680	611	801	453	538	497	590	642	512	469	538	525	639	482	476	401	433	490	575	528	511	626	409	582	427	364	490	433	561	441	461	388	346	494	318	400	473	367	411	544	379	465	418	470	392	420	503	402	587	464	397	373	355	412	365	452	349	443	434	410	364	357	345	349	452	445	473	308	388	389	352	346	302	369	369	356	396	339	314	328	445	388	333	279	328	406	478	387	405	410	363	312	389	329	372	325	288	307	398	286	616	395	376	294	356	338	303	393	323	260	283	362	251	352	359	283	246	273	313	288	302	264	427	279	259	334	246	249	322	354	321	369	435	318	270	276	346	362	250	251	389	325	267	349	237	253	360	330	315	291	344	283	238	361	294	206	340	231	302	252	271	238	256	221	262	173	218	217	713	246	345	334	230	219	186	197	294	219	281	246	181	372	226	331	317	203	270	278	354	246	292	315	265	361	188	208	248	287	233	309	273	207	195	220	193	211	157	306	240	219	264	366	215	212	255	204	322	298	245	264	193	199	230	197	184	259	260	222	299	133	242	269	203	221	216	208	194	184	220	165	332	205	207	178	214	219	190	252	179	216	281	222	216	181	222	151	226	319	252	268	213	134	204	218	206	204	190	225	175	298	299	200	207	189	284	184	190	160	163	252	294	198	211	259	206	229	204	175	207	151	206	158	204	249	269	160	283	188	257	228	169	183	198	188	223	207	187	209	147	241	344	185	142	153	158	217	235	214	188	144	245	178	143	184	216	201	157	179	230	128	198	189	161	104	185	220	153	198	133	196	120	158	124	162	160	162	216	182	162	200	229	178	166	203	171	204	203	256	224	158	173	153	169	249	214	175	172	123	128	159	127	126	131	176	308	191	132	196	126	137	167	188	188	163	151	176	179	106	152	149	199	191	163	199	160	232	168	242	307	147	160	151	146	185	147	171	165	135	154	111	107	181	142	156	198	188	107	199	124	132	162	219	109	161	91	129	138	135	125	174	188	138	212	140	122	122	167	124	126	148	206	132	138	143	121	175	126	157	129	126	116	135	109	175	148	94	183	130	135	136	91	183	166	192	101	161	100	133	134	101	142	100	145	94	140	152	158	164	112	155	133	151	158	92	174	140	93	107	151	125	111	119	99	109	102	140	111	127	104	139	149	145	160	157	203	167	123	118	117	73	153	132	94	107	125	124	139	118	69	110	192	175	122	94	146	120	113	166	137	140	124	100	107	118	162	147	111	138	124	114	105	154	128	82	152	123	126	89	213	107	94	103	95	114	88	92	110	121	114	129	140	158	107	111	175	123	120	128	112	131	115	135	112	139	135	106	177	102	126	80	104	122	95	152	122	116	101	112	79	66	105	83	143	118	163	113	155	106	102	95	90	99	78	101	89	90	126	108	134	92	122	84	111	79	101	82	117	106	96	96	90	118	103	134	83	102	107	83	89	118	163	102	78	116	94	93	96	84	101	111	89	79	91	108	98	106	143	111	97	97	103	121	128	117	88	78	55	190	76	121	125	107	87	109	115	106	93	73	95	140	131	100	93	90	158	58	83	80	85	88	83	104	130	103	100	87	54	93	86	107	112	166	99	103	83	90	99	89	72	106	78	76	101	148	94	109	145	65	130	101	78	56	105	84	94	55	67	92	87	35	68	104	56	129	80	103	78	85	60	132	90	80	71	63	127	72	101	83	80	62	108	54	116	71	101	107	104	95	68	107	67	59	92	105	63	83	67	85	86	71	100	106	91	99	92	120	106	137	97	95	74	76	80	86	122	67	79	97	74	60	73	76	68	84	125	82	33	65	66	83	69	56	101	64	160	119	58	76	70	87	72	97	59	64	73	65	116	72	74	81	66	75	60	65	48	121	59	81	136	76	80	68	74	73	62	64	90	74	77	69	83	81	139	117	99	75	74	69	76	83	43	50	82	77	78	76	87	69	63	67	54	46	70	72	97	109	105	53	126	85	89	69	76	69	84	68	61	80	43	99	66	57	81	71	47	67	78	79	111	72	78	65	60	62	84	62	88	44	82	41	65	93	65	79	78	33	65	56	61	50	128	65	39	35	44	67	56	53	65	69	79	60	66	56	71	46	61	106	58	76	66	77	76	50	48	59	66	40	77	49	79	58	88	81	63	42	79	47	77	49	72	60	118	83	75	48	44	57	50	57	50	66	48	100	29	49	53	47	78	52	62	42	63	34	45	72	70	33	48	53	56	71	66	61	43	59	84	49	82	44	40	60	49	63	44	61	74	94	57	35	48	43	92	63	40	43	40	53	49	44	46	60	46	44	48	65	66	48	54	36	60	70	58	59	47	37	39	43	54	61	86	51	52	50	64	60	74	45	63	77	48	32	47	46	52	49	100	91	47	41	40	42	37	39	54	53	56	40	67	68	52	45	37	66	33	60	39	60	48	35	43	46	55	78	48	39	65	42	51	35	58	37	52	58	55	77	59	64	69	54	82	60	35	45	56	80	72	52	47	38	91	31	37	49	36	32	51	69	62	44	52	57	40	58	34	32	44	21	82	35	34	37	53	42	29	40	38	64	40	42	39	51	51	44	21	37	42	48	46	50	54	35	38	43	37	40	51	28	34	59	127	37	44	54	50	36	48	74	28	50	47	43	47	50	56	40	68	45	27	47	44	38	27	44	30	34	77	67	47	25	52	51	38	74	53	63	47	35	55	30	64	42	81	28	24	57	38	37	39	31	42	98	41	32	35	46	41	34	53	87	43	42	58	34	32	58	27	31	40	98	31	71	36	84	30	45	43	32	23	27	36	39	37	34	32	50	25	38	57	30	26	39	24	47	26	19	33	91	68	39	32	30	32	49	34	24	11	88	55	38	50	37	54	44	24	25	39	36	46	39	28	19	28	70	41	38	40	19	21	31	34	42	36	43	39	18	17	21	34	29	33	39	17	82	96	28	48	26	37	46	25	30	49	23	49	36	20	20	30	49	42	43	38	33	38	25	33	35	38	44	26	39	28	41	29	47	27	29	32	25	34	31	21	28	28	72	68	24	26	17	19	30	31	42	32	25	28	33	27	20	39	38	43	25	30	28	19	28	27	34	28	29	28	40	31	37	22	22	40	25	36	24	16	37	13	44	47	22	19	22	39	34	39	36	41	22	15	18	29	29	26	27	25	23	39	31	37	15	36	29	33	30	31	55	30	37	19	25	25	23	32	22	24	37	28	21	24	20	45	33	21	34	19	21	48	21	35	27	17	18	27	23	21	4	27	10	22	24	22	17	36	28	33	15	36	11	21	33	28	17	21	25	27	20	29	34	18	19	14	17	42	16	15	32	20	35	29	28	12	18	19	16	22	39	17	25	10	38	14	19	13	16	33	30	27	23	18	12	9	21	12	35	20	19	18	15	13	22	30	22	27	37	25	22	19	34	31	12	20	14	15	17	10	18	19	14	11	27	21	21	14	25	24	24	17	16	13	18	17	15	25	19	22	46	12	18	22	12	11	20	27	22	21	18	12	12	14	18	18	12	19	14	18	14	25	15	19	16	23	15	23	15	11	24	11	17	28	24	9	24	22	20	26	7	9	17	35	17	11	21	12	20	10	21	7	17	16	15	55	20	14	12	11	9	11	23	5	14	14	4	17	6	10	6	17	15	7	19	10	6	32	13	12	13	28	9	22	14	18	13	20	16	9	5	10	14	11	12	9	15	11	13	25	9	5	7	10	20	7	11	9	35	17	16	18	16	15	7	5	8	14	10	13	11	6	14	16	11	5	17	11	9	9	5	0	8	13	21	11	6	9	6	10	4	13	5	3	8	11	12	9	9	6	8	10	11	13	13	4	9	7	14	11	5	12	9	12	6	5	32	9	13	8	5	12	5	3	9	11	5	11	4	5	11	3	7	14	10	2	28	11	6	9	3	4	3	6	6	2	4	2	6	5	6	3	3	9	2	5	4	6	3	12	5	3	5	7	9	16	15	2	3	4	4	13	5	4	3	4	1	4	9	10	1	5	8	5	13	5	5	2	0	4	0	0	2	9	1	5	4	2	7	11	1	3	3	2	7	0	0	0	1	1	2	3	0	0	1	1	3	2	0	17	1	2	1	3	2	0	4	0
ne0392	2707	2139	1287	1477	839	1291	1160	1074	1050	1055	806	937	1037	860	1157	763	909	618	668	794	970	776	587	654	653	764	722	677	636	957	490	523	544	671	616	528	614	591	546	908	447	496	370	576	481	712	587	626	637	434	584	432	427	664	424	616	518	451	449	430	517	420	460	528	394	539	550	512	429	371	494	373	395	579	407	531	485	460	397	346	450	386	466	339	429	450	392	377	366	423	392	437	467	543	310	395	438	369	356	335	463	371	355	406	378	341	419	457	391	300	375	381	438	513	417	363	448	421	303	421	386	410	337	326	343	387	264	688	418	409	305	371	339	292	411	345	252	244	407	282	380	398	330	267	289	429	328	333	307	434	324	230	433	314	312	312	336	301	400	375	289	301	272	467	326	271	302	529	288	261	361	238	294	561	359	322	321	357	237	196	437	308	232	374	269	311	256	317	290	352	287	310	234	242	297	659	273	366	413	337	200	196	195	276	251	325	235	208	330	292	342	352	209	285	278	383	235	293	285	262	319	241	195	293	412	273	297	260	245	197	228	262	200	212	333	242	228	297	299	199	336	241	200	422	330	277	354	202	189	201	195	175	231	275	191	314	137	273	250	200	199	276	261	266	177	268	204	347	210	209	191	236	226	198	246	191	193	266	241	224	190	225	210	210	314	225	325	200	160	204	218	247	194	242	298	177	280	297	220	205	235	250	182	171	208	167	278	326	253	222	220	206	197	183	195	258	222	257	267	260	228	237	212	313	221	283	231	224	222	240	216	267	248	178	239	183	209	476	203	164	134	207	211	294	280	180	175	326	192	168	171	193	191	156	191	312	154	174	215	170	147	174	176	199	207	179	212	132	211	172	156	136	161	233	180	184	242	315	236	171	308	173	196	233	254	227	191	153	211	171	293	288	155	233	153	156	160	115	131	158	183	473	220	151	227	142	168	220	266	202	185	124	170	206	124	202	134	219	204	183	170	115	266	200	197	412	191	193	149	163	152	159	140	186	141	124	130	92	194	145	177	215	178	126	200	122	191	193	195	158	202	130	139	147	162	139	155	159	130	182	152	112	136	138	124	135	152	145	156	127	246	145	184	151	205	117	162	135	115	118	171	181	112	161	112	136	142	147	142	148	241	132	140	134	150	137	139	139	125	138	96	178	174	110	133	145	144	112	151	155	120	127	138	116	116	175	115	158	76	146	115	142	134	101	111	112	158	161	159	151	157	238	182	141	138	108	115	159	135	119	114	140	129	134	144	60	130	175	175	111	97	178	140	111	171	152	148	132	80	86	145	159	129	109	147	145	108	120	106	133	100	183	111	132	96	173	182	135	121	139	145	113	86	91	134	163	112	137	236	122	94	159	107	131	143	138	152	92	158	106	132	124	118	157	99	120	66	103	85	132	205	116	124	117	156	99	79	108	116	131	114	162	113	245	122	87	142	103	134	76	135	96	114	103	131	124	100	100	103	123	98	123	135	130	113	79	75	97	129	128	125	85	119	136	110	86	92	115	129	85	136	92	103	85	92	123	126	112	110	84	109	113	155	98	102	82	89	96	167	117	109	92	75	89	229	123	165	164	200	78	118	118	145	75	98	94	114	116	113	106	136	145	86	114	127	89	110	106	104	211	99	115	99	60	114	100	110	83	108	97	142	60	117	89	101	74	112	118	84	103	136	92	110	115	78	128	103	64	113	73	128	89	81	104	86	106	39	112	93	64	120	81	93	91	79	75	127	110	99	75	87	116	102	85	87	81	81	120	36	81	82	95	123	104	68	90	113	71	77	65	124	89	61	73	87	77	65	103	78	108	86	100	130	119	188	90	128	75	85	82	99	110	79	64	81	83	88	107	60	87	77	122	88	21	35	78	69	54	91	86	64	102	108	66	87	53	77	88	73	66	111	64	83	130	62	72	72	57	73	61	75	79	82	40	48	120	55	80	97	52	92	51	75	105	92	91	85	63	70	177	102	85	89	77	70	113	79	67	89	58	86	63	134	93	84	76	90	53	34	72	81	113	79	118	69	108	68	80	75	76	81	64	67	66	97	48	101	97	68	65	75	39	67	58	81	86	78	71	41	93	57	83	72	91	50	82	44	79	78	53	92	85	44	57	47	60	93	92	76	47	51	65	68	54	50	66	92	62	49	95	51	92	42	61	55	55	73	70	71	71	55	74	59	77	53	89	46	78	53	74	90	58	70	92	55	66	70	54	67	158	56	70	61	54	61	43	47	53	66	61	65	50	62	56	61	61	73	63	62	58	36	62	74	64	39	62	56	59	77	65	48	63	46	81	68	76	58	41	69	58	54	65	74	66	88	81	40	47	61	81	84	55	63	76	64	36	86	58	65	48	54	35	81	57	55	51	67	53	51	75	58	49	57	81	47	62	79	82	57	48	20	57	70	88	33	82	66	57	68	57	75	38	55	106	92	51	41	49	47	54	47	67	87	59	68	59	56	50	45	54	75	59	61	37	60	73	56	58	61	45	57	71	59	53	48	41	37	56	37	28	50	38	81	70	66	61	48	62	54	52	45	61	46	67	49	42	70	122	23	41	40	36	28	55	55	74	51	53	40	44	51	46	74	48	22	30	31	36	41	46	51	26	39	41	33	39	42	34	29	45	48	34	38	34	51	40	56	47	30	50	29	56	32	34	33	41	52	130	51	31	64	53	14	33	63	22	56	52	46	44	41	69	54	74	43	30	50	29	60	36	67	60	49	69	72	52	34	49	51	51	83	51	65	54	41	32	20	41	30	45	29	54	59	28	34	44	39	46	93	37	51	33	64	69	44	48	74	39	37	53	41	48	44	43	43	43	104	27	55	59	51	42	44	57	28	35	49	31	51	37	49	35	47	54	41	54	43	31	63	51	49	24	31	35	134	54	66	23	44	28	54	43	54	27	96	49	27	37	36	53	35	46	20	48	23	60	48	24	31	39	64	61	36	57	35	30	55	24	23	22	52	45	30	44	22	31	19	33	39	38	159	138	26	27	40	59	42	23	37	38	42	47	29	30	25	42	33	19	46	29	32	19	29	44	34	25	66	16	33	29	80	53	40	36	26	38	17	36	25	40	30	37	34	44	19	32	15	28	25	36	41	31	33	35	52	28	21	34	37	37	38	55	37	22	44	36	39	21	32	31	38	23	40	32	14	32	14	20	31	41	33	22	37	33	36	21	32	47	30	34	26	38	31	27	24	25	22	35	40	43	22	53	34	25	32	36	38	29	20	16	43	29	23	16	28	25	19	43	21	13	29	29	20	16	33	38	24	26	40	28	28	26	26	23	25	24	27	44	66	25	18	30	12	39	34	20	35	29	36	47	17	30	8	22	19	27	25	28	22	24	16	30	23	21	33	14	15	30	29	20	41	20	23	26	27	22	13	20	27	24	22	14	30	13	40	20	16	43	21	18	35	21	37	25	20	22	27	16	38	42	20	23	43	13	33	14	29	29	22	16	21	25	23	41	37	28	25	26	27	20	17	38	13	11	29	21	17	13	21	30	27	28	17	25	16	11	17	28	31	27	34	16	19	22	14	11	29	26	25	20	46	20	23	21	11	26	12	21	15	13	12	35	11	10	20	25	12	17	19	11	11	24	22	33	22	11	28	23	13	26	19	14	25	25	6	3	5	27	8	11	21	22	8	9	15	18	28	14	12	9	12	33	20	7	15	11	9	8	24	6	14	29	21	15	18	10	5	26	12	9	20	16	7	10	16	17	20	19	8	11	5	16	32	10	21	12	13	8	8	22	30	9	17	8	16	11	7	8	22	8	12	5	15	8	8	7	8	6	10	11	12	9	16	11	6	7	6	6	12	12	11	13	2	10	11	1	6	12	2	16	9	8	5	8	5	5	13	14	5	5	3	10	11	19	5	15	13	19	14	13	11	14	9	12	4	10	15	13	19	7	5	6	6	7	10	8	1	8	2	4	9	5	9	16	8	13	13	8	12	11	2	4	3	4	7	2	10	5	3	5	11	4	20	4	4	7	4	3	5	7	2	3	5	3	8	9	16	5	1	10	6	5	5	5	2	3	4	2	5	6	8	9	13	9	6	6	2	3	3	4	0	2	9	8	2	4	3	2	4	3	2	3	2	3	9	0	2	0	0	1	5	1	0	2	1	4	3	0	2	0	1	0	2	3	0	1	0	0
ne0395	1056	1067	728	817	756	642	578	425	652	375	770	548	500	427	511	431	317	569	481	432	521	465	540	472	364	499	520	349	449	486	425	281	341	304	379	394	306	453	348	395	350	311	427	274	270	253	293	184	262	420	275	328	215	406	153	324	563	362	241	276	294	282	304	318	307	219	231	273	262	333	246	317	263	373	347	503	293	272	228	396	251	256	229	291	378	228	215	288	276	161	263	226	189	224	322	278	232	213	168	182	224	188	332	184	201	239	202	196	177	118	239	150	233	196	205	144	198	246	330	183	227	192	351	169	201	240	170	284	182	187	264	172	271	203	253	239	220	195	192	167	206	141	321	154	241	194	191	391	136	119	200	163	189	156	215	305	214	314	150	231	193	214	233	145	281	229	167	208	279	154	189	200	206	159	174	166	208	165	254	210	352	316	227	166	223	333	251	165	158	197	180	125	149	212	186	133	145	156	184	173	134	241	217	186	199	154	166	111	202	126	151	163	183	110	208	201	209	225	173	218	277	134	224	98	178	178	160	215	249	158	212	116	186	261	134	145	236	241	248	148	110	260	144	247	242	126	159	156	207	176	176	175	222	189	173	134	170	142	241	149	110	132	137	82	125	100	146	384	158	126	153	127	139	164	125	137	124	137	165	224	209	124	156	183	258	256	164	110	191	142	211	108	244	114	183	120	97	104	91	101	112	208	136	101	73	167	140	140	106	172	253	164	204	148	141	184	71	123	146	138	106	166	137	206	118	88	87	143	140	162	103	89	86	95	80	66	117	248	103	128	168	84	94	200	75	177	79	146	252	170	104	181	143	113	96	183	148	182	209	125	101	111	81	138	136	130	117	116	86	56	125	162	128	122	119	159	131	144	104	123	174	127	104	88	148	159	120	135	65	109	189	143	92	92	135	84	148	156	133	120	87	148	85	65	86	114	135	186	97	142	124	137	104	78	76	108	98	175	100	67	103	143	127	79	125	113	94	82	118	87	104	106	74	93	104	115	88	117	126	99	84	132	160	74	71	100	103	103	124	55	53	115	120	77	130	125	156	127	102	128	93	58	179	155	96	106	78	68	102	134	139	69	123	98	82	98	56	111	118	96	135	199	64	141	81	139	69	44	67	139	136	102	156	100	166	74	90	119	74	128	110	58	94	34	59	112	124	80	54	56	70	75	90	151	64	72	81	85	74	95	94	84	151	58	113	51	107	96	108	66	86	93	76	62	131	81	121	104	165	135	96	141	130	85	90	129	88	204	104	87	72	73	72	69	76	126	166	80	58	104	100	96	103	109	74	77	94	62	60	111	86	78	223	91	77	62	96	84	63	90	131	72	66	95	46	53	104	82	84	53	93	103	129	111	47	75	53	82	59	64	36	146	89	46	64	103	98	65	101	77	124	75	127	109	62	116	74	67	80	117	68	110	93	77	58	70	60	41	64	84	112	55	92	89	102	105	59	60	90	131	46	38	54	94	90	169	138	33	111	58	82	96	72	68	51	67	52	31	87	42	39	69	166	72	61	57	76	76	105	65	57	95	54	40	110	38	98	93	68	64	82	59	74	88	83	40	76	105	98	111	89	124	46	90	81	66	35	90	45	121	59	58	56	68	48	52	46	47	41	96	69	70	92	40	65	62	47	47	43	39	65	100	35	102	102	84	35	43	51	55	78	50	90	62	81	72	62	56	56	126	61	91	45	32	93	38	100	68	80	42	104	56	76	93	91	46	52	56	61	91	38	52	32	54	69	70	147	129	46	55	50	45	57	49	53	38	51	211	47	62	50	31	40	38	58	76	33	44	66	54	85	48	40	93	88	21	36	45	51	57	51	42	135	34	54	49	49	29	42	26	47	83	21	32	32	31	69	54	52	40	25	53	92	63	42	71	33	50	42	30	158	60	30	104	53	43	36	36	55	55	61	40	17	30	65	190	81	80	36	104	51	55	27	40	45	42	52	70	83	107	82	44	20	41	35	52	127	53	51	62	27	45	50	33	163	48	39	44	34	35	42	24	75	58	36	76	55	79	50	50	51	90	55	65	38	42	25	62	41	40	64	44	33	25	35	102	35	33	33	60	54	43	56	53	54	94	36	28	42	46	28	26	40	32	21	67	44	64	44	69	54	27	22	51	35	77	43	17	38	37	110	30	165	33	23	80	31	46	48	11	51	54	42	37	60	52	79	103	49	74	39	41	55	43	41	81	39	50	38	58	51	29	49	39	41	42	29	38	28	40	37	36	16	34	86	58	58	35	113	31	20	26	49	46	59	47	44	19	59	21	48	39	36	31	29	61	54	50	45	13	35	31	60	45	23	41	68	28	60	19	15	40	32	89	65	36	30	35	34	27	46	48	38	23	44	50	30	33	61	19	31	30	52	14	67	71	85	27	40	47	24	22	36	29	32	102	60	85	19	44	30	48	35	19	28	20	41	45	27	40	52	25	15	143	44	47	37	24	41	18	41	20	62	40	55	35	55	27	16	61	62	24	69	37	22	39	48	33	44	65	40	50	56	32	24	39	17	68	18	27	41	18	29	51	29	48	29	33	42	28	67	14	24	17	36	17	46	19	28	22	32	44	46	30	15	18	44	35	46	20	28	62	24	31	57	21	24	22	57	66	21	47	49	50	22	30	31	52	30	10	22	30	57	55	40	31	35	58	37	28	33	38	17	8	74	33	30	21	30	64	16	21	22	37	15	44	43	34	28	29	25	20	17	36	15	37	23	29	27	96	14	23	61	33	16	36	21	76	26	62	21	23	30	9	44	25	29	29	69	29	30	26	16	11	39	38	23	27	45	12	25	17	28	24	30	11	18	14	64	15	68	19	11	36	17	41	17	26	30	30	11	65	28	16	26	54	37	18	46	14	18	24	32	13	60	39	13	26	24	55	34	28	20	26	30	13	11	26	61	34	45	20	32	32	56	36	22	28	13	18	39	4	29	39	23	15	15	34	60	35	18	20	33	19	30	48	33	29	48	33	36	52	38	30	29	33	47	34	9	17	25	27	23	28	47	26	28	32	27	34	31	11	15	30	18	12	58	37	65	46	27	12	14	25	28	29	6	37	8	39	24	9	16	69	20	20	22	37	17	7	12	16	22	35	32	13	21	18	30	32	19	14	17	37	17	24	18	5	17	3	11	22	17	7	18	15	21	13	9	10	23	10	16	25	18	22	30	18	14	19	24	8	12	20	27	20	54	15	15	14	18	17	46	34	16	24	8	17	22	11	27	30	21	23	13	50	24	15	12	9	39	8	23	18	17	16	23	27	9	35	16	17	17	18	18	16	6	20	16	6	71	22	24	6	25	25	7	4	20	35	13	3	1	27	10	9	25	13	9	13	3	4	11	10	18	11	24	10	33	28	13	14	25	28	74	16	60	24	18	2	14	32	25	7	11	17	17	2	14	30	12	23	11	47	11	4	16	18	13	18	7	17	14	10	8	17	11	18	12	3	13	21	9	9	62	5	15	12	17	16	13	3	14	44	8	12	30	16	20	4	12	31	12	9	13	20	6	6	1	12	38	16	21	9	6	11	13	21	32	15	9	8	13	4	10	8	6	4	8	8	19	8	13	10	22	2	26	15	0	23	3	13	19	8	5	7	4	9	7	9	17	23	7	9	10	1	2	10	9	13	17	6	16	7	10	3	4	15	9	15	6	9	1	3	21	22	6	35	6	15	15	6	4	2	7	9	5	3	13	27	20	4	13	29	2	3	4	7	11	4	21	2	6	10	3	7	17	20	4	4	8	5	10	9	7	6	16	14	6	7	11	5	1	9	9	9	14	5	5	12	81	8	8	5	3	5	11	3	10	20	2	0	10	2	37	7	6	6	9	3	0	0	4	7	7	11	77	1	4	7	14	2	8	3	11	2	3	2	9	3	2	16	3	2	8	5	3	4	4	2	7	7	8	7	9	6	23	5	1	2	2	7	7	7	1	11	4	6	1	2	2	1	3	3	5	2	3	6	10	4	3	6	5	5	0	4	25	2	8	5	4	8	2	3	1	4	4	0	0	2	3	4	5	7	2	3	1	7	6	1	2	1	1	2	4	1	1	3	7	1	4	0	3	3	1	6	1	0	0	4	2	2	1	8	4	1	2	1	1	0	0	2	0	0	0	3	2	0	0	1	1	0	1	0	0	0	0	0
ne0396	1581	1341	860	659	807	949	705	659	723	574	710	723	741	599	545	672	528	551	637	603	473	568	692	416	430	518	531	519	502	571	454	395	416	515	503	426	382	511	448	444	450	432	402	383	286	445	418	309	436	459	389	353	290	295	272	440	445	419	363	292	418	345	278	472	345	319	370	317	298	421	268	263	375	365	366	470	286	398	316	384	350	381	323	326	351	328	288	301	297	292	264	284	327	334	282	343	338	261	279	181	252	253	232	294	305	276	282	346	245	185	222	256	388	317	299	229	305	313	353	299	273	289	357	304	272	257	226	149	290	299	300	262	250	247	265	305	226	189	284	253	327	237	279	245	220	231	288	318	241	232	276	181	294	188	315	436	228	351	252	166	268	269	278	211	307	236	172	281	222	149	203	241	294	225	256	153	193	263	242	211	115	346	250	254	185	208	198	240	243	240	227	205	178	222	204	111	177	258	223	199	198	196	179	259	204	212	181	145	335	178	254	208	232	185	227	214	230	240	222	207	191	113	171	172	193	169	237	267	267	194	226	158	198	183	204	174	192	216	267	169	135	265	214	195	252	132	285	189	217	232	176	193	236	160	271	227	174	180	208	171	140	167	134	160	164	164	145	259	203	177	147	147	164	183	119	153	192	175	211	256	208	122	160	214	174	229	206	133	213	152	177	153	187	161	158	169	96	156	172	106	182	142	176	121	172	202	131	158	199	231	258	147	184	185	172	194	123	146	176	170	149	180	114	191	142	114	109	201	169	127	151	126	132	88	99	121	116	155	179	123	223	139	166	107	120	175	137	125	223	149	112	181	116	140	106	150	138	204	198	113	110	113	139	141	160	135	157	153	146	121	174	180	114	144	133	121	204	137	121	119	45	136	126	115	232	98	169	198	91	129	105	157	115	106	136	109	151	159	124	77	106	95	105	122	105	165	168	279	160	90	117	133	140	100	113	171	105	166	109	146	152	138	116	114	219	136	104	170	152	116	82	91	112	127	138	138	115	145	179	99	109	154	213	119	104	119	138	135	128	63	104	97	113	71	97	154	164	126	105	189	190	103	140	194	134	93	78	62	100	135	65	126	168	111	98	128	106	115	100	113	104	131	102	176	98	172	90	93	87	187	94	104	156	91	115	64	108	119	94	186	76	69	110	61	81	111	165	151	117	68	83	119	114	101	67	80	100	71	111	118	99	86	102	92	114	68	168	133	85	87	115	124	90	93	128	96	97	176	124	162	134	119	132	164	110	78	101	148	124	158	95	92	104	101	99	108	91	91	96	87	98	110	116	98	102	103	79	107	95	110	64	137	183	83	57	73	70	52	75	64	76	74	86	108	97	60	106	124	111	107	80	130	65	96	68	112	63	82	114	85	82	163	118	35	69	133	99	48	125	88	75	169	98	114	62	79	59	72	94	68	67	108	87	91	80	121	95	70	73	77	167	73	95	96	76	81	39	93	118	130	79	77	40	98	107	144	136	85	88	68	92	101	65	71	58	53	69	30	99	58	73	78	105	84	77	72	96	77	43	80	79	83	68	90	62	92	82	91	73	84	117	62	100	111	28	53	63	72	103	104	79	80	61	70	87	72	82	93	134	81	63	74	81	82	68	65	71	101	76	87	60	75	70	45	69	71	72	85	55	47	88	98	55	73	85	81	61	60	55	101	99	72	88	80	86	65	34	65	74	113	73	145	32	52	92	45	67	85	94	49	67	55	92	47	79	89	73	68	90	81	71	96	46	80	88	54	132	86	95	81	57	54	86	71	80	90	51	223	56	75	52	76	37	36	59	68	52	53	77	67	100	117	58	84	58	58	51	86	88	77	49	56	104	68	56	71	74	31	40	64	27	46	42	27	58	55	64	72	45	19	50	46	40	119	38	76	48	59	50	39	116	45	40	72	50	62	53	45	44	84	56	66	15	38	48	96	29	38	30	78	70	75	57	40	48	83	83	70	49	46	65	59	59	46	80	48	60	51	49	62	39	44	63	73	157	59	45	36	86	56	43	44	94	35	46	67	55	64	63	67	64	69	73	41	41	60	38	47	41	56	66	62	52	48	113	107	72	51	48	49	67	65	45	54	70	49	29	54	44	53	83	42	50	62	54	57	52	134	57	89	54	52	57	58	60	72	38	33	43	41	50	42	142	50	35	48	71	48	93	22	47	60	38	28	25	55	56	54	51	28	41	53	41	42	40	83	44	48	35	22	60	47	49	30	45	60	48	50	56	69	75	53	25	61	89	49	59	54	64	53	31	43	61	51	40	51	36	51	71	47	39	45	44	37	42	56	57	73	61	28	46	49	60	36	40	43	55	52	56	27	50	41	48	55	70	55	19	25	51	43	47	51	52	32	49	50	30	11	76	29	46	36	33	15	39	86	41	27	79	45	28	32	33	51	41	51	59	38	33	44	33	49	41	30	36	45	57	55	33	56	39	33	15	111	26	49	24	47	29	40	37	34	68	57	41	48	80	34	29	62	38	29	58	40	29	37	19	28	49	34	40	74	58	27	36	46	30	67	39	38	57	83	39	41	42	39	50	31	27	37	46	27	49	29	17	27	47	35	38	64	56	38	32	62	34	34	37	55	45	13	44	49	37	26	62	18	27	30	44	39	79	49	35	53	55	40	43	90	46	77	29	65	48	64	25	45	13	66	59	37	36	55	41	27	71	47	64	29	43	87	29	26	11	64	23	32	40	47	34	37	64	34	21	39	24	40	33	25	42	63	22	22	27	53	21	48	29	39	38	65	45	31	37	30	47	26	21	37	52	37	30	46	32	27	28	36	34	29	46	16	22	8	24	30	81	36	14	14	71	27	79	56	31	36	20	34	22	28	39	36	17	49	31	22	38	62	29	23	41	43	33	33	32	48	9	69	19	69	24	46	40	48	28	22	37	40	36	37	22	43	30	23	27	57	54	26	29	23	22	29	45	14	56	25	27	11	17	59	44	32	32	33	51	26	25	32	25	29	42	35	40	16	63	24	23	24	44	22	14	20	38	33	26	20	38	22	26	35	19	59	35	22	32	31	52	23	52	33	49	35	17	42	21	23	34	36	11	33	15	29	32	31	16	77	17	40	28	41	15	13	15	34	19	33	20	21	26	19	19	43	47	14	33	72	22	25	29	23	15	11	12	33	15	15	31	35	11	17	17	13	38	65	39	28	30	17	23	13	23	31	23	12	30	31	24	20	31	20	22	23	43	33	24	34	25	24	18	23	27	19	5	23	47	13	18	40	24	12	31	19	33	27	37	26	26	21	16	18	22	16	19	43	18	21	27	30	23	30	14	10	14	19	23	25	19	36	13	12	22	32	30	15	6	33	22	15	14	20	14	16	6	13	15	15	13	24	19	17	22	29	14	17	22	24	19	26	20	9	23	5	22	30	19	20	30	30	23	14	21	17	20	12	22	16	17	6	7	16	15	20	16	20	11	11	10	17	15	23	8	5	23	20	9	8	29	12	28	18	10	36	18	10	35	30	8	18	16	12	27	11	12	32	10	25	17	23	19	21	6	21	16	18	24	20	26	12	13	21	38	17	13	15	14	16	18	9	16	10	6	11	3	9	5	10	9	11	32	16	3	8	11	11	12	11	7	8	21	13	10	3	12	8	5	6	9	1	9	8	14	11	20	16	49	7	15	8	8	23	10	15	16	13	13	12	15	19	16	32	8	4	19	5	3	22	9	14	20	2	12	20	17	8	18	13	3	17	12	14	23	21	29	5	8	23	7	10	16	15	12	12	7	11	10	9	3	7	15	68	4	8	6	5	13	5	5	19	16	17	1	6	9	6	13	3	9	19	5	9	9	5	12	2	10	3	8	4	9	3	9	6	7	5	2	8	9	9	8	1	11	6	8	7	8	5	8	8	3	3	2	5	5	9	17	7	20	24	2	25	0	13	5	12	5	13	11	1	9	5	2	6	9	12	5	4	9	6	4	3	8	5	0	12	6	6	4	0	15	10	2	11	9	4	2	2	4	3	6	0	16	4	3	6	1	24	6	3	3	0	1	3	7	1	0	2	6	4	2	2	3	2	6	5	1	1	4	7	4	2	3	3	1	0	3	6	2	2	0	3	8	16	1	1	48	4	11	1	1	0	1	0	2	1	0	1	1	1	10	1	1	3	1	1	0	0	1	2	3	0
ne0397	774	1261	516	487	526	373	370	224	364	233	369	279	285	239	421	353	253	295	345	250	296	255	402	137	222	315	341	290	264	382	399	199	241	164	329	301	237	302	201	324	182	208	196	150	163	183	173	153	283	316	101	244	196	186	138	291	204	215	255	194	171	265	302	240	196	152	127	230	194	220	137	248	266	200	288	437	128	169	154	262	184	290	73	161	368	106	125	202	162	158	232	184	90	170	154	202	79	163	175	132	134	169	260	84	143	163	120	103	152	93	202	134	106	90	100	155	81	179	178	65	185	95	156	131	143	130	109	64	72	86	220	143	182	124	136	258	95	96	86	115	154	151	105	106	173	108	137	120	123	90	154	121	105	105	189	216	135	242	60	129	96	146	186	95	130	159	88	188	138	116	86	87	147	150	70	187	139	75	163	109	104	215	165	104	148	156	139	163	138	126	147	70	117	145	122	95	105	73	104	70	141	145	62	107	115	110	107	79	215	111	58	75	88	87	147	126	95	232	165	138	231	85	188	89	124	59	54	177	146	79	151	84	77	225	90	131	249	154	161	79	91	94	110	123	170	105	74	104	84	128	89	115	100	81	162	50	85	87	137	67	91	132	113	57	74	96	50	98	89	110	68	116	65	101	67	82	44	81	97	172	219	80	87	197	138	262	115	70	181	116	112	84	193	93	100	119	70	67	97	58	94	40	173	59	80	123	98	89	70	77	169	53	133	92	134	89	82	115	63	107	85	117	50	127	50	111	64	103	118	113	95	76	57	52	40	64	91	218	75	70	55	71	71	123	66	145	114	123	88	174	56	117	138	105	51	37	37	114	169	64	89	82	49	80	83	74	66	172	57	77	131	99	72	69	74	94	80	92	68	30	75	99	65	73	127	47	65	103	35	77	144	119	57	108	45	65	92	80	116	70	68	99	80	27	65	85	93	139	28	82	51	60	87	67	30	55	90	99	59	42	127	160	59	78	119	97	47	49	123	60	54	74	91	57	98	64	80	55	134	48	35	168	144	41	65	62	152	58	127	25	50	41	75	40	92	86	66	89	58	126	48	69	102	151	72	38	32	32	56	88	68	30	71	47	44	69	49	79	233	68	65	52	63	113	34	179	40	27	46	77	61	74	116	136	158	43	59	82	35	67	47	33	32	18	39	29	61	92	64	29	43	73	66	89	35	52	32	44	44	86	47	54	116	100	37	45	58	87	57	46	60	88	44	50	125	63	80	56	44	67	55	122	104	57	144	56	195	23	62	60	112	53	25	29	57	68	38	51	46	36	82	101	87	56	50	42	51	24	31	60	29	58	48	32	32	26	80	17	55	31	73	51	83	68	35	51	56	80	84	17	95	48	72	105	34	88	20	30	57	49	30	84	58	47	33	64	85	48	71	66	53	49	95	107	65	30	41	41	57	90	79	116	85	93	44	59	58	65	47	44	58	41	61	78	64	82	100	30	44	62	58	87	32	46	59	34	70	32	112	32	122	73	46	51	28	68	32	17	54	24	30	44	48	41	53	31	40	136	21	38	40	89	35	16	29	47	51	56	41	84	111	41	33	76	22	47	46	56	68	59	60	41	43	50	94	39	36	67	46	114	36	48	31	42	23	37	24	54	46	86	47	39	104	52	49	30	19	49	49	68	9	96	28	75	28	64	31	25	36	50	55	88	139	43	50	61	33	28	28	92	19	42	13	46	47	19	49	73	46	69	38	27	47	33	37	29	37	70	72	82	30	28	13	26	67	62	21	44	35	67	24	28	38	29	50	37	51	34	27	51	15	25	27	17	23	25	46	15	32	40	25	19	18	79	55	40	43	28	25	47	23	35	36	52	13	50	24	22	32	19	18	31	26	23	16	17	37	20	39	18	9	21	37	37	29	35	30	95	70	15	28	19	21	63	17	24	32	11	42	21	20	31	3	16	29	15	16	23	12	113	46	35	14	48	57	33	31	33	62	32	79	17	14	44	34	54	37	27	42	31	28	32	63	15	64	68	5	14	32	25	40	19	56	55	6	51	38	64	64	14	34	58	31	37	29	30	19	31	40	23	59	46	23	16	49	60	57	35	24	54	50	26	18	29	32	40	27	43	31	21	20	14	23	31	26	39	21	62	27	76	49	21	22	14	29	52	19	28	19	32	42	30	31	20	19	28	14	32	45	11	45	28	13	26	19	66	30	49	23	38	24	44	25	24	34	36	19	29	41	22	37	23	18	15	37	14	13	31	22	25	56	11	28	24	42	40	18	45	70	43	25	30	38	43	25	46	25	27	58	13	29	5	30	30	13	34	32	36	41	24	26	30	26	52	20	30	44	12	47	30	36	41	15	28	30	16	28	28	40	18	161	41	16	13	57	7	14	3	47	17	44	20	45	20	39	59	21	14	23	25	30	43	26	45	12	43	21	43	15	33	23	82	12	9	9	20	39	39	22	43	21	26	4	34	25	47	14	22	28	19	49	12	93	17	54	32	48	14	11	27	31	34	27	38	16	14	12	24	10	19	9	24	42	45	38	32	21	40	18	26	97	13	49	23	20	38	30	26	33	34	84	14	25	14	5	13	22	19	33	7	10	37	26	5	18	14	22	29	41	10	55	24	9	14	34	7	5	9	30	32	23	13	86	76	33	15	17	26	4	13	11	13	20	45	5	41	9	60	46	35	31	33	10	3	48	58	31	13	50	34	12	11	13	79	13	26	42	11	35	19	2	11	16	41	11	17	37	3	36	35	9	18	24	13	16	15	28	62	15	29	21	16	138	22	11	13	21	34	56	23	35	6	7	8	31	18	27	10	30	13	21	12	50	14	25	24	13	10	34	11	31	34	12	21	5	12	29	16	21	53	12	9	6	15	33	56	32	17	42	21	15	27	32	8	29	60	10	11	36	10	18	12	27	17	18	35	14	8	23	34	43	48	16	49	9	47	24	27	33	4	16	21	16	31	8	26	9	27	25	11	15	32	33	12	21	17	16	22	8	14	49	22	9	10	34	20	65	20	6	16	9	10	20	16	42	15	53	14	19	18	7	9	14	22	9	10	5	26	25	23	15	18	18	2	10	34	31	12	12	37	14	13	6	40	15	21	6	8	21	6	16	9	13	31	14	5	10	27	16	41	20	6	6	27	13	31	8	4	25	8	14	35	7	26	17	26	36	9	6	7	21	2	10	12	16	12	30	11	19	20	16	8	4	35	13	21	26	8	14	25	11	26	4	9	2	24	11	11	8	6	9	16	72	7	8	27	16	7	13	5	26	7	19	11	25	17	14	6	26	8	20	15	17	10	45	11	14	39	7	8	4	6	17	7	8	16	5	8	14	15	16	8	5	14	3	10	10	6	9	14	3	9	14	13	4	11	5	32	9	77	11	23	18	28	11	21	9	44	33	2	11	6	41	9	11	3	10	3	22	13	11	4	7	13	2	3	12	3	14	8	19	10	16	8	4	7	5	11	10	10	26	6	7	1	17	16	15	5	3	21	6	1	10	13	30	6	7	14	4	3	3	11	4	12	6	13	16	9	8	5	4	2	8	6	26	11	11	17	14	11	15	3	6	2	18	6	27	6	8	9	13	0	5	7	21	5	9	13	2	7	3	14	13	13	6	2	11	9	12	3	7	14	2	2	3	25	3	14	7	6	25	20	8	11	6	12	9	12	4	10	7	14	5	9	0	90	15	20	5	6	7	6	0	8	5	5	3	7	10	3	6	0	4	4	8	7	2	9	3	9	5	5	8	9	3	1	5	68	5	8	9	1	8	1	6	1	13	16	8	16	6	8	7	0	7	6	5	0	0	9	31	5	6	5	2	2	3	17	2	7	8	11	4	2	2	1	1	6	7	2	1	1	2	9	9	23	2	2	57	8	15	7	8	1	6	1	0	3	3	4	7	15	24	0	16	4	4	2	0	3	5	5	5	7	5	3	4	2	1	13	3	7	1	3	3	3	4	8	0	2	1	10	1	1	7	7	1	5	1	4	8	2	0	2	2	1	3	0	7	1	15	2	1	2	23	1	5	1	8	2	3	1	1	3	0	2	1	1	0	3	1	0	2	0	1	4	0	1	0	1	2	0	7	2	24	2	1	2	10	1	2	11	4	4	2	0	1	1	3	0	0	0	0	1	6	0	1	0	0	2	23	1	0	1	5	0	0	0
ne0398	1221	1586	1143	751	1053	880	670	627	826	564	948	716	757	635	598	637	520	774	782	635	568	518	650	573	547	636	672	560	649	599	534	467	440	443	531	527	361	556	534	469	551	393	395	303	340	369	480	261	448	498	371	377	344	413	245	374	617	493	436	389	460	519	352	518	345	317	392	350	484	531	314	379	404	393	416	656	395	450	368	472	281	366	320	336	662	394	332	321	408	301	262	291	291	304	490	359	375	292	274	250	350	261	305	320	316	239	269	347	206	156	210	232	315	375	310	290	302	300	453	287	272	288	410	334	298	242	283	272	292	296	317	249	377	312	408	419	267	288	296	303	242	221	256	294	332	277	363	451	242	203	240	278	311	239	323	392	249	395	259	269	289	300	269	249	307	259	290	298	289	180	258	359	228	253	249	205	267	266	306	350	242	275	302	306	278	418	303	234	289	246	229	163	164	205	251	140	242	254	280	240	201	260	235	286	291	251	219	146	290	194	245	210	253	158	192	231	258	276	232	278	277	207	281	142	226	155	211	273	298	254	297	197	190	224	227	166	255	260	312	259	157	280	148	270	410	169	246	238	263	251	271	200	274	247	201	217	213	199	240	184	144	194	181	136	201	151	95	234	195	194	225	190	198	280	151	254	176	198	249	270	230	207	225	381	271	276	179	252	238	153	245	102	304	173	114	175	105	127	150	183	197	343	292	142	132	211	251	203	148	252	329	165	268	219	211	216	125	182	188	223	193	246	186	191	141	79	164	209	170	205	164	113	129	173	119	115	162	202	138	174	222	122	197	120	101	247	137	147	212	162	182	227	203	124	156	176	281	254	353	175	150	146	73	191	296	106	186	178	106	110	176	282	131	185	202	169	181	153	121	156	104	194	177	114	168	96	202	257	127	142	171	167	180	96	204	184	186	181	146	167	144	126	102	97	93	175	189	182	148	244	135	173	150	80	121	142	126	207	141	114	163	210	124	106	160	137	132	180	202	102	72	119	143	143	232	158	157	156	186	151	134	179	251	114	127	150	286	127	172	72	109	155	142	131	134	173	186	168	145	172	137	149	176	362	219	122	191	118	162	199	82	100	144	117	63	147	108	176	131	114	143	189	126	166	71	187	133	72	72	181	171	146	219	169	283	127	127	135	97	158	109	87	133	33	52	122	201	176	123	52	124	132	142	138	126	106	137	83	120	135	178	133	158	85	142	107	162	157	141	96	120	99	95	123	139	110	126	154	169	177	187	149	172	148	143	136	79	252	179	161	74	196	58	90	124	135	107	124	106	129	120	137	125	112	112	107	156	78	101	152	129	109	164	118	128	81	78	112	82	67	149	92	104	126	94	88	132	96	113	125	96	162	57	156	64	118	62	111	78	89	63	190	137	62	117	119	122	92	138	143	125	502	177	151	67	123	82	107	112	133	71	121	127	112	80	132	78	92	114	117	182	80	104	109	122	131	69	135	157	156	120	46	52	98	131	121	129	59	143	96	122	118	78	83	109	88	62	24	166	53	80	87	150	124	72	67	135	65	25	99	134	101	74	118	61	89	99	132	54	68	115	62	83	141	153	64	83	137	104	133	114	81	83	84	106	117	72	132	103	120	58	98	247	107	41	67	66	69	56	119	81	97	101	65	99	72	55	101	75	52	56	147	66	127	89	108	59	69	102	168	89	103	84	85	130	88	125	98	99	142	81	121	46	63	84	49	99	89	102	54	77	109	89	58	125	103	163	93	38	103	90	71	56	58	147	110	73	80	100	89	71	160	59	77	85	79	54	140	43	69	61	126	72	47	87	81	57	52	78	81	81	96	63	69	73	48	62	69	64	84	71	73	176	71	65	77	74	27	43	60	148	53	50	40	65	20	43	94	71	141	41	60	71	126	48	75	48	77	63	70	149	98	31	66	57	59	58	50	57	93	44	55	16	43	70	119	86	67	44	103	77	92	42	46	75	77	69	95	129	112	163	49	39	60	70	66	71	75	74	90	41	68	33	51	87	55	33	51	104	72	55	21	81	59	52	125	70	120	47	60	81	99	95	72	73	43	47	65	126	47	100	46	61	37	94	115	73	62	52	56	166	100	55	61	70	48	31	37	66	66	76	39	64	64	43	79	48	116	45	94	73	136	46	52	71	148	62	60	73	62	193	32	95	41	39	116	47	59	69	32	71	120	65	72	68	66	137	42	42	59	65	60	57	129	69	85	43	62	77	49	65	60	56	72	60	66	53	66	47	43	83	43	88	36	80	55	60	48	53	89	23	46	77	158	78	63	40	26	93	63	62	26	86	34	63	92	100	101	72	30	54	93	66	50	44	53	83	33	101	27	41	42	27	94	81	79	25	47	40	58	35	70	74	29	46	48	29	122	428	40	42	39	66	21	80	120	43	32	76	42	39	30	40	34	50	67	48	75	45	59	57	62	61	38	40	25	30	76	45	58	35	38	18	69	43	66	47	58	82	55	55	26	70	64	150	44	331	21	30	121	46	39	66	74	17	62	66	71	49	34	54	54	45	44	45	68	14	85	27	37	54	56	75	54	37	56	32	41	67	29	92	37	25	39	131	33	43	29	48	33	49	40	65	27	28	41	76	71	51	28	55	47	28	18	67	59	34	49	68	50	57	62	67	74	37	47	37	98	57	53	44	65	78	61	27	56	131	42	65	42	74	62	46	22	81	32	37	36	73	52	24	20	28	53	32	93	64	53	30	23	41	25	22	39	25	40	28	30	151	46	56	47	41	47	41	73	35	92	66	83	52	43	54	24	40	19	22	27	55	23	27	52	22	40	27	43	54	30	72	17	19	31	43	42	65	28	41	22	96	18	89	28	11	54	19	62	20	38	41	31	24	71	30	26	57	70	29	26	79	21	24	32	47	22	24	161	22	73	43	31	25	26	22	45	58	52	30	26	82	38	42	44	50	68	63	76	32	44	22	25	45	11	41	29	27	19	28	50	81	39	23	23	65	29	44	59	61	44	26	45	60	26	142	25	29	76	59	31	7	30	39	35	21	19	35	24	38	54	25	38	35	18	23	40	46	27	42	25	70	49	15	28	20	34	21	55	36	34	13	46	35	23	25	83	41	137	43	35	26	17	18	39	27	39	40	20	42	11	24	38	29	26	44	63	26	47	20	18	23	18	20	35	23	19	31	20	33	24	23	9	24	31	39	40	21	20	57	44	21	23	21	7	33	39	15	14	46	120	31	17	67	40	25	26	25	46	14	22	17	22	8	41	54	27	22	17	29	7	34	29	47	21	55	32	34	32	45	23	9	30	28	23	8	35	28	50	11	38	9	17	67	27	13	16	41	59	39	2	27	34	27	22	3	17	18	22	19	24	20	23	17	14	18	33	6	14	27	17	54	31	19	15	21	43	25	33	34	23	24	8	28	37	24	15	23	19	34	13	26	23	17	8	18	24	26	16	15	26	21	19	16	14	31	10	37	31	19	26	17	17	22	14	17	13	17	9	20	29	9	16	13	6	18	25	33	32	23	24	38	13	10	34	15	12	25	20	19	14	10	41	26	22	28	18	21	21	14	27	57	21	40	14	20	13	25	6	22	7	14	15	31	8	20	38	50	11	27	21	7	20	7	17	21	10	13	17	15	12	25	6	14	21	21	6	13	3	8	15	13	25	21	19	46	15	16	11	5	31	20	30	15	9	12	14	12	15	9	37	16	18	22	8	2	11	10	17	34	5	12	21	13	10	43	25	8	12	13	12	41	6	28	7	6	11	9	8	36	18	9	15	7	15	18	9	8	10	17	116	8	8	11	3	11	11	8	12	14	26	3	9	23	9	14	9	5	7	6	10	11	15	13	5	26	6	12	3	10	7	8	2	2	1	13	35	16	15	23	1	8	6	14	4	15	23	26	8	2	4	12	13	4	29	11	3	10	115	5	28	6	3	9	41	10	9	4	6	14	15	4	5	19	10	5	9	18	7	0	15	5	5	7	5	6	4	15	7	17	10	17	8	14	4	2	10	4	15	3	8	69	4	4	4	3	9	1	3	12	1	5	1	3	4	13	4	2	4	1	2	8	2	1	2	0	3	0	3	0	3	6	3	2	3	8	4	4	12	1	0	0	27	0	2	30	11	17	1	1	0	2	0	2	0	2	1	0	4	0	1	3	2	2	0	0	0	1	1	2	0
ne0399	2453	1725	2063	1413	1294	1307	917	1237	1120	1288	963	1052	965	854	686	710	722	988	676	880	801	668	653	779	869	756	777	681	491	591	635	551	708	707	573	481	705	752	636	430	614	582	451	676	299	491	668	582	323	456	644	588	615	627	415	562	707	609	377	626	544	516	294	508	582	499	486	533	525	528	820	499	379	370	366	735	488	531	399	304	509	466	435	532	454	558	496	529	325	384	238	419	417	331	330	389	442	598	338	463	410	252	382	457	444	509	486	448	421	240	271	319	392	498	423	408	431	368	447	529	267	399	437	270	321	527	354	420	433	466	506	202	537	495	453	467	358	512	391	431	318	382	298	420	223	340	342	766	280	336	313	387	293	354	324	332	297	276	463	248	348	364	315	318	385	429	370	294	343	204	247	439	306	250	352	440	370	358	350	397	579	219	373	307	345	349	282	186	381	384	276	338	241	344	320	191	355	331	264	333	220	266	246	340	537	299	350	338	166	279	384	439	201	236	228	377	337	304	232	402	370	307	288	237	202	403	448	244	312	301	234	290	320	320	205	299	270	378	324	296	306	257	226	307	601	371	273	268	251	100	341	220	311	580	124	312	243	273	355	293	142	327	440	244	323	173	220	399	265	383	382	332	233	337	233	246	276	246	173	262	221	349	389	524	318	416	75	316	146	203	304	249	287	233	207	245	226	187	301	315	211	292	216	193	173	211	322	306	237	285	368	352	292	237	193	275	174	313	207	251	191	170	298	526	251	157	263	204	196	337	118	320	266	165	248	173	241	290	170	331	165	201	142	345	246	261	163	206	369	167	303	183	190	136	238	274	226	287	186	261	236	214	118	179	226	254	166	90	227	149	182	216	142	155	307	264	207	206	274	264	295	170	305	215	146	282	211	175	198	242	310	226	182	334	154	212	184	243	252	202	292	215	217	217	227	214	227	162	197	215	244	158	232	219	212	194	151	208	201	135	129	242	167	111	99	219	198	176	144	167	82	130	123	149	205	47	192	76	127	235	243	175	119	207	157	222	184	171	206	182	181	207	164	216	160	171	204	166	157	135	106	49	174	174	129	167	205	274	199	156	357	178	218	315	130	176	212	164	152	190	273	243	96	251	106	208	168	158	44	97	236	228	168	176	177	208	176	294	118	69	209	159	113	257	50	165	169	122	89	184	122	113	152	105	200	190	181	209	108	181	230	118	158	55	107	190	167	125	106	130	162	147	196	152	111	209	161	158	237	120	86	77	185	128	115	142	76	154	207	97	79	127	159	136	111	88	98	176	35	209	183	130	61	186	165	132	209	113	169	157	149	142	202	282	221	194	132	108	118	95	167	98	110	125	126	163	142	230	106	188	76	156	115	184	107	151	93	168	100	249	95	140	144	46	210	122	98	148	114	84	180	101	127	208	138	171	125	162	82	142	169	187	161	55	46	99	120	29	129	192	80	211	135	190	198	129	168	58	344	127	139	51	124	90	138	189	133	34	143	186	157	147	124	191	186	118	157	68	119	145	105	111	115	125	109	134	120	42	107	159	171	95	111	65	130	192	121	110	81	90	134	106	126	99	211	71	126	172	126	99	172	122	131	107	222	115	74	96	73	89	126	123	110	178	77	35	174	111	90	51	91	105	40	65	92	81	94	94	65	176	110	101	128	170	190	136	87	118	147	94	72	89	27	128	94	67	129	102	83	135	102	72	73	64	118	144	110	160	119	74	240	146	142	116	97	59	103	41	194	81	84	84	99	89	139	96	96	91	139	69	45	187	41	118	55	75	62	111	83	131	128	50	55	113	80	62	44	94	115	84	104	169	71	171	155	59	64	89	107	93	154	126	143	88	122	61	88	92	55	63	110	202	42	52	77	46	49	83	157	126	22	80	199	98	77	56	66	24	82	115	161	154	93	105	118	85	180	59	48	39	98	92	28	152	119	141	118	146	95	51	118	50	81	73	102	82	33	51	109	96	127	90	61	105	35	51	136	117	50	71	100	88	77	108	78	67	61	109	74	51	95	111	114	75	108	79	112	111	123	132	56	83	133	89	96	82	139	37	84	49	32	63	137	146	107	126	17	50	85	80	62	101	87	85	64	58	71	63	48	99	33	104	57	83	57	242	92	45	85	64	66	62	87	77	77	78	69	25	53	87	76	85	123	81	84	80	81	25	86	83	64	285	56	43	128	51	91	56	105	77	88	45	44	48	109	92	79	179	39	108	83	36	46	86	63	83	66	35	40	72	46	53	47	73	95	28	97	113	48	52	30	86	68	94	63	43	74	42	49	90	140	104	110	23	62	113	105	52	68	126	46	58	86	128	74	63	64	63	106	55	45	88	57	157	99	53	47	177	45	54	33	43	21	91	21	66	75	90	40	102	60	59	73	26	292	93	28	203	23	17	56	56	12	47	57	88	43	115	96	72	62	97	88	53	110	23	36	74	120	37	34	49	134	87	37	66	94	67	37	44	57	62	58	69	50	38	31	99	59	27	80	53	64	50	67	97	92	93	69	63	35	62	21	44	81	66	23	87	70	80	55	64	102	61	85	35	67	73	41	35	34	73	24	61	109	42	59	72	85	29	39	70	20	38	61	28	25	45	64	61	18	83	54	57	43	76	25	86	84	32	23	71	45	37	71	33	42	17	16	57	40	34	75	67	42	51	118	53	27	16	39	46	129	47	103	40	55	55	53	27	47	34	52	98	46	63	83	47	21	50	22	37	56	31	63	34	28	40	82	31	56	41	98	62	43	54	71	42	75	72	13	88	25	11	54	46	34	111	55	15	17	42	97	34	35	68	32	25	74	67	32	79	22	82	43	73	65	61	70	43	99	59	27	39	58	56	81	74	43	119	12	74	71	43	58	74	71	41	54	24	29	24	69	26	105	61	56	23	27	38	39	67	53	27	33	55	30	42	36	22	71	27	31	28	55	22	29	65	16	42	77	21	28	32	40	40	67	54	74	97	16	38	53	35	29	82	31	35	29	67	35	72	116	98	57	37	68	100	31	18	48	36	23	12	17	24	30	17	7	23	44	41	17	37	34	33	58	28	42	14	29	23	34	29	25	17	31	15	4	27	49	20	30	61	17	10	33	34	31	50	13	29	16	108	119	54	28	41	62	131	21	38	61	39	44	75	30	13	34	24	41	19	21	11	14	26	21	29	18	27	7	8	49	15	61	55	107	24	17	8	7	32	39	20	16	15	38	34	22	4	45	61	37	34	45	26	26	54	27	42	19	16	18	49	35	17	69	21	17	11	34	17	33	32	22	60	32	38	4	35	44	29	25	43	18	26	18	33	51	21	35	28	31	6	33	51	39	52	20	20	19	10	1	22	14	13	15	33	22	60	43	32	19	39	17	18	26	5	49	22	34	23	30	20	38	11	36	36	26	8	12	16	35	15	27	9	30	30	41	37	5	26	6	23	21	17	36	9	12	23	33	9	44	12	23	29	31	43	19	11	12	18	52	28	20	1	31	33	22	22	13	15	15	19	61	39	39	18	20	13	14	20	29	23	29	15	27	23	7	19	38	26	11	23	26	3	19	5	60	65	53	28	20	28	52	53	16	27	17	19	22	28	12	20	14	26	8	4	18	5	7	26	29	12	25	10	20	10	19	15	13	21	88	61	14	16	14	12	9	9	10	15	61	10	17	6	8	21	18	46	11	19	7	26	11	13	24	3	32	28	22	19	11	14	6	16	11	6	17	14	18	50	18	31	5	31	9	20	21	9	10	17	21	7	15	14	18	15	13	10	24	74	8	19	2	12	58	10	9	18	14	20	6	9	6	14	16	7	14	7	25	6	19	19	6	7	12	15	9	4	59	27	7	4	20	4	102	7	9	8	4	10	14	13	15	10	5	8	30	7	74	7	3	31	10	9	2	1	25	55	14	23	8	5	19	1	17	12	23	3	6	7	8	2	13	13	7	5	7	12	19	0	4	8	20	3	104	5	13	4	6	12	5	13	8	10	1	12	12	33	204	3	7	3	2	6	13	37	5	1	4	20	7	2	1	12	13	10	15	2	8	6	9	9	3	5	9	9	31	11	11	5	7	4	27	5	5	3	3	14	1	3	3	2	13	3	4	0	2	4	3	0	0	0	8	7	0	2	10	4	1	3	0	2	0	1	9	2	1	0	13	0	0	0	0	0	0	1
ne0401	2309	3313	1262	703	1575	1218	798	777	863	927	1050	951	753	914	1042	748	668	768	801	897	875	494	871	473	774	612	841	868	551	1065	793	515	523	597	871	1070	442	815	440	686	468	571	327	439	411	432	376	500	713	559	409	574	586	295	379	720	566	801	672	562	504	398	839	629	590	455	392	445	462	644	340	639	565	416	525	936	546	552	522	358	307	618	369	265	723	340	397	491	452	605	370	529	280	465	526	463	328	395	310	268	496	352	480	278	301	390	223	357	372	276	381	358	435	256	303	250	338	450	326	279	519	243	712	381	465	364	270	308	291	320	470	501	387	329	647	430	294	229	251	271	266	268	232	225	434	242	342	236	355	465	173	250	320	238	377	346	385	372	254	193	254	367	374	421	445	473	305	581	370	214	380	290	244	395	265	355	490	265	364	275	129	293	263	313	295	415	260	362	233	350	382	312	162	326	379	217	193	257	467	175	313	447	201	236	212	238	221	330	463	349	229	314	226	322	297	574	288	536	364	400	518	301	515	289	477	403	351	476	283	199	388	254	288	377	316	343	320	515	400	231	405	414	274	259	349	390	177	212	192	307	364	200	348	166	437	209	230	276	169	326	262	302	202	253	249	424	168	226	227	264	184	304	187	301	353	211	340	145	305	269	442	174	235	170	269	189	266	187	317	146	457	155	586	266	193	197	175	251	249	202	396	197	341	223	224	313	203	482	197	205	347	131	487	152	350	269	264	254	158	267	351	472	168	217	197	167	204	248	185	208	146	176	208	117	151	217	215	179	151	275	233	233	235	145	235	260	255	202	213	353	206	305	314	186	176	108	184	178	302	190	206	205	115	196	246	178	132	404	182	200	240	350	281	173	183	135	199	183	172	217	119	258	246	142	250	155	134	280	224	232	114	103	113	255	145	256	253	116	184	201	214	164	126	122	199	198	266	198	99	275	216	203	150	149	103	204	209	288	336	107	183	234	124	158	228	119	119	118	237	151	112	338	200	163	203	223	117	162	195	188	228	279	233	126	220	149	202	210	275	62	124	94	137	117	296	313	254	283	160	294	84	110	180	124	144	157	214	144	227	132	83	129	117	83	106	158	137	205	239	74	226	137	177	164	90	232	76	76	131	205	145	133	202	239	261	139	225	137	127	267	147	194	114	57	97	175	149	193	170	106	123	219	144	162	188	228	88	147	137	180	131	193	358	142	131	93	150	225	253	115	132	147	126	130	188	262	91	178	303	225	166	143	251	104	204	49	126	188	378	99	109	131	58	143	307	292	103	138	93	97	212	189	183	116	100	79	116	59	94	129	96	157	169	122	101	183	116	73	156	142	236	184	120	142	132	158	105	97	104	85	106	139	209	264	72	93	123	92	232	113	122	202	145	91	124	144	208	219	137	104	122	325	250	159	238	244	89	82	165	215	134	228	141	242	93	105	166	247	165	104	75	58	172	161	159	264	162	116	103	95	157	145	205	118	93	99	112	117	262	112	275	112	208	111	75	108	62	44	192	51	137	54	152	90	167	47	194	137	220	88	71	131	121	82	152	74	156	218	95	147	112	86	155	200	101	87	122	126	120	164	107	128	92	87	68	117	100	336	60	204	78	136	71	54	78	78	48	62	48	178	150	169	119	114	150	141	97	117	72	115	98	173	93	268	192	145	67	62	98	140	135	103	140	95	87	81	228	80	73	109	207	97	127	125	94	63	55	112	72	88	54	94	99	62	105	67	74	96	69	114	41	84	145	37	177	135	44	99	70	130	165	93	185	99	123	198	99	50	51	92	105	34	95	46	105	162	45	81	96	90	204	155	87	127	122	186	95	89	85	155	97	76	68	88	69	44	65	92	67	36	149	71	44	80	184	21	128	117	92	95	24	105	38	76	51	88	63	144	92	59	67	80	136	49	116	131	91	38	198	72	57	102	36	61	72	66	43	92	91	171	90	170	43	134	146	119	68	123	194	93	105	69	151	119	68	90	149	70	93	75	95	142	78	52	70	106	42	50	98	89	80	90	83	118	51	147	62	189	28	79	74	83	77	134	137	56	63	78	112	41	167	74	119	43	123	98	89	59	82	102	152	77	128	65	31	21	140	81	107	100	86	90	38	34	89	94	57	53	53	120	49	78	55	57	85	87	109	116	46	78	82	26	68	50	73	55	34	66	127	75	119	93	139	64	56	149	48	86	114	65	47	162	104	67	100	122	71	67	68	65	60	54	120	62	164	68	43	52	75	42	42	50	23	60	73	66	60	92	141	80	62	52	89	94	61	81	87	45	116	62	41	60	89	98	66	59	69	70	42	42	19	74	86	70	24	70	63	47	110	111	177	49	35	108	49	47	62	79	73	50	64	101	68	46	58	45	44	118	85	80	87	18	112	23	65	35	80	28	38	47	35	122	108	58	46	79	43	62	70	115	69	40	47	35	61	125	62	134	57	78	46	74	130	45	78	67	78	49	114	52	51	82	26	39	86	80	51	25	49	33	80	63	74	83	50	65	92	85	41	40	74	26	58	55	56	49	126	100	41	20	79	31	95	90	19	85	53	44	91	67	131	70	22	32	78	49	41	39	28	27	23	91	66	22	60	76	49	50	47	118	79	35	52	139	80	18	72	22	59	46	99	130	63	84	35	37	44	77	48	36	22	50	81	51	58	27	75	11	45	118	34	62	84	70	61	25	46	59	102	59	44	50	75	29	67	25	60	36	42	30	15	22	72	72	77	62	53	24	104	22	37	90	55	16	92	39	32	91	23	58	67	53	65	4	46	5	42	19	49	34	39	46	17	27	29	51	54	159	46	42	70	69	88	48	57	69	45	22	66	58	54	46	47	69	23	57	66	33	22	13	49	24	26	17	49	58	81	19	70	27	24	52	66	32	54	18	41	40	83	23	50	34	46	59	26	25	30	97	49	42	91	34	59	47	23	60	45	56	24	43	100	30	84	35	55	32	36	37	66	42	32	72	83	54	67	28	20	36	23	88	70	42	17	24	82	38	104	33	84	68	27	37	17	47	35	26	41	35	24	43	21	57	60	53	39	25	22	65	39	29	17	22	29	51	19	28	47	47	31	43	35	58	30	69	97	17	12	102	44	11	88	47	21	59	104	38	21	74	60	36	54	52	24	83	24	36	19	34	30	31	46	45	65	86	87	39	71	63	56	16	55	53	27	40	25	33	26	17	55	20	34	87	37	34	15	55	60	38	100	32	50	76	29	37	32	42	17	23	35	12	50	25	10	34	55	18	23	32	40	17	56	25	32	9	27	47	26	36	15	24	33	64	19	46	25	18	34	32	17	62	17	14	11	10	20	29	7	18	58	59	16	30	11	21	61	24	51	22	39	33	19	39	25	38	42	44	14	60	8	6	24	38	32	25	43	19	30	29	38	71	60	43	64	12	27	18	30	15	23	36	23	29	33	37	29	25	42	17	52	20	23	18	73	70	25	76	37	49	12	36	19	29	37	68	16	18	34	36	43	20	25	22	25	46	56	26	18	23	22	31	10	9	32	19	24	25	26	7	27	26	14	24	16	41	9	13	40	21	13	10	28	5	19	7	52	29	30	38	15	38	11	21	34	14	44	25	75	8	13	2	13	7	16	15	12	16	19	12	13	44	29	14	14	12	8	23	9	28	24	21	26	19	23	14	11	12	12	7	13	61	11	10	11	13	6	24	16	54	2	25	11	5	25	4	7	23	1	14	14	12	32	6	3	16	17	19	20	10	19	18	7	13	29	6	5	22	7	4	17	50	24	4	10	43	25	10	9	7	4	10	23	20	21	7	9	14	5	0	21	10	11	10	14	7	10	42	9	34	4	16	5	5	18	4	6	3	6	3	15	22	0	2	4	14	8	19	10	6	1	5	17	27	6	7	20	4	14	10	7	9	18	7	9	6	10	0	2	15	3	38	4	15	2	10	2	5	3	3	3	6	5	7	5	1	5	8	5	13	13	4	3	1	6	2	12	15	3	1	3	4	3	4	1	3	14	3	2	11	7	0	1	6	3	9	1	2	23	1	7	3	6	10	4	10	7	7	5	239	1	9	0	0	9	8	5	1	9	0	0	7	3	10	3	2	3	3	2	3	3	2	0	2	3	4	8	3	6	6	0	4	0	1	0	1	1	0	3	1	0	2	0	1	0	0	0	0	2	0
ne0404	1593	1521	746	1291	778	799	1032	715	442	528	388	557	445	430	445	548	609	343	882	422	328	507	400	642	399	318	398	332	597	427	288	473	263	354	362	337	340	297	326	350	403	292	432	350	603	275	347	337	415	256	334	213	339	442	812	259	205	217	355	287	287	231	250	221	237	381	270	249	243	198	256	357	244	217	260	166	215	212	323	316	252	273	461	366	167	233	306	200	339	293	472	252	254	191	154	238	255	254	281	268	226	434	415	245	262	144	319	208	256	766	198	317	196	223	208	342	191	241	190	195	139	244	212	325	347	169	202	265	185	172	141	203	143	159	221	154	274	143	212	209	125	277	348	206	229	186	191	132	235	226	209	159	156	211	138	145	186	163	182	389	156	189	155	206	249	101	142	157	143	436	256	157	167	156	161	139	137	160	114	132	206	254	167	165	202	137	184	202	166	200	156	140	369	125	142	530	188	168	155	143	164	149	226	176	123	182	153	96	151	228	173	187	263	160	192	167	130	97	145	101	102	230	153	223	186	137	152	174	127	103	133	214	223	120	184	115	148	99	102	108	181	136	242	260	73	116	106	122	183	198	142	244	173	136	94	136	227	164	196	219	343	162	118	138	136	116	106	120	166	122	126	99	130	135	148	129	230	173	158	119	81	154	119	137	139	102	143	166	169	180	82	167	79	150	245	97	359	71	95	129	151	94	99	111	186	160	166	154	86	97	90	151	74	117	129	100	169	114	126	85	116	134	173	106	145	397	159	150	119	88	234	157	134	273	119	177	161	115	90	73	92	170	139	117	142	80	178	141	95	72	123	185	126	125	74	145	183	104	119	91	86	95	449	84	122	124	133	109	118	187	103	80	98	105	104	100	89	96	128	174	183	90	110	157	126	115	94	106	163	95	97	232	138	105	113	79	124	131	87	97	131	133	199	106	138	83	73	111	109	90	60	80	69	122	137	90	128	82	155	213	152	79	98	126	77	142	120	98	115	96	314	70	88	105	72	123	90	118	121	106	81	90	87	85	85	78	106	73	69	122	95	117	175	113	103	63	94	73	79	66	112	216	68	118	99	97	88	60	88	134	252	76	102	96	164	98	94	68	107	145	95	72	86	65	88	94	94	87	322	89	95	67	82	67	70	74	69	78	81	47	56	96	171	337	322	66	65	75	109	118	74	78	91	109	80	77	87	81	111	50	70	75	43	161	70	99	78	80	104	142	79	117	118	56	120	65	116	105	116	102	78	104	51	54	63	95	124	64	104	82	71	124	91	83	80	122	86	36	212	72	91	62	117	67	98	114	87	71	59	67	78	38	48	47	70	307	73	86	72	68	46	65	41	81	114	66	72	83	86	83	51	39	57	38	53	91	93	59	52	72	113	42	68	79	57	55	73	60	28	187	40	55	43	50	97	30	114	81	80	44	56	54	42	71	209	71	78	70	94	66	84	86	51	68	56	35	77	90	63	76	56	203	66	74	50	28	53	79	30	36	68	60	49	96	55	91	93	298	60	117	86	43	44	46	64	89	76	59	47	71	59	61	59	299	47	86	43	44	70	43	60	101	54	47	60	77	76	34	76	40	31	50	103	48	43	67	72	82	80	42	89	45	34	76	131	61	52	89	73	55	45	72	55	67	69	67	91	50	93	49	85	54	109	35	88	38	59	52	48	35	66	57	78	50	77	52	71	37	44	54	77	53	47	71	51	28	64	29	64	31	50	54	43	83	21	34	60	90	55	37	129	64	77	47	17	26	79	88	61	40	65	61	31	33	43	39	54	34	46	58	65	74	81	66	72	48	140	74	40	53	64	76	70	52	51	60	91	33	66	63	55	49	32	62	35	62	39	42	57	57	35	41	49	103	51	43	43	44	30	59	80	53	47	32	71	56	32	52	69	34	43	26	80	46	46	41	67	50	47	56	72	62	267	65	58	31	29	28	65	44	42	43	86	52	46	36	67	31	36	35	36	35	62	37	85	34	43	64	46	57	66	34	109	41	41	26	92	35	47	66	31	45	47	44	58	39	27	31	62	40	42	43	22	34	51	29	55	63	32	51	30	73	46	35	42	30	128	48	65	41	38	22	41	42	31	100	52	42	48	36	38	38	78	81	39	31	36	30	50	37	44	48	47	86	49	56	35	39	30	66	34	34	42	61	28	46	56	49	28	38	28	37	29	56	33	32	38	66	54	34	38	26	53	48	54	53	48	39	32	22	46	43	67	55	34	24	42	40	62	74	41	43	43	91	18	35	26	17	20	50	42	39	38	42	38	19	64	30	18	30	40	38	24	46	32	34	10	16	25	65	40	56	23	48	59	36	33	35	20	55	51	35	62	26	32	31	57	26	40	28	34	26	46	41	35	36	31	25	43	24	36	43	38	103	25	52	54	30	33	44	114	17	39	39	26	24	42	34	28	31	38	34	20	33	33	32	54	12	35	38	30	35	48	18	28	36	39	13	51	60	16	38	23	34	19	50	32	27	39	44	22	67	24	23	37	23	26	19	16	43	39	37	61	31	18	33	38	19	50	47	16	51	24	32	42	52	58	30	17	44	29	24	71	21	29	30	43	40	22	23	35	21	18	55	28	33	18	7	33	49	31	37	63	32	16	43	28	18	17	17	26	9	26	24	23	38	40	38	52	35	17	12	28	15	49	31	27	38	30	25	26	25	37	27	19	28	12	25	26	30	32	32	25	51	34	32	9	16	39	14	46	48	33	34	39	29	34	28	11	29	38	23	19	16	29	13	43	17	18	22	41	16	23	93	20	35	25	29	17	38	40	19	38	24	12	11	13	19	21	58	15	34	23	12	14	10	23	44	14	58	11	45	34	24	23	25	24	23	24	19	41	20	19	26	16	7	20	17	16	35	25	26	21	37	11	16	17	32	17	37	21	25	10	16	28	31	15	13	15	41	18	10	14	22	34	16	35	29	42	24	35	46	11	32	18	63	44	16	9	15	24	14	14	20	26	22	18	12	47	23	16	10	22	29	16	14	24	17	32	25	19	27	23	33	15	42	11	18	20	13	21	14	45	26	13	18	44	13	23	15	88	33	17	26	22	11	16	8	16	33	8	23	16	13	19	7	46	12	13	23	42	12	39	10	26	21	13	18	7	9	38	19	24	7	5	10	26	30	15	14	26	14	13	30	15	18	22	13	29	32	16	23	14	13	27	20	10	18	20	15	18	19	20	13	84	8	15	27	16	40	15	17	30	13	23	13	28	30	21	40	24	14	10	12	20	36	6	30	23	30	12	13	5	20	13	16	12	12	60	10	12	9	27	8	23	12	34	6	34	16	12	12	12	12	11	20	17	60	13	12	13	20	51	16	7	29	18	17	13	21	17	14	18	13	26	52	12	21	11	11	32	12	11	7	4	6	13	13	7	18	21	3	16	20	22	27	17	11	7	14	9	15	13	25	11	9	21	8	11	16	33	21	14	10	12	19	10	19	39	13	5	10	19	17	17	27	10	11	11	11	6	22	7	24	7	45	12	13	14	26	17	5	13	10	23	17	9	19	27	23	14	10	17	16	8	21	10	8	9	6	9	39	13	11	5	7	5	12	9	4	10	14	10	37	11	8	4	6	25	12	12	15	3	6	12	3	9	16	3	21	15	15	11	22	10	21	10	6	23	8	2	15	13	13	20	9	24	4	10	9	16	7	19	16	4	2	9	1	12	8	7	6	8	8	17	7	15	16	11	13	3	7	6	0	22	12	20	3	3	2	3	4	3	9	12	12	12	3	13	5	16	10	1	5	15	11	10	9	4	5	10	6	5	4	1	5	6	18	9	11	3	5	4	1	6	9	13	9	6	21	2	5	9	7	10	23	3	7	7	7	9	6	4	8	0	17	0	31	5	7	5	2	3	1	3	8	10	18	22	2	1	2	10	7	1	2	4	1	6	6	5	2	12	0	6	3	5	1	1	4	2	30	5	6	4	3	8	4	44	5	6	2	5	4	1	2	5	2	27	3	3	10	2	3	2	3	7	1	8	6	4	0	7	2	7	2	6	6	0	25	5	6	1	3	6	2	5	4	5	1	22	2	3	4	1	2	0	5	0	1	8	4	1	0	2	1	0	2	10	2	0	1	4	1	1	0	1	1	0	0	0	0	1	2	0	2	0	3	1	0	2	0	0	0	0	0	0	0
